TAG	TEXT	COMMENT
GAMEPLAY_EMOTE_EX1_323h_CONCEDE	你贏了…但是你的世界還是會毀滅！	
GAMEPLAY_EMOTE_EX1_323h_ERROR_FULL_MINIONS	太多手下了！	
GAMEPLAY_EMOTE_EX1_323h_ERROR_GENERIC	不能這麼做！	
GAMEPLAY_EMOTE_EX1_323h_ERROR_HAND_FULL	太多牌了！	
GAMEPLAY_EMOTE_EX1_323h_ERROR_I_ATTACKED	我已經攻擊過了！	
GAMEPLAY_EMOTE_EX1_323h_ERROR_JUST_PLAYED	它才剛剛進場而已！	
GAMEPLAY_EMOTE_EX1_323h_ERROR_MINION_ATTACKED	那個東西已經攻擊過了！	
GAMEPLAY_EMOTE_EX1_323h_ERROR_NEED_MANA	法力不足！	
GAMEPLAY_EMOTE_EX1_323h_ERROR_NEED_WEAPON	我的武器放哪去了？！	
GAMEPLAY_EMOTE_EX1_323h_ERROR_PLAY	不能打這張！	
GAMEPLAY_EMOTE_EX1_323h_ERROR_STEALTH	它在潛行中！	
GAMEPLAY_EMOTE_EX1_323h_ERROR_TARGET	目標無效！	
GAMEPLAY_EMOTE_EX1_323h_ERROR_TAUNT	那個嘲諷的手下擋到我了！	
GAMEPLAY_EMOTE_EX1_323h_FIRE_FESTIVAL	讓火焰燃燒吧！	
GAMEPLAY_EMOTE_EX1_323h_GOOD_GAME	打得漂亮！	
GAMEPLAY_EMOTE_EX1_323h_GREETINGS	你面對的是賈拉克瑟斯，燃燒軍團的埃雷達爾領主！	
GAMEPLAY_EMOTE_EX1_323h_HALLOWS_END	萬鬼節到了…加入他們吧！	
GAMEPLAY_EMOTE_EX1_323h_LOW_CARDS	我的套牌！快沒有牌了！	
GAMEPLAY_EMOTE_EX1_323h_LUNAR_NEW_YEAR	新春愉快！	
GAMEPLAY_EMOTE_EX1_323h_NO_CARDS	不！我沒有牌了！	
GAMEPLAY_EMOTE_EX1_323h_NOBLEGARDEN	歡慶貴族花園！	
GAMEPLAY_EMOTE_EX1_323h_OOPS	犯錯了！	
GAMEPLAY_EMOTE_EX1_323h_PIRATE_DAY	我是賈～～拉克瑟斯！	
GAMEPLAY_EMOTE_EX1_323h_SORRY	賈拉克瑟斯很…抱歉。	
GAMEPLAY_EMOTE_EX1_323h_THANKS	謝謝。	
GAMEPLAY_EMOTE_EX1_323h_THINK1	嗯…	
GAMEPLAY_EMOTE_EX1_323h_THINK2	我想想…	
GAMEPLAY_EMOTE_EX1_323h_THINK3	我該怎麼毀滅你呢…	
GAMEPLAY_EMOTE_EX1_323h_THREATEN	虛無！	
GAMEPLAY_EMOTE_EX1_323h_TIMER	時間快沒了！	
GAMEPLAY_EMOTE_EX1_323h_WELL_PLAYED	打得不錯。	
GAMEPLAY_EMOTE_EX1_323h_WINTERVEIL_GREETINGS	我會在冬幕節好好享用你的靈魂！	
GAMEPLAY_EMOTE_EX1_323h_WOW_04	不可置信！	
GAMEPLAY_EMOTE_HERO_01_CONCEDE	我選擇死亡！	
GAMEPLAY_EMOTE_HERO_01_ERROR_FULL_MINIONS	我的手下太多了。	
GAMEPLAY_EMOTE_HERO_01_ERROR_GENERIC	我不能這麼做。	
GAMEPLAY_EMOTE_HERO_01_ERROR_HAND_FULL	我的手牌太多了！	
GAMEPLAY_EMOTE_HERO_01_ERROR_I_ATTACKED	我已經攻擊過了。	
GAMEPLAY_EMOTE_HERO_01_ERROR_JUST_PLAYED	等一個回合那個手下才能攻擊。	
GAMEPLAY_EMOTE_HERO_01_ERROR_MINION_ATTACKED	那個手下已經攻擊過了。	
GAMEPLAY_EMOTE_HERO_01_ERROR_NEED_MANA	我沒有足夠的法力。	
GAMEPLAY_EMOTE_HERO_01_ERROR_NEED_WEAPON	我需要武器。	
GAMEPLAY_EMOTE_HERO_01_ERROR_PLAY	我不能打這張牌。	
GAMEPLAY_EMOTE_HERO_01_ERROR_STEALTH	我不能指定潛行的手下。	
GAMEPLAY_EMOTE_HERO_01_ERROR_TARGET	那不是有效的目標。	
GAMEPLAY_EMOTE_HERO_01_ERROR_TAUNT	必須先攻擊有嘲諷的手下。	
GAMEPLAY_EMOTE_HERO_01_EVENT_FIRE_FESTIVAL	點燃火堆！	
GAMEPLAY_EMOTE_HERO_01_EVENT_LUNAR_NEW_YEAR	新春愉快！	
GAMEPLAY_EMOTE_HERO_01_GOOD_GAME	打得漂亮！	
GAMEPLAY_EMOTE_HERO_01_GREETINGS	呵，你好。	
GAMEPLAY_EMOTE_HERO_01_HALLOWS_END	萬鬼節快樂。	
GAMEPLAY_EMOTE_HERO_01_LOW_CARDS	我快沒有牌了！	
GAMEPLAY_EMOTE_HERO_01_MIRROR_START	哈，放馬過來！	
GAMEPLAY_EMOTE_HERO_01_NO_CARDS	我沒有牌了！	
GAMEPLAY_EMOTE_HERO_01_NOBLEGARDEN	歡慶貴族花園。	
GAMEPLAY_EMOTE_HERO_01_OOPS	那一手有點問題。	
GAMEPLAY_EMOTE_HERO_01_PIRATE_DAY	呀迪哈迪哈～咿哈！	
GAMEPLAY_EMOTE_HERO_01_SORRY	這真是不幸。	
GAMEPLAY_EMOTE_HERO_01_START	勝利或死亡！	
GAMEPLAY_EMOTE_HERO_01_THANKS	謝謝。	
GAMEPLAY_EMOTE_HERO_01_THINK1	嗯…	
GAMEPLAY_EMOTE_HERO_01_THINK2	嗯…讓我想想…	
GAMEPLAY_EMOTE_HERO_01_THINK3	現在呢…	
GAMEPLAY_EMOTE_HERO_01_THREATEN	我會碾碎你！	
GAMEPLAY_EMOTE_HERO_01_TIMER	我必須選擇！	
GAMEPLAY_EMOTE_HERO_01_WELL_PLAYED	玩得不錯。	
GAMEPLAY_EMOTE_HERO_01_WINTERVEIL_GREETINGS	冬幕節快樂！	
GAMEPLAY_EMOTE_HERO_01_WOW	太驚人了。	
GAMEPLAY_EMOTE_HERO_01A_CELEBRATE	哈哈，太棒了！	
GAMEPLAY_EMOTE_HERO_01A_CONCEDE	啊，你贏啦！	
GAMEPLAY_EMOTE_HERO_01A_ERROR_FULL_MINIONS	我的手下太多了。	
GAMEPLAY_EMOTE_HERO_01A_ERROR_GENERIC	我不能這麼做。	
GAMEPLAY_EMOTE_HERO_01A_ERROR_HAND_FULL	我的手牌太多了！	
GAMEPLAY_EMOTE_HERO_01A_ERROR_I_ATTACKED	我已經攻擊過了。	
GAMEPLAY_EMOTE_HERO_01A_ERROR_JUST_PLAYED	等一個回合那個手下才能攻擊。	
GAMEPLAY_EMOTE_HERO_01A_ERROR_MINION_ATTACKED	那個手下已經攻擊過了。	
GAMEPLAY_EMOTE_HERO_01A_ERROR_NEED_MANA	我沒有足夠的法力。	
GAMEPLAY_EMOTE_HERO_01A_ERROR_NEED_WEAPON	我需要武器。	
GAMEPLAY_EMOTE_HERO_01A_ERROR_PLAY	我不能打這張牌。	
GAMEPLAY_EMOTE_HERO_01A_ERROR_STEALTH	我不能指定潛行的手下。	
GAMEPLAY_EMOTE_HERO_01A_ERROR_TARGET	那不是有效的目標。	
GAMEPLAY_EMOTE_HERO_01A_ERROR_TAUNT	我必須攻擊那個有嘲諷的手下。	
GAMEPLAY_EMOTE_HERO_01A_EVENT_LUNAR_NEW_YEAR	新春愉快！	
GAMEPLAY_EMOTE_HERO_01A_FIRE_FESTIVAL	仲夏火焰節快樂！	
GAMEPLAY_EMOTE_HERO_01A_GOOD_GAME	玩得好！	
GAMEPLAY_EMOTE_HERO_01A_GREETINGS	嗨呀，你好！	
GAMEPLAY_EMOTE_HERO_01A_HALLOWS_END	萬鬼節快樂，朋友！	
GAMEPLAY_EMOTE_HERO_01A_LOW_CARDS	我快要沒有牌了！	
GAMEPLAY_EMOTE_HERO_01A_MIRROR_START	耶！卡茲莫丹！	
GAMEPLAY_EMOTE_HERO_01A_NO_CARDS	我沒有牌了！	
GAMEPLAY_EMOTE_HERO_01A_NOBLEGARDEN	貴族花園節快樂！	
GAMEPLAY_EMOTE_HERO_01A_OOPS	搞…錯…了。	
GAMEPLAY_EMOTE_HERO_01A_PIRATE_DAY	呀啊！我是大海的國王！	
GAMEPLAY_EMOTE_HERO_01A_SORRY	真的很抱歉，朋友。	
GAMEPLAY_EMOTE_HERO_01A_START	為了卡茲莫丹！	
GAMEPLAY_EMOTE_HERO_01A_THANKS	噢！謝謝你啦！	
GAMEPLAY_EMOTE_HERO_01A_THINK1	嗯…	
GAMEPLAY_EMOTE_HERO_01A_THINK2	也許這樣…？呃不不不…	
GAMEPLAY_EMOTE_HERO_01A_THINK3	太多選擇了…	
GAMEPLAY_EMOTE_HERO_01A_THREATEN	感受山脈之怒！	
GAMEPLAY_EMOTE_HERO_01A_TIMER	唉呀！我得快點！	
GAMEPLAY_EMOTE_HERO_01A_WELL_PLAYED	打得漂亮。	
GAMEPLAY_EMOTE_HERO_01A_WINTERVEIL_GREETINGS	冬幕節快樂！	
GAMEPLAY_EMOTE_HERO_01A_WOW	不是吧！	
GAMEPLAY_EMOTE_HERO_02_CONCEDE	這場你贏了，朋友。	
GAMEPLAY_EMOTE_HERO_02_ERROR_FULL_MINIONS	我的手下太多了。	
GAMEPLAY_EMOTE_HERO_02_ERROR_GENERIC	我不能這麼做。	
GAMEPLAY_EMOTE_HERO_02_ERROR_HAND_FULL	我的手牌太多了！	
GAMEPLAY_EMOTE_HERO_02_ERROR_I_ATTACKED	我已經攻擊過了。	
GAMEPLAY_EMOTE_HERO_02_ERROR_JUST_PLAYED	等一個回合那個手下才能攻擊。	
GAMEPLAY_EMOTE_HERO_02_ERROR_MINION_ATTACKED	那個手下已經攻擊過了。	
GAMEPLAY_EMOTE_HERO_02_ERROR_NEED_MANA	我沒有足夠的法力。	
GAMEPLAY_EMOTE_HERO_02_ERROR_NEED_WEAPON	我需要武器。	
GAMEPLAY_EMOTE_HERO_02_ERROR_PLAY	我不能打這張牌。	
GAMEPLAY_EMOTE_HERO_02_ERROR_STEALTH	我不能指定潛行的手下。	
GAMEPLAY_EMOTE_HERO_02_ERROR_TARGET	那不是有效的目標。	
GAMEPLAY_EMOTE_HERO_02_ERROR_TAUNT	必須先攻擊有嘲諷的手下。	
GAMEPLAY_EMOTE_HERO_02_EVENT_FIRE_FESTIVAL	這是屬於元素的節日！	
GAMEPLAY_EMOTE_HERO_02_EVENT_LUNAR_NEW_YEAR	新春愉快！	
GAMEPLAY_EMOTE_HERO_02_GOOD_GAME	打得漂亮。	
GAMEPLAY_EMOTE_HERO_02_GREETINGS	你好啊，朋友。	
GAMEPLAY_EMOTE_HERO_02_HALLOWS_END	萬鬼節快樂，朋友。	
GAMEPLAY_EMOTE_HERO_02_LOW_CARDS	我快沒有牌了！	
GAMEPLAY_EMOTE_HERO_02_MIRROR_START	為了霜狼氏族！	
GAMEPLAY_EMOTE_HERO_02_NO_CARDS	我沒有牌了！	
GAMEPLAY_EMOTE_HERO_02_NOBLEGARDEN	歡慶貴族花園，朋友。	
GAMEPLAY_EMOTE_HERO_02_OOPS	犯錯了！	
GAMEPLAY_EMOTE_HERO_02_PIRATE_DAY	呀兒，夥伴！今天是海盜日！	
GAMEPLAY_EMOTE_HERO_02_SORRY	真是遺憾。	
GAMEPLAY_EMOTE_HERO_02_START	為了末日錘！	
GAMEPLAY_EMOTE_HERO_02_THANKS	謝謝你！	
GAMEPLAY_EMOTE_HERO_02_THINK1	嗯…	
GAMEPLAY_EMOTE_HERO_02_THINK2	我想想…	
GAMEPLAY_EMOTE_HERO_02_THINK3	我要考慮一下…	
GAMEPLAY_EMOTE_HERO_02_THREATEN	元素會摧毀你！	
GAMEPLAY_EMOTE_HERO_02_TIMER	快沒有時間了！	
GAMEPLAY_EMOTE_HERO_02_WELL_PLAYED	玩得不錯。	
GAMEPLAY_EMOTE_HERO_02_WINTERVEIL_GREETINGS	冬幕節快樂，朋友！	
GAMEPLAY_EMOTE_HERO_02_WOW	太厲害了！	
GAMEPLAY_EMOTE_HERO_02A_CELEBRATE	慶祝吧！	
GAMEPLAY_EMOTE_HERO_02A_CONCEDE	我被打敗了。	
GAMEPLAY_EMOTE_HERO_02A_ERROR_FULL_MINIONS	我的手下太多了。	
GAMEPLAY_EMOTE_HERO_02A_ERROR_GENERIC	不能那樣做。	
GAMEPLAY_EMOTE_HERO_02A_ERROR_HAND_FULL	我的手牌太多了！	
GAMEPLAY_EMOTE_HERO_02A_ERROR_I_ATTACKED	我已經攻擊過了。	VO_HERO_15_ERROR04_43.wav
GAMEPLAY_EMOTE_HERO_02A_ERROR_JUST_PLAYED	等一個回合那個手下才能攻擊。	
GAMEPLAY_EMOTE_HERO_02A_ERROR_MINION_ATTACKED	那個手下已經攻擊過了。	
GAMEPLAY_EMOTE_HERO_02A_ERROR_NEED_MANA	我沒有足夠的法力。	
GAMEPLAY_EMOTE_HERO_02A_ERROR_NEED_WEAPON	我需要武器。	
GAMEPLAY_EMOTE_HERO_02A_ERROR_PLAY	我不能打這張牌。	
GAMEPLAY_EMOTE_HERO_02A_ERROR_STEALTH	我不能指定潛行的手下。	
GAMEPLAY_EMOTE_HERO_02A_ERROR_TARGET	那不是有效的目標。	
GAMEPLAY_EMOTE_HERO_02A_ERROR_TAUNT	必須先攻擊有嘲諷的手下。	
GAMEPLAY_EMOTE_HERO_02A_EVENT_LUNAR_NEW_YEAR	新春愉快，萬事如意！	
GAMEPLAY_EMOTE_HERO_02A_FIRE_FESTIVAL	我的老家沒有火焰節。	
GAMEPLAY_EMOTE_HERO_02A_GREETINGS	哈囉，朋友。	
GAMEPLAY_EMOTE_HERO_02A_HALLOWS_END	可怕的萬鬼節快樂，小蝌蚪。	
GAMEPLAY_EMOTE_HERO_02A_LOW_CARDS	我快沒有牌了！	
GAMEPLAY_EMOTE_HERO_02A_MIRROR_START	年輕？我喝的海水比你吃的鹽巴還多！	
GAMEPLAY_EMOTE_HERO_02A_NO_CARDS	我沒有牌了！	
GAMEPLAY_EMOTE_HERO_02A_NOBLEGARDEN	貴族花園節快樂！	
GAMEPLAY_EMOTE_HERO_02A_OOPS	可惡！	
GAMEPLAY_EMOTE_HERO_02A_PIRATE_DAY	海盜？明明就是我們先到！	
GAMEPLAY_EMOTE_HERO_02A_SORRY	原諒我，年輕人	
GAMEPLAY_EMOTE_HERO_02A_START	年輕人，我來幫你上一堂課！	
GAMEPLAY_EMOTE_HERO_02A_THANKS	真心感謝你。	
GAMEPLAY_EMOTE_HERO_02A_THINK1	該怎麼出呢…	VO_HERO_15_Thinking1_13.wav
GAMEPLAY_EMOTE_HERO_02A_THINK2	這樣應該很有趣…	
GAMEPLAY_EMOTE_HERO_02A_THINK3	說不定…	
GAMEPLAY_EMOTE_HERO_02A_THREATEN	面對大海的智慧！	
GAMEPLAY_EMOTE_HERO_02A_TIMER	快一點啊，沒時間了！	
GAMEPLAY_EMOTE_HERO_02A_WELL_PLAYED	玩得不錯。	
GAMEPLAY_EMOTE_HERO_02A_WINTERVEIL_GREETINGS	祝你冬幕節快樂！	
GAMEPLAY_EMOTE_HERO_02A_WOW	不可思議！	
GAMEPLAY_EMOTE_HERO_03_CONCEDE	我輸了。	
GAMEPLAY_EMOTE_HERO_03_ERROR_FULL_MINIONS	我的手下太多了。	
GAMEPLAY_EMOTE_HERO_03_ERROR_GENERIC	我不能這麼做。	
GAMEPLAY_EMOTE_HERO_03_ERROR_HAND_FULL	我的手牌太多了！	
GAMEPLAY_EMOTE_HERO_03_ERROR_I_ATTACKED	我已經攻擊過了。	
GAMEPLAY_EMOTE_HERO_03_ERROR_JUST_PLAYED	等一個回合那個手下才能攻擊。	
GAMEPLAY_EMOTE_HERO_03_ERROR_MINION_ATTACKED	那個手下已經攻擊過了。	
GAMEPLAY_EMOTE_HERO_03_ERROR_NEED_MANA	我沒有足夠的法力。	
GAMEPLAY_EMOTE_HERO_03_ERROR_NEED_WEAPON	我需要武器。	
GAMEPLAY_EMOTE_HERO_03_ERROR_PLAY	我不能打這張牌。	
GAMEPLAY_EMOTE_HERO_03_ERROR_STEALTH	我不能指定潛行的手下。	
GAMEPLAY_EMOTE_HERO_03_ERROR_TARGET	那不是有效的目標。	
GAMEPLAY_EMOTE_HERO_03_ERROR_TAUNT	必須先攻擊有嘲諷的手下。	
GAMEPLAY_EMOTE_HERO_03_EVENT_LUNAR_NEW_YEAR	新春愉快！	
GAMEPLAY_EMOTE_HERO_03_FIRE_FESTIVAL	仲夏節快樂。	
GAMEPLAY_EMOTE_HERO_03_GOOD_GAME	打得漂亮！	
GAMEPLAY_EMOTE_HERO_03_GREETINGS	這是我的榮幸。	
GAMEPLAY_EMOTE_HERO_03_HALLOWS_END	萬鬼節快樂。	
GAMEPLAY_EMOTE_HERO_03_LOW_CARDS	我快沒有牌了！	
GAMEPLAY_EMOTE_HERO_03_MIRROR_START	管好你自己。	
GAMEPLAY_EMOTE_HERO_03_NO_CARDS	我沒有牌了！	
GAMEPLAY_EMOTE_HERO_03_NOBLEGARDEN	歡慶貴族花園。	
GAMEPLAY_EMOTE_HERO_03_OOPS	我出錯了…	
GAMEPLAY_EMOTE_HERO_03_PIRATE_DAY	呀啊！我要成為海賊王！	
GAMEPLAY_EMOTE_HERO_03_SORRY	對不起啊。	
GAMEPLAY_EMOTE_HERO_03_START	你要小心點。	
GAMEPLAY_EMOTE_HERO_03_THANKS	謝謝你。	
GAMEPLAY_EMOTE_HERO_03_THINK1	嗯…	
GAMEPLAY_EMOTE_HERO_03_THINK2	我想想…	
GAMEPLAY_EMOTE_HERO_03_THINK3	太多選擇了…	
GAMEPLAY_EMOTE_HERO_03_THREATEN	我會殺死你！	
GAMEPLAY_EMOTE_HERO_03_TIMER	我必須趕快選擇…	
GAMEPLAY_EMOTE_HERO_03_WELL_PLAYED	玩得不錯。	
GAMEPLAY_EMOTE_HERO_03_WINTERVEIL_GREETINGS	冬幕節快樂！	
GAMEPLAY_EMOTE_HERO_03_WOW	真厲害！	
GAMEPLAY_EMOTE_HERO_04_CONCEDE	你贏得勝利了。	
GAMEPLAY_EMOTE_HERO_04_ERROR_FULL_MINIONS	我的手下太多了。	
GAMEPLAY_EMOTE_HERO_04_ERROR_GENERIC	我不能這麼做。	
GAMEPLAY_EMOTE_HERO_04_ERROR_HAND_FULL	我的手牌太多了！	
GAMEPLAY_EMOTE_HERO_04_ERROR_I_ATTACKED	我已經攻擊過了。	
GAMEPLAY_EMOTE_HERO_04_ERROR_JUST_PLAYED	等一個回合那個手下才能攻擊。	
GAMEPLAY_EMOTE_HERO_04_ERROR_MINION_ATTACKED	那個手下已經攻擊過了。	
GAMEPLAY_EMOTE_HERO_04_ERROR_NEED_MANA	我沒有足夠的法力。	
GAMEPLAY_EMOTE_HERO_04_ERROR_NEED_WEAPON	我需要武器。	
GAMEPLAY_EMOTE_HERO_04_ERROR_PLAY	我不能打這張牌。	
GAMEPLAY_EMOTE_HERO_04_ERROR_STEALTH	我不能指定潛行的手下。	
GAMEPLAY_EMOTE_HERO_04_ERROR_TARGET	那不是有效的目標。	
GAMEPLAY_EMOTE_HERO_04_ERROR_TAUNT	必須先攻擊有嘲諷的手下。	
GAMEPLAY_EMOTE_HERO_04_EVENT_LUNAR_NEW_YEAR	新春愉快！	
GAMEPLAY_EMOTE_HERO_04_FIRE_FESTIVAL	仲夏火焰節快樂！	
GAMEPLAY_EMOTE_HERO_04_GOOD_GAME	打得漂亮！	
GAMEPLAY_EMOTE_HERO_04_GREETINGS	你好！	
GAMEPLAY_EMOTE_HERO_04_HALLOWS_END	萬鬼節快樂，勇士。	VO_HERO_04_HAPPY_HALLOWEEN_13.wav
GAMEPLAY_EMOTE_HERO_04_LOW_CARDS	我快沒有牌了！	
GAMEPLAY_EMOTE_HERO_04_MIRROR_START	我會以聖光迎戰！	
GAMEPLAY_EMOTE_HERO_04_NO_CARDS	我沒有牌了！	
GAMEPLAY_EMOTE_HERO_04_NOBLEGARDEN	歡慶貴族花園，勇士。	VO_HERO_04_HAPPY_NOBLEGARDEN_17.wav
GAMEPLAY_EMOTE_HERO_04_OOPS	我犯錯了。	
GAMEPLAY_EMOTE_HERO_04_PIRATE_DAY	呀呃！卑鄙的混蛋！	VO_HERO_04_PIRATE_DAY_33.wav
GAMEPLAY_EMOTE_HERO_04_SORRY	很抱歉。	
GAMEPLAY_EMOTE_HERO_04_START	我會以榮耀作戰。	
GAMEPLAY_EMOTE_HERO_04_THANKS	謝謝你。	
GAMEPLAY_EMOTE_HERO_04_THINK1	嗯…	
GAMEPLAY_EMOTE_HERO_04_THINK2	我想想…	
GAMEPLAY_EMOTE_HERO_04_THINK3	我要考慮一下…	
GAMEPLAY_EMOTE_HERO_04_THREATEN	正義必得伸張！	
GAMEPLAY_EMOTE_HERO_04_TIMER	我必須趕快行動！	
GAMEPLAY_EMOTE_HERO_04_WELL_PLAYED	玩得不錯。	
GAMEPLAY_EMOTE_HERO_04_WINTERVEIL_GREETINGS	冬幕節快樂，勇士！	
GAMEPLAY_EMOTE_HERO_04_WOW	聖光啊！	
GAMEPLAY_EMOTE_HERO_04A_CELEBRATE	今日聖光照耀著我們！	
GAMEPLAY_EMOTE_HERO_04A_CONCEDE	你贏了，我認輸。	
GAMEPLAY_EMOTE_HERO_04A_ERROR_FULL_MINIONS	我的手下太多了。	
GAMEPLAY_EMOTE_HERO_04A_ERROR_GENERIC	我不能這麼做。	
GAMEPLAY_EMOTE_HERO_04A_ERROR_HAND_FULL	我的手牌太多了！	
GAMEPLAY_EMOTE_HERO_04A_ERROR_I_ATTACKED	我已經攻擊過了。	
GAMEPLAY_EMOTE_HERO_04A_ERROR_JUST_PLAYED	等一個回合那個手下才能攻擊。	
GAMEPLAY_EMOTE_HERO_04A_ERROR_MINION_ATTACKED	那個手下已經攻擊過了。	
GAMEPLAY_EMOTE_HERO_04A_ERROR_NEED_MANA	我沒有足夠的法力。	
GAMEPLAY_EMOTE_HERO_04A_ERROR_NEED_WEAPON	我需要武器。	
GAMEPLAY_EMOTE_HERO_04A_ERROR_PLAY	我不能打這張牌。	
GAMEPLAY_EMOTE_HERO_04A_ERROR_STEALTH	我不能指定潛行的手下。	
GAMEPLAY_EMOTE_HERO_04A_ERROR_TARGET	那不是有效的目標。	
GAMEPLAY_EMOTE_HERO_04A_ERROR_TAUNT	我必須攻擊那個有嘲諷的手下。	
GAMEPLAY_EMOTE_HERO_04A_FIRE_FESTIVAL	火焰節快樂！	
GAMEPLAY_EMOTE_HERO_04A_GOOD_GAME	玩得好！	
GAMEPLAY_EMOTE_HERO_04A_GREETINGS	啊，你好，挑戰者。	
GAMEPLAY_EMOTE_HERO_04A_HALLOWS_END	萬鬼節快樂。	
GAMEPLAY_EMOTE_HERO_04A_LOW_CARDS	我快要沒有牌了！	
GAMEPLAY_EMOTE_HERO_04A_LUNAR_NEW_YEAR	新年快樂。	
GAMEPLAY_EMOTE_HERO_04A_MIRROR_START	哈。你還差得遠呢。	
GAMEPLAY_EMOTE_HERO_04A_NO_CARDS	我沒有牌了！	
GAMEPLAY_EMOTE_HERO_04A_NOBLEGARDEN	貴族花園節快樂！	
GAMEPLAY_EMOTE_HERO_04A_OOPS	這是失誤。	
GAMEPLAY_EMOTE_HERO_04A_PIRATE_DAY	呀啊，我要拿走你的寶藏。	
GAMEPLAY_EMOTE_HERO_04A_SORRY	致上衷心的歉意。	
GAMEPLAY_EMOTE_HERO_04A_START	我的劍燒著神聖之火！	
GAMEPLAY_EMOTE_HERO_04A_THANKS	非常感謝。	
GAMEPLAY_EMOTE_HERO_04A_THINK1	嗯…	
GAMEPLAY_EMOTE_HERO_04A_THINK2	太多選擇了…	
GAMEPLAY_EMOTE_HERO_04A_THINK3	或許…	
GAMEPLAY_EMOTE_HERO_04A_THREATEN	你會付出代價！	
GAMEPLAY_EMOTE_HERO_04A_TIMER	快一點！	
GAMEPLAY_EMOTE_HERO_04A_WELL_PLAYED	打得好。	
GAMEPLAY_EMOTE_HERO_04A_WINTERVEIL_GREETINGS	冬幕節快樂！	
GAMEPLAY_EMOTE_HERO_04A_WOW	真是了不起啊。	
GAMEPLAY_EMOTE_HERO_05_CONCEDE	打得漂亮，我認輸。	
GAMEPLAY_EMOTE_HERO_05_ERROR_FULL_MINIONS	我的手下太多了。	
GAMEPLAY_EMOTE_HERO_05_ERROR_GENERIC	我不能這麼做。	
GAMEPLAY_EMOTE_HERO_05_ERROR_HAND_FULL	我的手牌太多了！	
GAMEPLAY_EMOTE_HERO_05_ERROR_I_ATTACKED	我已經攻擊過了。	
GAMEPLAY_EMOTE_HERO_05_ERROR_JUST_PLAYED	等一個回合那個手下才能攻擊。	
GAMEPLAY_EMOTE_HERO_05_ERROR_MINION_ATTACKED	那個手下已經攻擊過了。	
GAMEPLAY_EMOTE_HERO_05_ERROR_NEED_MANA	我沒有足夠的法力。	
GAMEPLAY_EMOTE_HERO_05_ERROR_NEED_WEAPON	我需要武器。	
GAMEPLAY_EMOTE_HERO_05_ERROR_PLAY	我不能打這張牌。	
GAMEPLAY_EMOTE_HERO_05_ERROR_STEALTH	我不能指定潛行的手下。	
GAMEPLAY_EMOTE_HERO_05_ERROR_TARGET	那不是有效的目標。	
GAMEPLAY_EMOTE_HERO_05_ERROR_TAUNT	必須先攻擊有嘲諷的手下。	
GAMEPLAY_EMOTE_HERO_05_EVENT_LUNAR_NEW_YEAR	新春愉快！	
GAMEPLAY_EMOTE_HERO_05_FIRE_FESTIVAL	仲夏節快樂。	
GAMEPLAY_EMOTE_HERO_05_GOOD_GAME	打得漂亮！	
GAMEPLAY_EMOTE_HERO_05_GREETINGS	你好啊，旅行者。	
GAMEPLAY_EMOTE_HERO_05_HALLOWS_END	萬鬼節快樂。	
GAMEPLAY_EMOTE_HERO_05_LOW_CARDS	我快沒有牌了！	
GAMEPLAY_EMOTE_HERO_05_MIRROR_START	那就來吧！	
GAMEPLAY_EMOTE_HERO_05_NO_CARDS	我沒有牌了！	
GAMEPLAY_EMOTE_HERO_05_NOBLEGARDEN	歡慶貴族花園。	
GAMEPLAY_EMOTE_HERO_05_OOPS	原本不是要這樣做的。	
GAMEPLAY_EMOTE_HERO_05_PIRATE_DAY	呀呃！	
GAMEPLAY_EMOTE_HERO_05_SORRY	我很抱歉。	
GAMEPLAY_EMOTE_HERO_05_START	狩獵開始了！	
GAMEPLAY_EMOTE_HERO_05_THANKS	謝謝。	
GAMEPLAY_EMOTE_HERO_05_THINK1	嗯…	
GAMEPLAY_EMOTE_HERO_05_THINK2	我想想…	
GAMEPLAY_EMOTE_HERO_05_THINK3	嗯…	
GAMEPLAY_EMOTE_HERO_05_THREATEN	我會獵殺你！	
GAMEPLAY_EMOTE_HERO_05_TIMER	時間快要沒了！	
GAMEPLAY_EMOTE_HERO_05_WELL_PLAYED	玩得不錯。	
GAMEPLAY_EMOTE_HERO_05_WINTERVEIL_GREETINGS	冬幕節快樂！	
GAMEPLAY_EMOTE_HERO_05_WOW	太強了！	
GAMEPLAY_EMOTE_HERO_05A_CELEBRATE	哈哈！太好了！太好了！	
GAMEPLAY_EMOTE_HERO_05A_CONCEDE	厲害！我認輸。	
GAMEPLAY_EMOTE_HERO_05A_ERROR_FULL_MINIONS	我的手下太多了。	
GAMEPLAY_EMOTE_HERO_05A_ERROR_GENERIC	我不能這麼做。	
GAMEPLAY_EMOTE_HERO_05A_ERROR_HAND_FULL	我的手牌太多了！	
GAMEPLAY_EMOTE_HERO_05A_ERROR_I_ATTACKED	我已經攻擊過了。	
GAMEPLAY_EMOTE_HERO_05A_ERROR_JUST_PLAYED	等一個回合那個手下才能攻擊。	
GAMEPLAY_EMOTE_HERO_05A_ERROR_MINION_ATTACKED	那個手下已經攻擊過了。	
GAMEPLAY_EMOTE_HERO_05A_ERROR_NEED_MANA	我沒有足夠的法力。	
GAMEPLAY_EMOTE_HERO_05A_ERROR_NEED_WEAPON	我需要武器。	
GAMEPLAY_EMOTE_HERO_05A_ERROR_PLAY	我不能打這張牌。	
GAMEPLAY_EMOTE_HERO_05A_ERROR_STEALTH	我不能指定潛行的手下。	
GAMEPLAY_EMOTE_HERO_05A_ERROR_TARGET	那不是有效的目標。	
GAMEPLAY_EMOTE_HERO_05A_ERROR_TAUNT	我必須攻擊那個有嘲諷的手下。	
GAMEPLAY_EMOTE_HERO_05A_EVENT_FIRE_FESTIVAL	火焰節到了。	
GAMEPLAY_EMOTE_HERO_05A_EVENT_HALLOWS_END	萬鬼節快樂。	
GAMEPLAY_EMOTE_HERO_05A_EVENT_LUNAR_NEW_YEAR	新春愉快！	
GAMEPLAY_EMOTE_HERO_05A_EVENT_NOBLEGARDEN	貴族花園節快樂！	
GAMEPLAY_EMOTE_HERO_05A_EVENT_PIRATE_DAY	呀啊！我會讓你沈船！	
GAMEPLAY_EMOTE_HERO_05A_GOOD_GAME	打得漂亮！	
GAMEPLAY_EMOTE_HERO_05A_GREETINGS	你好，冒險者。	
GAMEPLAY_EMOTE_HERO_05A_LOW_CARDS	我快要沒有牌了！	
GAMEPLAY_EMOTE_HERO_05A_MIRROR_START	我從不顫抖。	
GAMEPLAY_EMOTE_HERO_05A_NO_CARDS	我沒有牌了！	
GAMEPLAY_EMOTE_HERO_05A_OOPS	嗯。犯錯了。	
GAMEPLAY_EMOTE_HERO_05A_SORRY	很遺憾。	
GAMEPLAY_EMOTE_HERO_05A_START	在精靈之力前顫抖吧！	
GAMEPLAY_EMOTE_HERO_05A_THANKS	謝謝。	
GAMEPLAY_EMOTE_HERO_05A_THINK1	嗯…	
GAMEPLAY_EMOTE_HERO_05A_THINK2	該射誰呢？	
GAMEPLAY_EMOTE_HERO_05A_THINK3	該怎麼做呢…	
GAMEPLAY_EMOTE_HERO_05A_THREATEN	我的復仇將馬上到來！	
GAMEPLAY_EMOTE_HERO_05A_TIMER	快點行動！	
GAMEPLAY_EMOTE_HERO_05A_WELL_PLAYED	打得不錯。	
GAMEPLAY_EMOTE_HERO_05A_WINTERVEIL_GREETING	冬幕節快樂！	
GAMEPLAY_EMOTE_HERO_05A_WOW	太棒了！	
GAMEPLAY_EMOTE_HERO_06_CONCEDE	我認輸了。	
GAMEPLAY_EMOTE_HERO_06_ERROR_FULL_MINIONS	我的手下太多了。	
GAMEPLAY_EMOTE_HERO_06_ERROR_GENERIC	我不能這麼做。	
GAMEPLAY_EMOTE_HERO_06_ERROR_HAND_FULL	我的手牌太多了！	
GAMEPLAY_EMOTE_HERO_06_ERROR_I_ATTACKED	我已經攻擊過了。	
GAMEPLAY_EMOTE_HERO_06_ERROR_JUST_PLAYED	等一個回合那個手下才能攻擊。	
GAMEPLAY_EMOTE_HERO_06_ERROR_MINION_ATTACKED	那個手下已經攻擊過了。	
GAMEPLAY_EMOTE_HERO_06_ERROR_NEED_MANA	我沒有足夠的法力。	
GAMEPLAY_EMOTE_HERO_06_ERROR_NEED_WEAPON	我需要武器。	
GAMEPLAY_EMOTE_HERO_06_ERROR_PLAY	我不能打這張牌。	
GAMEPLAY_EMOTE_HERO_06_ERROR_STEALTH	我不能指定潛行的手下。	
GAMEPLAY_EMOTE_HERO_06_ERROR_TARGET	那不是有效的目標。	
GAMEPLAY_EMOTE_HERO_06_ERROR_TAUNT	必須先攻擊有嘲諷的手下。	
GAMEPLAY_EMOTE_HERO_06_EVENT_LUNAR_NEW_YEAR	新春愉快！	
GAMEPLAY_EMOTE_HERO_06_FIRE_FESTIVAL	仲夏節快樂，小心別弄出森林大火。	
GAMEPLAY_EMOTE_HERO_06_GOOD_GAME	打得漂亮！	
GAMEPLAY_EMOTE_HERO_06_GREETINGS	你好！	
GAMEPLAY_EMOTE_HERO_06_HALLOWS_END	萬鬼節快樂！	
GAMEPLAY_EMOTE_HERO_06_LOW_CARDS	我快沒有牌了！	
GAMEPLAY_EMOTE_HERO_06_MIRROR_START	對，大自然很重要！	
GAMEPLAY_EMOTE_HERO_06_NO_CARDS	我沒有牌了！	
GAMEPLAY_EMOTE_HERO_06_NOBLEGARDEN	歡慶貴族花園。	
GAMEPLAY_EMOTE_HERO_06_OOPS	這是自然的錯誤…	
GAMEPLAY_EMOTE_HERO_06_PIRATE_DAY	呀呃！	
GAMEPLAY_EMOTE_HERO_06_SORRY	很抱歉。	
GAMEPLAY_EMOTE_HERO_06_START	我必須保護大自然！	
GAMEPLAY_EMOTE_HERO_06_START_TYRANDE	泰蘭妲，我的摯愛！	
GAMEPLAY_EMOTE_HERO_06_THANKS	感謝你。	
GAMEPLAY_EMOTE_HERO_06_THINK1	嗯…	
GAMEPLAY_EMOTE_HERO_06_THINK2	嗯…我想想…	
GAMEPLAY_EMOTE_HERO_06_THINK3	該怎麼做呢…	
GAMEPLAY_EMOTE_HERO_06_THREATEN	大自然會對付你的！	
GAMEPLAY_EMOTE_HERO_06_TIMER	時光不等人…	
GAMEPLAY_EMOTE_HERO_06_WELL_PLAYED	玩得不錯。	
GAMEPLAY_EMOTE_HERO_06_WINTERVEIL_GREETINGS	冬幕節快樂！	
GAMEPLAY_EMOTE_HERO_06_WOW	了不起！	
GAMEPLAY_EMOTE_HERO_07_CONCEDE	這次你贏了。	
GAMEPLAY_EMOTE_HERO_07_ERROR_FULL_MINIONS	我的手下太多了。	
GAMEPLAY_EMOTE_HERO_07_ERROR_GENERIC	我不能這麼做。	
GAMEPLAY_EMOTE_HERO_07_ERROR_HAND_FULL	我的手牌太多了！	
GAMEPLAY_EMOTE_HERO_07_ERROR_I_ATTACKED	我已經攻擊過了。	
GAMEPLAY_EMOTE_HERO_07_ERROR_JUST_PLAYED	等一個回合那個手下才能攻擊。	
GAMEPLAY_EMOTE_HERO_07_ERROR_MINION_ATTACKED	那個手下已經攻擊過了。	
GAMEPLAY_EMOTE_HERO_07_ERROR_NEED_MANA	我沒有足夠的法力。	
GAMEPLAY_EMOTE_HERO_07_ERROR_NEED_WEAPON	我需要武器。	
GAMEPLAY_EMOTE_HERO_07_ERROR_PLAY	我不能打這張牌。	
GAMEPLAY_EMOTE_HERO_07_ERROR_STEALTH	我不能指定潛行的手下。	
GAMEPLAY_EMOTE_HERO_07_ERROR_TARGET	那不是有效的目標。	
GAMEPLAY_EMOTE_HERO_07_ERROR_TAUNT	必須先攻擊有嘲諷的手下。	
GAMEPLAY_EMOTE_HERO_07_EVENT_LUNAR_NEW_YEAR	新春愉快！	
GAMEPLAY_EMOTE_HERO_07_FIRE_FESTIVAL	燃燒吧，火焰。	
GAMEPLAY_EMOTE_HERO_07_GOOD_GAME	打得漂亮！	
GAMEPLAY_EMOTE_HERO_07_GREETINGS	你好啊。	
GAMEPLAY_EMOTE_HERO_07_HALLOWS_END	陰森的萬鬼節來了！	
GAMEPLAY_EMOTE_HERO_07_LOW_CARDS	我快沒有牌了！	
GAMEPLAY_EMOTE_HERO_07_MIRROR_START	那我就是你的惡夢！	
GAMEPLAY_EMOTE_HERO_07_NO_CARDS	我沒有牌了！	
GAMEPLAY_EMOTE_HERO_07_NOBLEGARDEN	歡慶貴族花園。	
GAMEPLAY_EMOTE_HERO_07_OOPS	不該那樣出的。	
GAMEPLAY_EMOTE_HERO_07_PIRATE_DAY	海盜日？慶祝這個幹嘛？	
GAMEPLAY_EMOTE_HERO_07_SORRY	抱歉。	
GAMEPLAY_EMOTE_HERO_07_START	你的靈魂屬於我！	
GAMEPLAY_EMOTE_HERO_07_THANKS	謝謝你。	
GAMEPLAY_EMOTE_HERO_07_THINK1	嗯…	
GAMEPLAY_EMOTE_HERO_07_THINK2	我想想…	
GAMEPLAY_EMOTE_HERO_07_THINK3	這麼多的可能性…	
GAMEPLAY_EMOTE_HERO_07_THREATEN	你的靈魂會受難！	
GAMEPLAY_EMOTE_HERO_07_TIMER	我快沒有時間了！	
GAMEPLAY_EMOTE_HERO_07_WELL_PLAYED	玩得不錯。	
GAMEPLAY_EMOTE_HERO_07_WINTERVEIL_GREETINGS	快樂的冬幕節到了…	
GAMEPLAY_EMOTE_HERO_07_WOW	幹得不錯！	
GAMEPLAY_EMOTE_HERO_08_CONCEDE	這場你贏了。	
GAMEPLAY_EMOTE_HERO_08_ERROR_FULL_MINIONS	我的手下太多了。	
GAMEPLAY_EMOTE_HERO_08_ERROR_GENERIC	我不能這麼做。	
GAMEPLAY_EMOTE_HERO_08_ERROR_HAND_FULL	我的手牌太多了！	
GAMEPLAY_EMOTE_HERO_08_ERROR_I_ATTACKED	我已經攻擊過了。	
GAMEPLAY_EMOTE_HERO_08_ERROR_JUST_PLAYED	等一個回合那個手下才能攻擊。	
GAMEPLAY_EMOTE_HERO_08_ERROR_MINION_ATTACKED	那個手下已經攻擊過了。	
GAMEPLAY_EMOTE_HERO_08_ERROR_NEED_MANA	我沒有足夠的法力。	
GAMEPLAY_EMOTE_HERO_08_ERROR_NEED_WEAPON	我需要武器。	
GAMEPLAY_EMOTE_HERO_08_ERROR_PLAY	我不能打這張牌。	
GAMEPLAY_EMOTE_HERO_08_ERROR_STEALTH	我不能指定潛行的手下。	
GAMEPLAY_EMOTE_HERO_08_ERROR_TARGET	那不是有效的目標。	
GAMEPLAY_EMOTE_HERO_08_ERROR_TAUNT	必須先攻擊有嘲諷的手下。	
GAMEPLAY_EMOTE_HERO_08_EVENT_LUNAR_NEW_YEAR	新春愉快！	
GAMEPLAY_EMOTE_HERO_08_FIRE_FESTIVAL	仲夏火焰節快樂！	
GAMEPLAY_EMOTE_HERO_08_GOOD_GAME	打得漂亮！	
GAMEPLAY_EMOTE_HERO_08_GREETINGS	哈囉！	
GAMEPLAY_EMOTE_HERO_08_HALLOWS_END	萬鬼節快樂。	
GAMEPLAY_EMOTE_HERO_08_LOW_CARDS	我快沒有牌了！	
GAMEPLAY_EMOTE_HERO_08_MIRROR_START	那就看誰厲害。	
GAMEPLAY_EMOTE_HERO_08_NO_CARDS	我沒有牌了！	
GAMEPLAY_EMOTE_HERO_08_NOBLEGARDEN	歡慶貴族花園。	
GAMEPLAY_EMOTE_HERO_08_OOPS	唉呀！	
GAMEPLAY_EMOTE_HERO_08_PIRATE_DAY	啊嘿！	
GAMEPLAY_EMOTE_HERO_08_SORRY	對不起。	
GAMEPLAY_EMOTE_HERO_08_START	這是你自找的！	
GAMEPLAY_EMOTE_HERO_08_THANKS	謝謝你。	
GAMEPLAY_EMOTE_HERO_08_THINK1	嗯…	
GAMEPLAY_EMOTE_HERO_08_THINK2	讓我想想…	
GAMEPLAY_EMOTE_HERO_08_THINK3	該怎麼做呢…	
GAMEPLAY_EMOTE_HERO_08_THREATEN	我的魔法會撕裂你！	
GAMEPLAY_EMOTE_HERO_08_TIMER	時間快不夠了…	
GAMEPLAY_EMOTE_HERO_08_WELL_PLAYED	這手漂亮。	
GAMEPLAY_EMOTE_HERO_08_WINTERVEIL_GREETINGS	冬幕節快樂！	
GAMEPLAY_EMOTE_HERO_08_WOW	太驚人了！	
GAMEPLAY_EMOTE_HERO_08A_CELEBRATE	很好，很好！哈哈！	
GAMEPLAY_EMOTE_HERO_08A_CONCEDE	將軍！做得好。	
GAMEPLAY_EMOTE_HERO_08A_ERROR_FULL_MINIONS	我的手下太多了。	
GAMEPLAY_EMOTE_HERO_08A_ERROR_GENERIC	我不能這麼做。	
GAMEPLAY_EMOTE_HERO_08A_ERROR_HAND_FULL	我的手牌太多了！	
GAMEPLAY_EMOTE_HERO_08A_ERROR_I_ATTACKED	我已經攻擊過了。	
GAMEPLAY_EMOTE_HERO_08A_ERROR_JUST_PLAYED	等一個回合那個手下才能攻擊。	
GAMEPLAY_EMOTE_HERO_08A_ERROR_MINION_ATTACKED	那個手下已經攻擊過了。	
GAMEPLAY_EMOTE_HERO_08A_ERROR_NEED_MANA	我沒有足夠的法力。	
GAMEPLAY_EMOTE_HERO_08A_ERROR_NEED_WEAPON	我需要武器。	
GAMEPLAY_EMOTE_HERO_08A_ERROR_PLAY	我不能打這張牌。	
GAMEPLAY_EMOTE_HERO_08A_ERROR_STEALTH	我不能指定潛行的手下。	
GAMEPLAY_EMOTE_HERO_08A_ERROR_TARGET	那不是有效的目標。	
GAMEPLAY_EMOTE_HERO_08A_ERROR_TAUNT	我必須攻擊那個有嘲諷的手下。	
GAMEPLAY_EMOTE_HERO_08A_FIRE_FESTIVAL	仲夏火焰節到了！	
GAMEPLAY_EMOTE_HERO_08A_GOOD_GAME	玩得漂亮！	
GAMEPLAY_EMOTE_HERO_08A_GREETINGS	啊，你好啊。	
GAMEPLAY_EMOTE_HERO_08A_HALLOWS_END	萬鬼節快樂。	
GAMEPLAY_EMOTE_HERO_08A_LOW_CARDS	我快要沒有牌了！	
GAMEPLAY_EMOTE_HERO_08A_LUNAR_NEW_YEAR	新春愉快！	
GAMEPLAY_EMOTE_HERO_08A_MIRROR_START	噢，早就開始了。	
GAMEPLAY_EMOTE_HERO_08A_NO_CARDS	我沒有牌了！	
GAMEPLAY_EMOTE_HERO_08A_NOBLEGARDEN	貴族花園節快樂！	
GAMEPLAY_EMOTE_HERO_08A_OOPS	那真是蠢啊。	
GAMEPLAY_EMOTE_HERO_08A_PIRATE_DAY	我是守～護者，麥迪文～！	
GAMEPLAY_EMOTE_HERO_08A_SORRY	致上衷心的歉意。	
GAMEPLAY_EMOTE_HERO_08A_START	遊戲開始吧！	
GAMEPLAY_EMOTE_HERO_08A_THANKS	非常感謝。	
GAMEPLAY_EMOTE_HERO_08A_THINK1	嗯…	
GAMEPLAY_EMOTE_HERO_08A_THINK2	有意思…	
GAMEPLAY_EMOTE_HERO_08A_THINK3	或許…	
GAMEPLAY_EMOTE_HERO_08A_THREATEN	沒有人能阻擋我！沒有人！	
GAMEPLAY_EMOTE_HERO_08A_TIMER	我不能再舉棋不定了！	
GAMEPLAY_EMOTE_HERO_08A_WELL_PLAYED	打得好。	
GAMEPLAY_EMOTE_HERO_08A_WINTERVEIL_GREETINGS	冬幕節快樂，挑戰者。	
GAMEPLAY_EMOTE_HERO_08A_WOW	真是了不起啊。	
GAMEPLAY_EMOTE_HERO_08B_CONCEDE	做得好，你贏了。	
GAMEPLAY_EMOTE_HERO_08B_ERROR_FULL_MINIONS	我的手下太多了。	
GAMEPLAY_EMOTE_HERO_08B_ERROR_GENERIC	我不能這麼做。	
GAMEPLAY_EMOTE_HERO_08B_ERROR_HAND_FULL	我的手牌太多了！	
GAMEPLAY_EMOTE_HERO_08B_ERROR_I_ATTACKED	我已經攻擊過了。	
GAMEPLAY_EMOTE_HERO_08B_ERROR_JUST_PLAYED	等一個回合那個手下才能攻擊。	
GAMEPLAY_EMOTE_HERO_08B_ERROR_MINION_ATTACKED	那個手下已經攻擊過了。	
GAMEPLAY_EMOTE_HERO_08B_ERROR_NEED_MANA	我沒有足夠的法力。	
GAMEPLAY_EMOTE_HERO_08B_ERROR_NEED_WEAPON	我需要武器。	
GAMEPLAY_EMOTE_HERO_08B_ERROR_PLAY	我不能打這張牌。	
GAMEPLAY_EMOTE_HERO_08B_ERROR_STEALTH	我不能指定潛行的手下。	
GAMEPLAY_EMOTE_HERO_08B_ERROR_TARGET	那不是有效的目標。	
GAMEPLAY_EMOTE_HERO_08B_ERROR_TAUNT	必須先攻擊有嘲諷的手下。	
GAMEPLAY_EMOTE_HERO_08B_FIRE_FESTIVAL	迎接仲夏慶典吧！	
GAMEPLAY_EMOTE_HERO_08B_GOOD_GAME	嗯，打得漂亮。	
GAMEPLAY_EMOTE_HERO_08B_GREETINGS	追求真理的同好，你好。	
GAMEPLAY_EMOTE_HERO_08B_HALLOWS_END	萬鬼節快樂！	
GAMEPLAY_EMOTE_HERO_08B_LOW_CARDS	我快沒有牌了！	
GAMEPLAY_EMOTE_HERO_08B_LUNAR_NEW_YEAR	新春愉快！	
GAMEPLAY_EMOTE_HERO_08B_MIRROR_START	我們可以一同學習。	
GAMEPLAY_EMOTE_HERO_08B_NO_CARDS	我沒有牌了！	
GAMEPLAY_EMOTE_HERO_08B_NOBLEGARDEN	歡慶貴族花園。	
GAMEPLAY_EMOTE_HERO_08B_OOPS	噢，糟了。	
GAMEPLAY_EMOTE_HERO_08B_PIRATE_DAY	今天要幫…海盜…慶祝？	
GAMEPLAY_EMOTE_HERO_08B_SORRY	喔，天啊，真是遺憾。	
GAMEPLAY_EMOTE_HERO_08B_START	知識就是力量。	
GAMEPLAY_EMOTE_HERO_08B_THANKS	謝謝你，朋友。	
GAMEPLAY_EMOTE_HERO_08B_THINK1	嗯…	
GAMEPLAY_EMOTE_HERO_08B_THINK2	觀察與思考…	
GAMEPLAY_EMOTE_HERO_08B_THINK3	一定有辦法...	
GAMEPLAY_EMOTE_HERO_08B_THREATEN	囂張的傢伙，該給你點教訓了！	
GAMEPLAY_EMOTE_HERO_08B_TIMER	注意時間！	
GAMEPLAY_EMOTE_HERO_08B_WELL_PLAYED	玩得不錯。	
GAMEPLAY_EMOTE_HERO_08B_WINTERVEIL_GREETINGS	冬幕節快樂！	
GAMEPLAY_EMOTE_HERO_08B_WOW	了不起！	
GAMEPLAY_EMOTE_HERO_09_CONCEDE	你打敗我了。	
GAMEPLAY_EMOTE_HERO_09_ERROR_FULL_MINIONS	我的手下太多了。	
GAMEPLAY_EMOTE_HERO_09_ERROR_GENERIC	我不能這麼做。	
GAMEPLAY_EMOTE_HERO_09_ERROR_HAND_FULL	我的手牌太多了！	
GAMEPLAY_EMOTE_HERO_09_ERROR_I_ATTACKED	我已經攻擊過了。	
GAMEPLAY_EMOTE_HERO_09_ERROR_JUST_PLAYED	等一個回合那個手下才能攻擊。	
GAMEPLAY_EMOTE_HERO_09_ERROR_MINION_ATTACKED	那個手下已經攻擊過了。	
GAMEPLAY_EMOTE_HERO_09_ERROR_NEED_MANA	我沒有足夠的法力。	
GAMEPLAY_EMOTE_HERO_09_ERROR_NEED_WEAPON	我需要武器。	
GAMEPLAY_EMOTE_HERO_09_ERROR_PLAY	我不能打這張牌。	
GAMEPLAY_EMOTE_HERO_09_ERROR_STEALTH	我不能指定潛行的手下。	
GAMEPLAY_EMOTE_HERO_09_ERROR_TARGET	那不是有效的目標。	
GAMEPLAY_EMOTE_HERO_09_ERROR_TAUNT	必須先攻擊有嘲諷的手下。	
GAMEPLAY_EMOTE_HERO_09_EVENT_LUNAR_NEW_YEAR	新春愉快！	
GAMEPLAY_EMOTE_HERO_09_FIRE_FESTIVAL	我想看煙火！	
GAMEPLAY_EMOTE_HERO_09_GOOD_GAME	打得漂亮！	
GAMEPLAY_EMOTE_HERO_09_GREETINGS	你好！	
GAMEPLAY_EMOTE_HERO_09_GREETINGS_DISABLED	嗯～嗯！	
GAMEPLAY_EMOTE_HERO_09_HALLOWS_END	萬鬼節快樂！	
GAMEPLAY_EMOTE_HERO_09_LOW_CARDS	我快沒有牌了！	
GAMEPLAY_EMOTE_HERO_09_MIRROR_START	聖光會守護正義！	
GAMEPLAY_EMOTE_HERO_09_NO_CARDS	我沒有牌了！	
GAMEPLAY_EMOTE_HERO_09_NOBLEGARDEN	歡慶貴族花園。	
GAMEPLAY_EMOTE_HERO_09_OOPS	原本的計畫不是這樣…	
GAMEPLAY_EMOTE_HERO_09_OOPS_DISABLED	嗯哼？	
GAMEPLAY_EMOTE_HERO_09_PIRATE_DAY	呀呃！	
GAMEPLAY_EMOTE_HERO_09_SORRY	很抱歉。	
GAMEPLAY_EMOTE_HERO_09_START	聖光會帶來勝利！	
GAMEPLAY_EMOTE_HERO_09_THANKS	謝謝你。	
GAMEPLAY_EMOTE_HERO_09_THANKS_DISABLED	哼！哼！	
GAMEPLAY_EMOTE_HERO_09_THINK1	嗯…	
GAMEPLAY_EMOTE_HERO_09_THINK2	我想想…	
GAMEPLAY_EMOTE_HERO_09_THINK3	我要考慮一下…	
GAMEPLAY_EMOTE_HERO_09_THREATEN	聖光會懲罰你！	
GAMEPLAY_EMOTE_HERO_09_THREATEN_DISABLED	嗯！哼！	
GAMEPLAY_EMOTE_HERO_09_TIMER	我得趕快選擇…	
GAMEPLAY_EMOTE_HERO_09_WELL_PLAYED	玩得不錯。	
GAMEPLAY_EMOTE_HERO_09_WELL_PLAYED_DISABLED	嗯哼…	
GAMEPLAY_EMOTE_HERO_09_WINTERVEIL_GREETINGS	冬幕節快樂！	
GAMEPLAY_EMOTE_HERO_09_WOW	太帥了！	
GAMEPLAY_EMOTE_HERO_09_WOW_DISABLED	嗯！哼！	
GAMEPLAY_EMOTE_HERO_TBKTRAF_KT_CONCEDE	我將捲土重來…	
GAMEPLAY_EMOTE_HERO_TBKTRAF_KT_GREETINGS	我們終於見面了。	
GAMEPLAY_EMOTE_HERO_TBKTRAF_KT_LOW_CARDS	我的牌快打光了！	
GAMEPLAY_EMOTE_HERO_TBKTRAF_KT_NO_CARDS	不！我詛咒你，闖入者！	
GAMEPLAY_EMOTE_HERO_TBKTRAF_KT_OOPS	看來又得重新計畫了…	
GAMEPLAY_EMOTE_HERO_TBKTRAF_KT_SORRY	抱歉啦， 嘿嘿嘿。	
GAMEPLAY_EMOTE_HERO_TBKTRAF_KT_START	面對我吧，闖入者。	
GAMEPLAY_EMOTE_HERO_TBKTRAF_KT_THANKS	喔呵！太感謝你了！	
GAMEPLAY_EMOTE_HERO_TBKTRAF_KT_THINK1	如果這樣呢？	
GAMEPLAY_EMOTE_HERO_TBKTRAF_KT_THINK2	很好，很好！	
GAMEPLAY_EMOTE_HERO_TBKTRAF_KT_THINK3	你覺得如何啊，畢勾沃斯？	
GAMEPLAY_EMOTE_HERO_TBKTRAF_KT_THREATEN	我要凍結你的每一滴血！	
GAMEPLAY_EMOTE_HERO_TBKTRAF_KT_WELL_PLAYED	唉喲！不錯喔！	
GAMEPLAY_EMOTE_HERO_TBKTRAF_RAF_CONCEDE	不！我不可能會輸！	
GAMEPLAY_EMOTE_HERO_TBKTRAF_RAF_GREETINGS	哈囉。	
GAMEPLAY_EMOTE_HERO_TBKTRAF_RAF_LOW_CARDS	我快要沒有牌了！	
GAMEPLAY_EMOTE_HERO_TBKTRAF_RAF_NO_CARDS	我的寶藏啊！	
GAMEPLAY_EMOTE_HERO_TBKTRAF_RAF_OOPS	出錯了！	
GAMEPLAY_EMOTE_HERO_TBKTRAF_RAF_SORRY	真可惜啊。	
GAMEPLAY_EMOTE_HERO_TBKTRAF_RAF_START	我是終極考古學家，拉法姆！	
GAMEPLAY_EMOTE_HERO_TBKTRAF_RAF_THANKS	謝謝你。	
GAMEPLAY_EMOTE_HERO_TBKTRAF_RAF_THINK1	嗯…	
GAMEPLAY_EMOTE_HERO_TBKTRAF_RAF_THINK2	哪張好呢…	
GAMEPLAY_EMOTE_HERO_TBKTRAF_RAF_THINK3	這個嘛…	
GAMEPLAY_EMOTE_HERO_TBKTRAF_RAF_THREATEN	見識無與倫比的力量！	
GAMEPLAY_EMOTE_HERO_TBKTRAF_RAF_WELL_PLAYED	打得不錯。	
GAMEPLAY_EMOTE_HERO_TBMECHWAR01_CONCEDE	<認輸>	The text is in brackets because the VO files is just Annoy-o-Tron's greeting
GAMEPLAY_EMOTE_HERO_TBMECHWAR01_ERROR_FULL_MINIONS	<錯誤！>	The text is in brackets because the VO files is just Annoy-o-Tron's greeting
GAMEPLAY_EMOTE_HERO_TBMECHWAR01_ERROR_HAND_FULL	<錯誤！>	The text is in brackets because the VO files is just Annoy-o-Tron's greeting
GAMEPLAY_EMOTE_HERO_TBMECHWAR01_ERROR_I_ATTACKED	<錯誤！>	The text is in brackets because the VO files is just Annoy-o-Tron's greeting
GAMEPLAY_EMOTE_HERO_TBMECHWAR01_ERROR_JUST_PLAYED	<錯誤！>	The text is in brackets because the VO files is just Annoy-o-Tron's greeting
GAMEPLAY_EMOTE_HERO_TBMECHWAR01_ERROR_MINION_ATTACKED	<錯誤！>	The text is in brackets because the VO files is just Annoy-o-Tron's greeting
GAMEPLAY_EMOTE_HERO_TBMECHWAR01_ERROR_NEED_MANA	<錯誤！>	The text is in brackets because the VO files is just Annoy-o-Tron's greeting
GAMEPLAY_EMOTE_HERO_TBMECHWAR01_ERROR_NEED_WEAPON	<錯誤！>	The text is in brackets because the VO files is just Annoy-o-Tron's greeting
GAMEPLAY_EMOTE_HERO_TBMECHWAR01_ERROR_PLAY	<錯誤！>	The text is in brackets because the VO files is just Annoy-o-Tron's greeting
GAMEPLAY_EMOTE_HERO_TBMECHWAR01_ERROR_STEALTH	<錯誤！>	The text is in brackets because the VO files is just Annoy-o-Tron's greeting
GAMEPLAY_EMOTE_HERO_TBMECHWAR01_ERROR_TARGET	<錯誤！>	The text is in brackets because the VO files is just Annoy-o-Tron's greeting
GAMEPLAY_EMOTE_HERO_TBMECHWAR01_ERROR_TAUNT	<錯誤！>	The text is in brackets because the VO files is just Annoy-o-Tron's greeting
GAMEPLAY_EMOTE_HERO_TBMECHWAR01_GREETINGS	<招呼>	The text is in brackets because the VO files is just Annoy-o-Tron's greeting
GAMEPLAY_EMOTE_HERO_TBMECHWAR01_LOW_CARDS	<牌數偏低>	The text is in brackets because the VO files is just Annoy-o-Tron's greeting
GAMEPLAY_EMOTE_HERO_TBMECHWAR01_NO_CARDS	<沒有牌了>	The text is in brackets because the VO files is just Annoy-o-Tron's greeting
GAMEPLAY_EMOTE_HERO_TBMECHWAR01_OOPS	<錯誤>	The text is in brackets because the VO files is just Annoy-o-Tron's greeting
GAMEPLAY_EMOTE_HERO_TBMECHWAR01_SORRY	<道歉>	The text is in brackets because the VO files is just Annoy-o-Tron's greeting
GAMEPLAY_EMOTE_HERO_TBMECHWAR01_START	<開始>	The text is in brackets because the VO files is just Annoy-o-Tron's greeting
GAMEPLAY_EMOTE_HERO_TBMECHWAR01_THANKS	<致謝>	The text is in brackets because the VO files is just Annoy-o-Tron's greeting
GAMEPLAY_EMOTE_HERO_TBMECHWAR01_THINK1	<處理中…>	The text is in brackets because the VO files is just Annoy-o-Tron's greeting
GAMEPLAY_EMOTE_HERO_TBMECHWAR01_THINK2	<取得目標…>	The text is in brackets because the VO files is just Annoy-o-Tron's greeting
GAMEPLAY_EMOTE_HERO_TBMECHWAR01_THINK3	<浪費運算週期…>	The text is in brackets because the VO files is just Annoy-o-Tron's greeting
GAMEPLAY_EMOTE_HERO_TBMECHWAR01_THREATEN	<威脅>	The text is in brackets because the VO files is just Annoy-o-Tron's attack
GAMEPLAY_EMOTE_HERO_TBMECHWAR01_TIMER	<時間不足>	The text is in brackets because the VO files is just Annoy-o-Tron's greeting
GAMEPLAY_EMOTE_HERO_TBMECHWAR01_WELL_PLAYED	<誇讚>	The text is in brackets because the VO files is just Annoy-o-Tron's greeting
GAMEPLAY_EMOTE_HERO_TBMECHWAR01_WOW	<真厲害！>	The text is in brackets because the VO files is just Annoy-o-Tron's greeting
GAMEPLAY_EMOTE_HERO_TBMECHWAR02_CONCEDE	<程式結束>	The text is in brackets because the VO files is just Boom Bot's greeting
GAMEPLAY_EMOTE_HERO_TBMECHWAR02_ERROR_FULL_MINIONS	<錯誤！>	The text is in brackets because the VO files is just Boom Bot's greeting
GAMEPLAY_EMOTE_HERO_TBMECHWAR02_ERROR_HAND_FULL	<錯誤！>	The text is in brackets because the VO files is just Boom Bot's greeting
GAMEPLAY_EMOTE_HERO_TBMECHWAR02_ERROR_I_ATTACKED	<錯誤！>	The text is in brackets because the VO files is just Boom Bot's greeting
GAMEPLAY_EMOTE_HERO_TBMECHWAR02_ERROR_JUST_PLAYED	<錯誤！>	The text is in brackets because the VO files is just Boom Bot's greeting
GAMEPLAY_EMOTE_HERO_TBMECHWAR02_ERROR_MINION_ATTACKED	<錯誤！>	The text is in brackets because the VO files is just Boom Bot's greeting
GAMEPLAY_EMOTE_HERO_TBMECHWAR02_ERROR_NEED_MANA	<錯誤！>	The text is in brackets because the VO files is just Boom Bot's greeting
GAMEPLAY_EMOTE_HERO_TBMECHWAR02_ERROR_NEED_WEAPON	<錯誤！>	The text is in brackets because the VO files is just Boom Bot's greeting
GAMEPLAY_EMOTE_HERO_TBMECHWAR02_ERROR_PLAY	<錯誤！>	The text is in brackets because the VO files is just Boom Bot's greeting
GAMEPLAY_EMOTE_HERO_TBMECHWAR02_ERROR_STEALTH	<錯誤！>	The text is in brackets because the VO files is just Boom Bot's greeting
GAMEPLAY_EMOTE_HERO_TBMECHWAR02_ERROR_TARGET	<錯誤！>	The text is in brackets because the VO files is just Boom Bot's greeting
GAMEPLAY_EMOTE_HERO_TBMECHWAR02_ERROR_TAUNT	<錯誤！>	The text is in brackets because the VO files is just Boom Bot's greeting
GAMEPLAY_EMOTE_HERO_TBMECHWAR02_GREETINGS	<招呼>	The text is in brackets because the VO files is just Annoy-o-Tron's greeting
GAMEPLAY_EMOTE_HERO_TBMECHWAR02_LOW_CARDS	<牌數偏低>	The text is in brackets because the VO files is just Boom Bot's greeting
GAMEPLAY_EMOTE_HERO_TBMECHWAR02_NO_CARDS	<沒有牌了！>	The text is in brackets because the VO files is just Boom Bot's greeting
GAMEPLAY_EMOTE_HERO_TBMECHWAR02_OOPS	<錯誤！>	The text is in brackets because the VO files is just Boom Bot's greeting
GAMEPLAY_EMOTE_HERO_TBMECHWAR02_SORRY	<致歉>	The text is in brackets because the VO files is just Boom Bot's greeting
GAMEPLAY_EMOTE_HERO_TBMECHWAR02_START	<啟動>	The text is in brackets because the VO files is just Boom Bot's greeting
GAMEPLAY_EMOTE_HERO_TBMECHWAR02_THANKS	<謝謝你>	The text is in brackets because the VO files is just Boom Bot's greeting
GAMEPLAY_EMOTE_HERO_TBMECHWAR02_THINK1	<處理中…>	The text is in brackets because the VO files is just Boom Bot's greeting
GAMEPLAY_EMOTE_HERO_TBMECHWAR02_THINK2	<取得目標…>	The text is in brackets because the VO files is just Boom Bot's greeting
GAMEPLAY_EMOTE_HERO_TBMECHWAR02_THINK3	<浪費運算週期…>	The text is in brackets because the VO files is just Boom Bot's greeting
GAMEPLAY_EMOTE_HERO_TBMECHWAR02_THREATEN	<威脅！>	The text is in brackets because the VO files is just Boom Bot's Attack sound
GAMEPLAY_EMOTE_HERO_TBMECHWAR02_TIMER	<時間不足>	The text is in brackets because the VO files is just Boom Bot's greeting
GAMEPLAY_EMOTE_HERO_TBMECHWAR02_WELL_PLAYED	<誇讚>	The text is in brackets because the VO files is just Boom Bot's greeting
GAMEPLAY_EMOTE_HERO_TBMECHWAR02_WOW	<太強了！>	The text is in brackets because the VO files is just Annoy-o-Tron's greeting
GAMEPLAY_EMOTE_ICC_481_CONCEDE	暫且享受你毫無意義的勝利吧。	
GAMEPLAY_EMOTE_ICC_481_GREETINGS	迎接死亡的冰冷擁抱。	
GAMEPLAY_EMOTE_ICC_481_LOW_CARDS	我快沒有牌了！	
GAMEPLAY_EMOTE_ICC_481_NO_CARDS	我沒有牌了！	
GAMEPLAY_EMOTE_ICC_481_OOPS	犯下大錯了。	
GAMEPLAY_EMOTE_ICC_481_START	為了末日錘！	
GAMEPLAY_EMOTE_ICC_481_THANKS	謝謝。	
GAMEPLAY_EMOTE_ICC_481_THINK1	嗯…	
GAMEPLAY_EMOTE_ICC_481_THINK2	元素不再指引我。	
GAMEPLAY_EMOTE_ICC_481_THINK3	我得自己做出選擇。	
GAMEPLAY_EMOTE_ICC_481_THREATEN	我會粉碎你！	
GAMEPLAY_EMOTE_ICC_481_TIMER	我得做出抉擇！	
GAMEPLAY_EMOTE_ICC_481_WELL_PLAYED	玩得不錯。	
GAMEPLAY_EMOTE_ICC_481_WOW	威猛。	
GAMEPLAY_EMOTE_ICC_827_CONCEDE	今天算你贏。	
GAMEPLAY_EMOTE_ICC_827_GREETINGS	你躲到哪裡去啦？	
GAMEPLAY_EMOTE_ICC_827_LOW_CARDS	我快沒有牌了！	
GAMEPLAY_EMOTE_ICC_827_NO_CARDS	我沒有牌了！	
GAMEPLAY_EMOTE_ICC_827_OOPS	太慘了…	
GAMEPLAY_EMOTE_ICC_827_START	你要小心點。	
GAMEPLAY_EMOTE_ICC_827_THANKS	謝謝你。	
GAMEPLAY_EMOTE_ICC_827_THINK1	嗯…	
GAMEPLAY_EMOTE_ICC_827_THINK2	死亡的陰影在擴散…	
GAMEPLAY_EMOTE_ICC_827_THINK3	時間就這麼過去了…	
GAMEPLAY_EMOTE_ICC_827_THREATEN	你會害怕你自己的影子。	
GAMEPLAY_EMOTE_ICC_827_TIMER	我必須趕快選擇！	
GAMEPLAY_EMOTE_ICC_827_WELL_PLAYED	真不錯。	
GAMEPLAY_EMOTE_ICC_827_WOW	太不真實了！	
GAMEPLAY_EMOTE_ICC_828_CONCEDE	這場狩獵，算你贏。	
GAMEPLAY_EMOTE_ICC_828_GREETINGS	快逃吧，獵物！	
GAMEPLAY_EMOTE_ICC_828_LOW_CARDS	我快沒有牌了！	
GAMEPLAY_EMOTE_ICC_828_NO_CARDS	我沒有牌了！	
GAMEPLAY_EMOTE_ICC_828_OOPS	失誤了。	
GAMEPLAY_EMOTE_ICC_828_START	狩獵開始了！	
GAMEPLAY_EMOTE_ICC_828_THANKS	謝謝。	
GAMEPLAY_EMOTE_ICC_828_THINK1	嗯…	
GAMEPLAY_EMOTE_ICC_828_THINK2	要追蹤哪個足跡呢…	
GAMEPLAY_EMOTE_ICC_828_THINK3	我想想…	
GAMEPLAY_EMOTE_ICC_828_THREATEN	我會獵殺你…到天涯海角！	
GAMEPLAY_EMOTE_ICC_828_TIMER	氣味快消散了！	
GAMEPLAY_EMOTE_ICC_828_WELL_PLAYED	玩得不錯。	
GAMEPLAY_EMOTE_ICC_828_WOW	厲害。	
GAMEPLAY_EMOTE_ICC_829_CONCEDE	這次，算你贏了。	
GAMEPLAY_EMOTE_ICC_829_GREETINGS	只有我的正義。	
GAMEPLAY_EMOTE_ICC_829_LOW_CARDS	我快沒有牌了！	
GAMEPLAY_EMOTE_ICC_829_NO_CARDS	我沒有牌了！	
GAMEPLAY_EMOTE_ICC_829_OOPS	真是失望。	
GAMEPLAY_EMOTE_ICC_829_START	我會以榮耀作戰。	
GAMEPLAY_EMOTE_ICC_829_THANKS	謝謝你。	
GAMEPLAY_EMOTE_ICC_829_THINK1	嗯…	
GAMEPLAY_EMOTE_ICC_829_THINK2	霜之哀傷在呼喚…	
GAMEPLAY_EMOTE_ICC_829_THINK3	冰封王座在呼喚我…	
GAMEPLAY_EMOTE_ICC_829_THREATEN	求饒吧，但我不會理你。	
GAMEPLAY_EMOTE_ICC_829_TIMER	末日即將來臨了！	
GAMEPLAY_EMOTE_ICC_829_WELL_PLAYED	玩得不錯。	
GAMEPLAY_EMOTE_ICC_829_WOW	真不敢相信！	
GAMEPLAY_EMOTE_ICC_830_CONCEDE	哼！你的勝利毫無意義！	
GAMEPLAY_EMOTE_ICC_830_GREETINGS	全然的黑暗，就是我的復仇。	
GAMEPLAY_EMOTE_ICC_830_LOW_CARDS	我快要沒有牌了！	
GAMEPLAY_EMOTE_ICC_830_NO_CARDS	我沒有牌了！	
GAMEPLAY_EMOTE_ICC_830_OOPS	人性充滿瑕疵。	
GAMEPLAY_EMOTE_ICC_830_START	黑暗會獲得勝利。	
GAMEPLAY_EMOTE_ICC_830_THANKS	謝謝你。	
GAMEPLAY_EMOTE_ICC_830_THINK1	嗯…	
GAMEPLAY_EMOTE_ICC_830_THINK2	黑暗在向我傾訴。	
GAMEPLAY_EMOTE_ICC_830_THINK3	暗影在低語…	
GAMEPLAY_EMOTE_ICC_830_THREATEN	黑暗會吞噬你！	
GAMEPLAY_EMOTE_ICC_830_TIMER	暗影正在消散…	
GAMEPLAY_EMOTE_ICC_830_WELL_PLAYED	玩得不錯。	
GAMEPLAY_EMOTE_ICC_830_WOW	超乎常理！	
GAMEPLAY_EMOTE_ICC_831_CONCEDE	這次…算你贏。	
GAMEPLAY_EMOTE_ICC_831_GREETINGS	恐懼吧。	
GAMEPLAY_EMOTE_ICC_831_LOW_CARDS	我快沒有牌了！	
GAMEPLAY_EMOTE_ICC_831_NO_CARDS	我沒有牌了！	
GAMEPLAY_EMOTE_ICC_831_OOPS	那毫無意義。	
GAMEPLAY_EMOTE_ICC_831_START	你的靈魂屬於我！	
GAMEPLAY_EMOTE_ICC_831_THANKS	謝謝你。	
GAMEPLAY_EMOTE_ICC_831_THINK1	嗯…	
GAMEPLAY_EMOTE_ICC_831_THINK2	我的渴望愈來越強…	
GAMEPLAY_EMOTE_ICC_831_THINK3	好多殘酷的選擇…	
GAMEPLAY_EMOTE_ICC_831_THREATEN	面對…傳說級的苦難！	
GAMEPLAY_EMOTE_ICC_831_TIMER	滿足我的饑渴！	
GAMEPLAY_EMOTE_ICC_831_WELL_PLAYED	做得很好。	
GAMEPLAY_EMOTE_ICC_831_WOW	地獄之火啊！	
GAMEPLAY_EMOTE_ICC_832_CONCEDE	你贏了，我可以安息了。	
GAMEPLAY_EMOTE_ICC_832_GREETINGS	腐朽的循環開始了。	
GAMEPLAY_EMOTE_ICC_832_LOW_CARDS	我快沒有牌了！	
GAMEPLAY_EMOTE_ICC_832_NO_CARDS	我沒有牌了！	
GAMEPLAY_EMOTE_ICC_832_OOPS	計畫出錯了。	
GAMEPLAY_EMOTE_ICC_832_START	生命的循環終結了。	
GAMEPLAY_EMOTE_ICC_832_THANKS	感謝你。	
GAMEPLAY_EMOTE_ICC_832_THINK1	嗯…	
GAMEPLAY_EMOTE_ICC_832_THINK2	糾結的念頭…	
GAMEPLAY_EMOTE_ICC_832_THINK3	我的意念被汙染了	
GAMEPLAY_EMOTE_ICC_832_THREATEN	你會腐爛生蛆！	
GAMEPLAY_EMOTE_ICC_832_TIMER	死亡是永恆的，但這回合不是！	
GAMEPLAY_EMOTE_ICC_832_WELL_PLAYED	厲害。	
GAMEPLAY_EMOTE_ICC_832_WOW	令人震驚！	
GAMEPLAY_EMOTE_ICC_833_CONCEDE	我向你的力量屈服。	
GAMEPLAY_EMOTE_ICC_833_GREETINGS	你在發抖…你怕了嗎？	
GAMEPLAY_EMOTE_ICC_833_LOW_CARDS	我快沒有牌了！	
GAMEPLAY_EMOTE_ICC_833_NO_CARDS	我沒有牌了！	
GAMEPLAY_EMOTE_ICC_833_OOPS	致命的錯誤。	
GAMEPLAY_EMOTE_ICC_833_START	這是你自找的！	
GAMEPLAY_EMOTE_ICC_833_THANKS	謝謝你。	
GAMEPLAY_EMOTE_ICC_833_THINK1	嗯…	
GAMEPLAY_EMOTE_ICC_833_THINK2	冰都要融了…	
GAMEPLAY_EMOTE_ICC_833_THINK3	嗯，我得決定了…	
GAMEPLAY_EMOTE_ICC_833_THREATEN	向你的女王臣服吧！	
GAMEPLAY_EMOTE_ICC_833_TIMER	時間要到了！	
GAMEPLAY_EMOTE_ICC_833_WELL_PLAYED	玩得不錯。	
GAMEPLAY_EMOTE_ICC_833_WOW	太感…凍了！	
GAMEPLAY_EMOTE_ICC_834_CONCEDE	我選擇死亡。	
GAMEPLAY_EMOTE_ICC_834_GREETINGS	你逃不過我的怒火！	
GAMEPLAY_EMOTE_ICC_834_LOW_CARDS	我快沒有牌了！	
GAMEPLAY_EMOTE_ICC_834_NO_CARDS	我沒有牌了！	
GAMEPLAY_EMOTE_ICC_834_OOPS	出錯了。	
GAMEPLAY_EMOTE_ICC_834_START	勝利或死亡！	
GAMEPLAY_EMOTE_ICC_834_THANKS	謝謝。	
GAMEPLAY_EMOTE_ICC_834_THINK1	嗯…	
GAMEPLAY_EMOTE_ICC_834_THINK2	時間…	
GAMEPLAY_EMOTE_ICC_834_THINK3	現在呢…	
GAMEPLAY_EMOTE_ICC_834_THREATEN	下跪求饒吧…	
GAMEPLAY_EMOTE_ICC_834_TIMER	我必須選擇！	
GAMEPLAY_EMOTE_ICC_834_WELL_PLAYED	夠格的敵人！	
GAMEPLAY_EMOTE_ICC_834_WOW	令人震驚！	
VO_Arthas_Male_Human_Attack_01	剷除一切邪惡！	
VO_Arthas_Male_Human_CONCEDE_01	戰鬥結束。你贏了。	
VO_Arthas_Male_Human_ERROR_FULL_MINIONS_01	我的手下太多了！	
VO_Arthas_Male_Human_ERROR_GENERIC_01	我不能這麼做。	
VO_Arthas_Male_Human_ERROR_HAND_FULL_01	我的手牌太多了！	
VO_Arthas_Male_Human_ERROR_I_ATTACKED_01	我已經攻擊過了。	
VO_Arthas_Male_Human_ERROR_JUST_PLAYED_01	等一個回合那個手下才能攻擊。	
VO_Arthas_Male_Human_ERROR_MINION_ATTACKED_01	那個手下已經攻擊過了。	
VO_Arthas_Male_Human_ERROR_NEED_MANA_01	我沒有足夠的法力。	
VO_Arthas_Male_Human_ERROR_NEED_WEAPON_01	我需要武器。	
VO_Arthas_Male_Human_ERROR_PLAY_01	我不能打這張牌。	
VO_Arthas_Male_Human_ERROR_STEALTH_01	我不能指定潛行的手下。	
VO_Arthas_Male_Human_ERROR_TARGET_01	那不是有效的目標。	
VO_Arthas_Male_Human_ERROR_TAUNT_01	必須先攻擊有嘲諷的手下。	
VO_Arthas_Male_Human_FIRE_FESTIVAL_01	升起火堆！	
VO_Arthas_Male_Human_GREETINGS_01	你好，很高興見到你。	
VO_Arthas_Male_Human_HAPPY_HALLOWEEN_01	萬鬼節快樂…	
VO_Arthas_Male_Human_HAPPY_HOLIDAYS_01	冬幕節快樂，朋友！	
VO_Arthas_Male_Human_HAPPY_NEW_YEAR_01	新年快樂！	
VO_Arthas_Male_Human_HAPPY_NEW_YEAR_LUNAR_01	新春愉快！	
VO_Arthas_Male_Human_HAPPY_NOBLEGARDEN	歡慶貴族花園。	
VO_Arthas_Male_Human_LOW_CARDS_01	我快要沒有牌了！	
VO_Arthas_Male_Human_MIRROR_GREETINGS_01	的確，我也是。	
VO_Arthas_Male_Human_MIRROR_START_01	為了父王！	
VO_Arthas_Male_Human_NO_CARDS_01	我沒有牌了！	
VO_Arthas_Male_Human_OOPS_01	失策了。	
VO_Arthas_Male_Human_PIRATE_DAY_01	我是呀啊～薩斯。	
VO_Arthas_Male_Human_SORRY_01	請接受我誠摯的道歉，朋友。	
VO_Arthas_Male_Human_START_01	為了羅德隆！	
VO_Arthas_Male_Human_THANKS_01	由衷感謝。	
VO_Arthas_Male_Human_THINK1_01	嗯…	
VO_Arthas_Male_Human_THINK2_01	未來的路…該怎麼走…	
VO_Arthas_Male_Human_THINK3_01	烏瑟會怎麼做…	
VO_Arthas_Male_Human_THREATEN_01	你已無可救藥。	
VO_Arthas_Male_Human_TIMER_01	我得立刻行動！	
VO_Arthas_Male_Human_WELL_PLAYED_01	玩得不錯。	
VO_Arthas_Male_Human_WOW_01	聖光啊！	
VO_BRM_027h__LUNAR_NEW_YEAR	新春愉快！	
VO_BRM_027h_Attack_15	感受薩弗隆的烈焰吧！	
VO_BRM_027h_Concede_11	你贏了。打得好！	
VO_BRM_027h_Emote_Start	我會報仇的，黑龍！	
VO_BRM_027h_ERROR01_51	我需要武器。	
VO_BRM_027h_ERROR02_52	法力不足。	
VO_BRM_027h_ERROR03_53	他已經攻擊過了。	
VO_BRM_027h_ERROR04_54	我已經攻擊過了！	
VO_BRM_027h_ERROR05_55	凡人需要等一個回合才能攻擊。	
VO_BRM_027h_ERROR06_56	太多卡片了。	
VO_BRM_027h_ERROR07_57	太多手下了！	
VO_BRM_027h_ERROR08_58	他是潛行的手下。	
VO_BRM_027h_ERROR09_59	不能這樣出牌。	
VO_BRM_027h_ERROR10_60	不能這麼做。	
VO_BRM_027h_ERROR11_61	那個有嘲諷的手下擋住我了。	
VO_BRM_027h_ERROR12_62	不能這麼做！	
VO_BRM_027h_FIRE_FESTIVAL	這是屬於我的慶典！	
VO_BRM_027h_GG_16	打得漂亮！	
VO_BRM_027h_Greetings_04	讓火焰淨化一切！	
VO_BRM_027h_HALLOWS_END	萬鬼節快樂！	
VO_BRM_027h_HAPPY_NEW_YEAR_38	我要讓新年在火焰中燃燒！	
VO_BRM_027h_LowCards_49	我的卡片都快燒光啦。	
VO_BRM_027h_NOBLEGARDEN	貴族花園節快樂！	
VO_BRM_027h_NoCards_50	我的卡片全燒光啦。	
VO_BRM_027h_Oops_07	啊！出錯了！	
VO_BRM_027h_PIRATE_DAY	看好了，我是火焰之王！	
VO_BRM_027h_Sorry_10	抱歉。	
VO_BRM_027h_Thanks_09	致上灼熱的謝意。	
VO_BRM_027h_Thinking1_12	嗯…	
VO_BRM_027h_Thinking2_13	我想想…	
VO_BRM_027h_Thinking3_14	要先燒誰好呢…	
VO_BRM_027h_Threaten_08	你會在火焰中滅亡！	
VO_BRM_027h_Time_48	時間的引信正在燃燒！	
VO_BRM_027h_Well_Played_06	這手漂亮！	
VO_BRM_027h_Winterveil_Greetings	冬天應該要暖和一點才對。	
VO_BRM_027h_WOW_20	哇！	
VO_EX1_323h_HAPPY_NEW_YEAR_13	新年快樂！	
VO_GIL_504_Female_Orc_Concede_01	這次你贏了。	
VO_GIL_504_Female_Orc_Greetings_02	歡迎來到我的地盤。	
VO_GIL_504_Female_Orc_LowCards_01	我快要沒有牌了！	
VO_GIL_504_Female_Orc_NoCards_01	我沒有牌了！	
VO_GIL_504_Female_Orc_Oops_01	不明智啊。	
VO_GIL_504_Female_Orc_Start_01	夜晚的森林很危險。	
VO_GIL_504_Female_Orc_Thanks_01	謝謝你。	
VO_GIL_504_Female_Orc_Thinking_01	嗯…	
VO_GIL_504_Female_Orc_Thinking_02	真是困擾。	
VO_GIL_504_Female_Orc_Thinking_03	道路昏暗不明…	
VO_GIL_504_Female_Orc_Threaten_02	我會詛咒你！	
VO_GIL_504_Female_Orc_Time_01	我必須決定！	
VO_GIL_504_Female_Orc_Well_Played_01	玩得不錯。	
VO_GIL_504_Female_Orc_Wow_01	漆黑的暗夜啊！	
VO_GILA_400h_Male_Human_Concede_01	我對付不了你。	
VO_GILA_400h_Male_Human_Death_02	*慘叫*	
VO_GILA_400h_Male_Human_ERROR_FULL_MINIONS_01	已經沒有地方了。	
VO_GILA_400h_Male_Human_ERROR_GENERIC_01	我不能這麼做。	
VO_GILA_400h_Male_Human_ERROR_GENERIC_04	我就是辦不到。	
VO_GILA_400h_Male_Human_ERROR_HAND_FULL_01	我的手牌太多了！	
VO_GILA_400h_Male_Human_ERROR_I_ATTACKED_01	我已經攻擊過了。	
VO_GILA_400h_Male_Human_ERROR_MINION_ATTACKED_01	那個手下已經攻擊過了。	
VO_GILA_400h_Male_Human_ERROR_NEED_MANA_02	我沒有足夠的法力！	
VO_GILA_400h_Male_Human_ERROR_NEED_WEAPON_02	我需要武器！	
VO_GILA_400h_Male_Human_ERROR_STEALTH_01	那是潛行的！	
VO_GILA_400h_Male_Human_ERROR_SUMMON_SICKNESS_01	那個手下還沒準備好。	
VO_GILA_400h_Male_Human_ERROR_TARGET_01	我沒辦法指定那個目標。	
VO_GILA_400h_Male_Human_ERROR_TAUNT_01	有個嘲諷手下擋住我們。	
VO_GILA_400h_Male_Human_Greetings_01	我不喜歡你。我的狗也不喜歡你。	
VO_GILA_400h_Male_Human_LowCards_01	我快沒有牌了…	
VO_GILA_400h_Male_Human_NoCards_01	我沒牌了！	
VO_GILA_400h_Male_Human_Oops_01	真是糟糕。	
VO_GILA_400h_Male_Human_Sorry_01	很抱歉。	
VO_GILA_400h_Male_Human_Start_01	看看我的小狗找到了什麼。	
VO_GILA_400h_Male_Human_Thanks_01	謝謝你。	
VO_GILA_400h_Male_Human_Thinking_01	嗯...	
VO_GILA_400h_Male_Human_Thinking_03	得好好想一想…	
VO_GILA_400h_Male_Human_Thinking_04	快想，快想…	
VO_GILA_400h_Male_Human_Threaten_04	你最好趕緊裝死。	
VO_GILA_400h_Male_Human_Time_01	時間不多了。	
VO_GILA_400h_Male_Human_Well_Played_01	還不賴啊。	
VO_GILA_400h_Male_Human_WOW_01	厲害！	
VO_GILA_500h3_Female_Human_Concede_01	我無法擊敗你。	
VO_GILA_500h3_Female_Human_ERROR_FULL_MINIONS_01	沒有足夠的空間了。	
VO_GILA_500h3_Female_Human_ERROR_GENERIC_04	不能夠這麼做！	
VO_GILA_500h3_Female_Human_ERROR_HAND_FULL_02	我的手牌已經滿了！	
VO_GILA_500h3_Female_Human_ERROR_I_ATTACKED_02	我不能攻擊兩次。	
VO_GILA_500h3_Female_Human_ERROR_MINION_ATTACKED_01	我的手下已經攻擊過了。	
VO_GILA_500h3_Female_Human_ERROR_NEED_MANA_02	我沒有足夠的法力。	
VO_GILA_500h3_Female_Human_ERROR_NEED_WEAPON_02	我得要有武器！	
VO_GILA_500h3_Female_Human_ERROR_PLAY_01	我不能打這張牌。	
VO_GILA_500h3_Female_Human_ERROR_STEALTH_01	我找不到目標！	
VO_GILA_500h3_Female_Human_ERROR_SUMMON_SICKNESS_01	那個手下還沒準備好。	
VO_GILA_500h3_Female_Human_ERROR_TARGET_01	我沒辦法指定那個目標。	
VO_GILA_500h3_Female_Human_ERROR_TAUNT_01	必須先攻擊有嘲諷的手下。	
VO_GILA_500h3_Female_Human_Greetings_01	無冕者向你致意。	
VO_GILA_500h3_Female_Human_LowCards_01	我剩沒幾張牌了…	
VO_GILA_500h3_Female_Human_NoCards_01	我沒有牌了！	
VO_GILA_500h3_Female_Human_Oops_02	那是個…意外。	
VO_GILA_500h3_Female_Human_Sorry_01	真不好意思。	
VO_GILA_500h3_Female_Human_Start_01	線索把我一路帶到這裡。	
VO_GILA_500h3_Female_Human_Thanks_01	謝謝你。	
VO_GILA_500h3_Female_Human_Thinking_02	一定會有辦法…	
VO_GILA_500h3_Female_Human_Thinking_03	快想啊，泰絲，快想啊。	
VO_GILA_500h3_Female_Human_Thinking_05	啊…嗯…	
VO_GILA_500h3_Female_Human_Threaten_03	我會消滅你！	
VO_GILA_500h3_Female_Human_Time_01	我得趕快行動。	
VO_GILA_500h3_Female_Human_Well_Played_01	優秀的策略。	
VO_GILA_500h3_Female_Human_WOW_01	真是太驚人了。	
VO_GILA_600h_Male_Worgen_Concede_01	我竟然輸給你了。	
VO_GILA_600h_Male_Worgen_ERROR_FULL_MINIONS_02	戰場上的手下太多了。	
VO_GILA_600h_Male_Worgen_ERROR_GENERIC_01	辦不到。	
VO_GILA_600h_Male_Worgen_ERROR_GENERIC_02	我不能這麼做。	
VO_GILA_600h_Male_Worgen_ERROR_HAND_FULL_01	太多張牌了！	
VO_GILA_600h_Male_Worgen_ERROR_I_ATTACKED_01	我已經攻擊過了。	
VO_GILA_600h_Male_Worgen_ERROR_MINION_ATTACKED_01	那個手下已經攻擊過了。	
VO_GILA_600h_Male_Worgen_ERROR_NEED_MANA_01	我沒有法力。	
VO_GILA_600h_Male_Worgen_ERROR_NEED_WEAPON_02	我需要武器。	
VO_GILA_600h_Male_Worgen_ERROR_STEALTH_01	那個手下躲起來了！	
VO_GILA_600h_Male_Worgen_ERROR_SUMMON_SICKNESS_01	他們還沒準備好展開攻擊。	
VO_GILA_600h_Male_Worgen_ERROR_TARGET_01	我沒辦法指定那個目標。	
VO_GILA_600h_Male_Worgen_ERROR_TAUNT_01	必須先攻擊有嘲諷的手下。	
VO_GILA_600h_Male_Worgen_Greetings_01	跟我的大炮打聲招呼吧。	
VO_GILA_600h_Male_Worgen_LowCards_01	我快要沒牌了！	
VO_GILA_600h_Male_Worgen_NoCards_01	我已經沒有牌了！	
VO_GILA_600h_Male_Worgen_Oops_01	錯了！	
VO_GILA_600h_Male_Worgen_Sorry_01	我很…抱歉。	
VO_GILA_600h_Male_Worgen_Start_01	我已經準備就緒。	
VO_GILA_600h_Male_Worgen_Thanks_01	謝謝你。	
VO_GILA_600h_Male_Worgen_Thinking_01	嗯...	
VO_GILA_600h_Male_Worgen_Thinking_02	我的下一步是…	
VO_GILA_600h_Male_Worgen_Thinking_04	我一定會找到出路…	
VO_GILA_600h_Male_Worgen_Threaten_01	我要把你轟成碎片！	
VO_GILA_600h_Male_Worgen_Time_01	不要催我！	
VO_GILA_600h_Male_Worgen_Well_Played_01	相當出色。	
VO_GILA_600h_Male_Worgen_WOW_01	真不敢相信！	
VO_GILA_900h_Female_Gnome_Concede_01	我什麼招都試了。還是你贏！	
VO_GILA_900h_Female_Gnome_ERROR_FULL_MINIONS_02	我不能再叫手下了。	
VO_GILA_900h_Female_Gnome_ERROR_GENERIC_01	我不能這麼做。	
VO_GILA_900h_Female_Gnome_ERROR_HAND_FULL_01	我的手牌太多了！	
VO_GILA_900h_Female_Gnome_ERROR_I_ATTACKED_02	我不能再攻擊啦。	
VO_GILA_900h_Female_Gnome_ERROR_MINION_ATTACKED_01	那個手下已經攻擊過了。	
VO_GILA_900h_Female_Gnome_ERROR_NEED_MANA_01	法力不足！	
VO_GILA_900h_Female_Gnome_ERROR_NEED_WEAPON_01	我沒有武器。	
VO_GILA_900h_Female_Gnome_ERROR_PLAY_01	就算是我也不能打這張牌。	
VO_GILA_900h_Female_Gnome_ERROR_STEALTH_01	那是潛行的目標。	
VO_GILA_900h_Female_Gnome_ERROR_SUMMON_SICKNESS_01	那個手下需要時間做好準備。	
VO_GILA_900h_Female_Gnome_ERROR_TARGET_01	沒辦法指定那個目標。	
VO_GILA_900h_Female_Gnome_ERROR_TAUNT_01	必須先攻擊有嘲諷的手下。	
VO_GILA_900h_Female_Gnome_GG_01	真是精采的對戰！	
VO_GILA_900h_Female_Gnome_Greetings_01	喔，哈囉，又是你。	
VO_GILA_900h_Female_Gnome_LowCards_01	剩沒多少張牌了…	
VO_GILA_900h_Female_Gnome_NoCards_01	我沒有牌了！	
VO_GILA_900h_Female_Gnome_Oops_02	我好像犯錯了。	
VO_GILA_900h_Female_Gnome_Sorry_01	呃，抱歉？	
VO_GILA_900h_Female_Gnome_Start_01	你的時間結束了！	
VO_GILA_900h_Female_Gnome_Thanks_01	謝謝。	
VO_GILA_900h_Female_Gnome_Thinking_02	嗯…	
VO_GILA_900h_Female_Gnome_Thinking_03	…要從四度空間思考才行…	
VO_GILA_900h_Female_Gnome_Thinking_05	時間的齒輪正在轉動…	
VO_GILA_900h_Female_Gnome_Threaten_01	我要把你從時間線擦掉。	
VO_GILA_900h_Female_Gnome_Time_01	我～怎麼可能會沒有～時間呢？	
VO_GILA_900h_Female_Gnome_Well_Played_01	表現得比我還好。	
VO_GILA_900h_Female_Gnome_WOW_02	不可思議！	
VO_HERO_01_HAPPY_NEW_YEAR_06	新年快樂！	
VO_HERO_02_HAPPY_NEW_YEAR_07	新年快樂，朋友！	
VO_HERO_03_HAPPY_NEW_YEAR_06	新年快樂！	
VO_HERO_03a_Attack_15	我就是正義！	
VO_HERO_03a_CONCEDE_06	打得好，我認輸。	
VO_HERO_03a_ERROR_FULL_MINIONS_25	我的手下太多了。	
VO_HERO_03a_ERROR_GENERIC_30	我不能這麼做。	
VO_HERO_03a_ERROR_HAND_FULL_24	我的手牌太多了！	
VO_HERO_03a_ERROR_I_ATTACKED_22	我已經攻擊過了。	
VO_HERO_03a_ERROR_JUST_PLAYED_23	等一個回合那個手下才能攻擊。	
VO_HERO_03a_ERROR_MINION_ATTACKED_21	那個手下已經攻擊過了。	
VO_HERO_03a_ERROR_NEED_MANA_20	我沒有足夠的法力。	
VO_HERO_03a_ERROR_NEED_WEAPON_19	我需要武器。	
VO_HERO_03a_ERROR_PLAY_27	我不能打這張牌。	
VO_HERO_03a_ERROR_STEALTH_26	我不能指定潛行的手下。	
VO_HERO_03a_ERROR_TARGET_28	那不是有效的目標。	
VO_HERO_03a_ERROR_TAUNT_29	必須先攻擊有嘲諷的手下。	
VO_HERO_03a_FIRE_FESTIVAL	仲夏節快樂！	
VO_HERO_03a_GREETINGS_03	嗨，朋友。	
VO_HERO_03a_HALLOWS_END	萬鬼節快樂！	
VO_HERO_03a_HAPPY_HOLIDAYS_52	冬幕節快樂！	
VO_HERO_03a_HAPPY_NEW_YEAR_53	新年快樂！	
VO_HERO_03a_LOW_CARDS_17	我快沒有牌了！	
VO_HERO_03a_MIRROR_GREETINGS_04	真是驚喜，你好啊！	
VO_HERO_03a_MIRROR_START_02	我就是正義的化身。	
VO_HERO_03a_NO_CARDS_18	我沒有牌了！	
VO_HERO_03a_NOBLEGARDEN	歡慶貴族花園…彩蛋呢？	
VO_HERO_03a_OOPS_08	錯誤的戰術。	
VO_HERO_03a_PICKED_11	時候到了！	
VO_HERO_03a_PIRATE_DAY	呀呃！	
VO_HERO_03a_SORRY_10	抱歉。	
VO_HERO_03a_START_01	沒人能逃離我的追捕。	
VO_HERO_03a_THANKS_09	謝謝你。	
VO_HERO_03a_THINK1_12	嗯…	
VO_HERO_03a_THINK2_13	嗯…我想想…	
VO_HERO_03a_THINK3_14	我要考慮一下…	
VO_HERO_03a_THREATEN_05	你讓我發火了！	
VO_HERO_03a_TIMER_16	快點！	
VO_HERO_03a_WELL_PLAYED_07	玩得不錯。	
VO_HERO_03a_WOW_35	真驚人！	
VO_HERO_04_HAPPY_NEW_YEAR_15	新年快樂，勇士！	
VO_HERO_05_HAPPY_NEW_YEAR_15	新年快樂！	
VO_HERO_06_HAPPY_NEW_YEAR_15	新年快樂！	
VO_HERO_07_HAPPY_NEW_YEAR_15	新年快樂！	
VO_HERO_08_HAPPY_NEW_YEAR_15	新年快樂！	
VO_HERO_08b_HAPPY_NEW_YEAR_53	新年快樂！	
VO_HERO_09_HAPPY_NEW_YEAR_15	新年快樂！	
VO_HERO_09a_Attack_15	為了伊露恩！	
VO_HERO_09a_CONCEDE_06	結束了，你贏了。	
VO_HERO_09a_ERROR_FULL_MINIONS_25	我的手下太多了！	
VO_HERO_09a_ERROR_GENERIC_30	我不能這麼做。	
VO_HERO_09a_ERROR_HAND_FULL_24	我的手牌太多了！	
VO_HERO_09a_ERROR_I_ATTACKED_22	我已經攻擊過了。	
VO_HERO_09a_ERROR_JUST_PLAYED_23	等一個回合那個手下才能攻擊。	
VO_HERO_09a_ERROR_MINION_ATTACKED_21	那個手下已經攻擊過了。	
VO_HERO_09a_ERROR_NEED_MANA_20	我沒有足夠的法力。	
VO_HERO_09a_ERROR_NEED_WEAPON_19	我需要武器。	
VO_HERO_09a_ERROR_PLAY_27	我不能打這張牌。	
VO_HERO_09a_ERROR_STEALTH_26	我不能指定潛行的手下。	
VO_HERO_09a_ERROR_TARGET_28	那不是有效的目標。	
VO_HERO_09a_ERROR_TAUNT_29	必須先攻擊有嘲諷的手下。	
VO_HERO_09a_FIRE_FESTIVAL	仲夏節快樂！	
VO_HERO_09a_GREETINGS_03	祝福你。	
VO_HERO_09a_HALLOWS_END	萬鬼節快樂！	
VO_HERO_09a_HAPPY_HOLIDAYS_52	冬幕節快樂！	
VO_HERO_09a_HAPPY_NEW_YEAR_01	新年快樂！	
VO_HERO_09a_HAPPY_NEW_YEAR_LUNAR_53	新年快樂！	
VO_HERO_09a_LOW_CARDS_17	我快沒有牌了！	
VO_HERO_09a_MIRROR_GREETINGS_04	也祝福你。	
VO_HERO_09a_MIRROR_START_02	女神會保護我。	
VO_HERO_09a_NO_CARDS_18	我沒有牌了！	
VO_HERO_09a_NOBLEGARDEN	歡慶貴族花園。	
VO_HERO_09a_OOPS_08	這是個錯誤。	
VO_HERO_09a_PICKED_11	女神在呼喚我。	
VO_HERO_09a_PIRATE_DAY	真言術：呀啊！	
VO_HERO_09a_SORRY_10	原諒我。	
VO_HERO_09a_START_01	伊露恩賜我力量。	
VO_HERO_09a_START_MALFURION	親愛的瑪法里恩！	
VO_HERO_09a_THANKS_09	謝謝你。	
VO_HERO_09a_THINK1_12	嗯…	
VO_HERO_09a_THINK2_13	我想想…	
VO_HERO_09a_THINK3_14	伊露恩的旨意是什麼呢…	
VO_HERO_09a_THREATEN_05	你會後悔的！	
VO_HERO_09a_TIMER_16	動作快點！	
VO_HERO_09a_WELL_PLAYED_07	玩得不錯。	
VO_HERO_09a_WOW_10	太棒了！	
VO_HERO_11_HAPPY_NEW_YEAR_20	新年快樂！	
VO_HERO_12_HAPPY_NEW_YEAR_20	新年快樂！	
VO_HERO_13_HAPPY_NEW_YEAR_20	新年快樂！	
VO_HERO_14_HAPPY_NEW_YEAR_20	新年快樂！	
VO_HERO_15_HAPPY_NEW_YEAR_24	<新年快樂！>	
VO_HERO_16_Female_Dryad_Concede_01	我贏不了他們…	
VO_HERO_16_Female_Dryad_ERROR_01	我沒有武器。	
VO_HERO_16_Female_Dryad_ERROR_02	我需要更多法力！	
VO_HERO_16_Female_Dryad_ERROR_03	這個手下無法再攻擊了！	
VO_HERO_16_Female_Dryad_ERROR_04	我已經攻擊過了。	
VO_HERO_16_Female_Dryad_ERROR_05	那個手下還不能攻擊。	
VO_HERO_16_Female_Dryad_ERROR_06	我的手牌滿了！	
VO_HERO_16_Female_Dryad_ERROR_07	我的手下太多了！	
VO_HERO_16_Female_Dryad_ERROR_08	那個膽小的手下躲起來了。	
VO_HERO_16_Female_Dryad_ERROR_09	我不能這麼做。	
VO_HERO_16_Female_Dryad_ERROR_10	辦不到。	
VO_HERO_16_Female_Dryad_ERROR_11	必須先攻擊有嘲諷的手下。	
VO_HERO_16_Female_Dryad_ERROR_12	無法這麼做	
VO_HERO_16_Female_Dryad_FIRE_FESTIVAL_01	我喜歡仲夏節！	
VO_HERO_16_Female_Dryad_Greetings_01	大自然祝福你。	
VO_HERO_16_Female_Dryad_HAPPY_HALLOWEEN_01	萬鬼節快樂！	
VO_HERO_16_Female_Dryad_HAPPY_HOLIDAYS_01	冬幕節快樂！	
VO_HERO_16_Female_Dryad_HAPPY_NEW_YEAR_01	來慶祝新年吧！	
VO_HERO_16_Female_Dryad_HAPPY_NOBLEGARDEN_01	歡慶貴族花園。	
VO_HERO_16_Female_Dryad_LowCards_01	我快沒有牌了！	
VO_HERO_16_Female_Dryad_MALFURION_START_01	Ishnu'alah，大德魯伊。	
VO_HERO_16_Female_Dryad_MIRROR_GREETINGS_01	也祝福你！	
VO_HERO_16_Female_Dryad_MIRROR_START_01	為林野而戰！	
VO_HERO_16_Female_Dryad_NoCards_01	我沒有牌了！	
VO_HERO_16_Female_Dryad_Oops_02	大錯特錯。	
VO_HERO_16_Female_Dryad_PIRATE_DAY_01	我是海盜！呀啊！	
VO_HERO_16_Female_Dryad_Sorry_01	真是抱歉。	
VO_HERO_16_Female_Dryad_Start_01	這是森林的反撲。	
VO_HERO_16_Female_Dryad_Thanks_01	謝謝你。	
VO_HERO_16_Female_Dryad_Thinking_01	我想想…	
VO_HERO_16_Female_Dryad_Thinking_02	如果這樣的話…	
VO_HERO_16_Female_Dryad_Thinking_03	假如…	
VO_HERO_16_Female_Dryad_Threaten_01	體驗森林的痛苦！	
VO_HERO_16_Female_Dryad_Time_01	時間緊迫！	
VO_HERO_16_Female_Dryad_Well_Played_01	玩得不錯。	
VO_HERO_16_Female_Dryad_WOW_01	真是厲害！	
VO_HERO_18_Female_Gnome_Concede_01	真厲害！你贏了。	
VO_HERO_18_Female_Gnome_ERROR_01	我要先有武器吧？	
VO_HERO_18_Female_Gnome_ERROR_03	法力不足！	
VO_HERO_18_Female_Gnome_ERROR_04	他們已經攻擊過了！	
VO_HERO_18_Female_Gnome_ERROR_06	我不能攻擊兩次！	
VO_HERO_18_Female_Gnome_ERROR_07	噓，他們還在睡。	
VO_HERO_18_Female_Gnome_ERROR_08	哇，太多手牌啦！	
VO_HERO_18_Female_Gnome_ERROR_10	場上只能有7個手下啊。	
VO_HERO_18_Female_Gnome_ERROR_12	他們潛行躲起來了！	
VO_HERO_18_Female_Gnome_ERROR_14	嗯…沒辦法。	
VO_HERO_18_Female_Gnome_ERROR_15	我沒辦法指定那個目標。	
VO_HERO_18_Female_Gnome_ERROR_17	有嘲諷手下在擋路！	
VO_HERO_18_Female_Gnome_FIRE_FESTIVAL_01	仲夏節煙火最棒了！	
VO_HERO_18_Female_Gnome_Greetings_01	你好啊，朋友！	
VO_HERO_18_Female_Gnome_HAPPY_HALLOWEEN_01	萬鬼節！嘻嘻，好怕怕！	
VO_HERO_18_Female_Gnome_HAPPY_HOLIDAYS_01	冬幕節快樂！	
VO_HERO_18_Female_Gnome_HAPPY_NEW_YEAR_01	新年快樂！	
VO_HERO_18_Female_Gnome_HAPPY_NEW_YEAR_LUNAR_16	新春愉快！	
VO_HERO_18_Female_Gnome_LowCards_01	我快沒有牌了！	
VO_HERO_18_Female_Gnome_MIRROR_START_01	耶！一定很好玩！	
VO_HERO_18_Female_Gnome_NOBLEGARDEN	我超愛貴族花園！	
VO_HERO_18_Female_Gnome_NoCards_01	啊！我沒有牌了！	
VO_HERO_18_Female_Gnome_Oops_02	哇，糟糕！	
VO_HERO_18_Female_Gnome_PIRATE_DAY_01	呀，我是海盜！呀！	
VO_HERO_18_Female_Gnome_Sorry_01	噢，我很抱歉…	
VO_HERO_18_Female_Gnome_Start_01	來找樂子吧，嘻嘻！	
VO_HERO_18_Female_Gnome_Thanks_02	喔～感謝你！	
VO_HERO_18_Female_Gnome_Thinking_01	嗯...	
VO_HERO_18_Female_Gnome_Thinking_03	嗯…噔噠啦噔。	
VO_HERO_18_Female_Gnome_Thinking_04	如果這樣出…	
VO_HERO_18_Female_Gnome_Threaten_01	你可以做成可愛的布偶。	
VO_HERO_18_Female_Gnome_Time_01	動作快點！	
VO_HERO_18_Female_Gnome_Well_Played_01	哇，玩得不錯！	
VO_HERO_18_Female_Gnome_WOW_01	真是厲害！	
VO_ICC08_LichKing_Male_Human_YoungArthas_02	我最討厭自己打自己了。	
VO_TBA01_4__Concede	*低吼*	
VO_TBA01_4__Error_Full_Minions	*低吼*	
VO_TBA01_4__Error_Generic	*低吼*	
VO_TBA01_4__Error_Hand_Full	*低吼*	
VO_TBA01_4__Error_I_Attacked	*低吼*	
VO_TBA01_4__Error_Just_Played	*低吼*	
VO_TBA01_4__Error_Minion_Attacked	*低吼*	
VO_TBA01_4__Error_Need_Mana	*低吼*	
VO_TBA01_4__Error_Need_Weapon	*低吼*	
VO_TBA01_4__Error_Play	*低吼*	
VO_TBA01_4__Error_Stealth	*低吼*	
VO_TBA01_4__Good_Game	*低吼*	
VO_TBA01_4__Greetings	遊戲開始了！	
VO_TBA01_4__Low_Cards	*低吼*	
VO_TBA01_4__No_Cards	*低吼*	
VO_TBA01_4__Oops	喔，真糟糕。	
VO_TBA01_4__Sorry	抱歉。	
VO_TBA01_4__Start	我是這個地方的主人！	
VO_TBA01_4__Thanks	謝謝。	
VO_TBA01_4__Threaten	看啊，奈法利安真正的力量！	
VO_TBA01_4__Timer	*低吼*	
VO_TBA01_4__Well_Played	打得不錯。	
