TAG	TEXT	COMMENT
GAMEPLAY_EMOTE_EX1_323h_CONCEDE	Tú ganas... ¡PERO TU MUNDO SIGUE TENIENDO LOS DÍAS CONTADOS!	
GAMEPLAY_EMOTE_EX1_323h_ERROR_FULL_MINIONS	HAY DEMASIADOS ESBIRROS.	
GAMEPLAY_EMOTE_EX1_323h_ERROR_GENERIC	ESO NO SE PUEDE HACER.	
GAMEPLAY_EMOTE_EX1_323h_ERROR_HAND_FULL	¡HAY DEMASIADAS CARTAS!	
GAMEPLAY_EMOTE_EX1_323h_ERROR_I_ATTACKED	YA ATAQUÉ.	
GAMEPLAY_EMOTE_EX1_323h_ERROR_JUST_PLAYED	¡ACABA DE ENTRAR!	
GAMEPLAY_EMOTE_EX1_323h_ERROR_MINION_ATTACKED	ESA COSA YA ATACÓ.	
GAMEPLAY_EMOTE_EX1_323h_ERROR_NEED_MANA	¡NO HAY SUFICIENTE MANÁ!	
GAMEPLAY_EMOTE_EX1_323h_ERROR_NEED_WEAPON	¿PARA DÓNDE SE FUE A PARAR MI ARMA?	
GAMEPLAY_EMOTE_EX1_323h_ERROR_PLAY	NO PUEDO HACER ESA JUGADA.	
GAMEPLAY_EMOTE_EX1_323h_ERROR_STEALTH	ESTÁ EN SIGILO.	
GAMEPLAY_EMOTE_EX1_323h_ERROR_TARGET	NO ES VÁLIDO.	
GAMEPLAY_EMOTE_EX1_323h_ERROR_TAUNT	¡ESE ESBIRRO CON PROVOCACIÓN ESTÁ EN MI CAMINO!	
GAMEPLAY_EMOTE_EX1_323h_FIRE_FESTIVAL	¡ENCIENDAN LAS LLAMAS!	
GAMEPLAY_EMOTE_EX1_323h_GOOD_GAME	¡BUENA PARTIDA!	
GAMEPLAY_EMOTE_EX1_323h_GREETINGS	¡Te enfrentas a Jaraxxus, señor Eredar de la Legión Ardiente!	
GAMEPLAY_EMOTE_EX1_323h_HALLOWS_END	¡LA MUERTE TE VISITARÁ EN HALLOWEEN!	
GAMEPLAY_EMOTE_EX1_323h_LOW_CARDS	¡Mi mazo! ¡ME ESTOY QUEDANDO SIN CARTAS!	
GAMEPLAY_EMOTE_EX1_323h_LUNAR_NEW_YEAR	¡Te enfrentas a Jaraxxus, señor Eredar de la Legión Ardiente!	
GAMEPLAY_EMOTE_EX1_323h_NO_CARDS	¡NOOOOO! ¡NO ME QUEDAN CARTAS!	
GAMEPLAY_EMOTE_EX1_323h_NOBLEGARDEN	¡FELIZ JARDÍN NOBLE!	
GAMEPLAY_EMOTE_EX1_323h_OOPS	¡ERROR!	
GAMEPLAY_EMOTE_EX1_323h_PIRATE_DAY	¡SOY JARRRRRRAXXUS!	
GAMEPLAY_EMOTE_EX1_323h_SORRY	JARAXXUS lo... lo siente.	
GAMEPLAY_EMOTE_EX1_323h_THANKS	GRACIAS.	
GAMEPLAY_EMOTE_EX1_323h_THINK1	Mmm...	
GAMEPLAY_EMOTE_EX1_323h_THINK2	Me pregunto...	
GAMEPLAY_EMOTE_EX1_323h_THINK3	Cómo te destruiré...	
GAMEPLAY_EMOTE_EX1_323h_THREATEN	¡OLVIDO!	
GAMEPLAY_EMOTE_EX1_323h_TIMER	¡SE ACABA EL TIEMPO!	
GAMEPLAY_EMOTE_EX1_323h_WELL_PLAYED	¡BUENA JUGADA!	
GAMEPLAY_EMOTE_EX1_323h_WINTERVEIL_GREETINGS	ESTE FESTIVAL DE INVIERNO, ¡ME DARÉ UN FESTÍN CON TU ALMA!	
GAMEPLAY_EMOTE_EX1_323h_WOW_04	¡ALUCINANTE!	
GAMEPLAY_EMOTE_HERO_01_CONCEDE	¡Elijo la muerte!	
GAMEPLAY_EMOTE_HERO_01_ERROR_FULL_MINIONS	Tengo demasiados esbirros.	
GAMEPLAY_EMOTE_HERO_01_ERROR_GENERIC	No puedo hacer eso.	
GAMEPLAY_EMOTE_HERO_01_ERROR_HAND_FULL	¡Mi mano está llena!	
GAMEPLAY_EMOTE_HERO_01_ERROR_I_ATTACKED	Ya ataqué.	
GAMEPLAY_EMOTE_HERO_01_ERROR_JUST_PLAYED	Ese esbirro necesita un turno de descanso.	
GAMEPLAY_EMOTE_HERO_01_ERROR_MINION_ATTACKED	Ese esbirro ya atacó.	
GAMEPLAY_EMOTE_HERO_01_ERROR_NEED_MANA	No tengo suficiente maná.	
GAMEPLAY_EMOTE_HERO_01_ERROR_NEED_WEAPON	Necesito un arma.	
GAMEPLAY_EMOTE_HERO_01_ERROR_PLAY	No puedo hacer esa jugada.	
GAMEPLAY_EMOTE_HERO_01_ERROR_STEALTH	No puedo hacer objetivo en esbirros en Sigilo.	
GAMEPLAY_EMOTE_HERO_01_ERROR_TARGET	Ese objetivo no es válido.	
GAMEPLAY_EMOTE_HERO_01_ERROR_TAUNT	Hay un esbirro con Provocación en el camino.	
GAMEPLAY_EMOTE_HERO_01_EVENT_FIRE_FESTIVAL	¡Enciendan las piras!	
GAMEPLAY_EMOTE_HERO_01_EVENT_LUNAR_NEW_YEAR	Heh, encantado.	
GAMEPLAY_EMOTE_HERO_01_GOOD_GAME	Buena partida.	
GAMEPLAY_EMOTE_HERO_01_GREETINGS	Heh, encantado.	
GAMEPLAY_EMOTE_HERO_01_HALLOWS_END	Feliz Halloween.	
GAMEPLAY_EMOTE_HERO_01_LOW_CARDS	¡Casi no me quedan cartas!	
GAMEPLAY_EMOTE_HERO_01_MIRROR_START	¡Ja, ja! ¡Veamos qué tienes!	
GAMEPLAY_EMOTE_HERO_01_NO_CARDS	¡No me quedan cartas!	
GAMEPLAY_EMOTE_HERO_01_NOBLEGARDEN	¡Feliz Jardín Noble!	
GAMEPLAY_EMOTE_HERO_01_OOPS	Fue un error.	
GAMEPLAY_EMOTE_HERO_01_PIRATE_DAY	¡YARRRRTY JARRRTY JARRR-TI-JAR!	
GAMEPLAY_EMOTE_HERO_01_SORRY	Lo siento mucho.	
GAMEPLAY_EMOTE_HERO_01_START	¡Victoria o muerte!	
GAMEPLAY_EMOTE_HERO_01_THANKS	Te lo agradezco.	
GAMEPLAY_EMOTE_HERO_01_THINK1	Mmm...	
GAMEPLAY_EMOTE_HERO_01_THINK2	Mmm... me pregunto...	
GAMEPLAY_EMOTE_HERO_01_THINK3	Ahora qué...	
GAMEPLAY_EMOTE_HERO_01_THREATEN	¡Te aplastaré!	
GAMEPLAY_EMOTE_HERO_01_TIMER	¡Debo elegir!	
GAMEPLAY_EMOTE_HERO_01_WELL_PLAYED	Buena jugada.	
GAMEPLAY_EMOTE_HERO_01_WINTERVEIL_GREETINGS	¡Feliz festín del Festival de Invierno!	
GAMEPLAY_EMOTE_HERO_01_WOW	¡Increíble!	
GAMEPLAY_EMOTE_HERO_01A_CELEBRATE	¡Hip, hip, hurra!	
GAMEPLAY_EMOTE_HERO_01A_CONCEDE	Me has vencido.	
GAMEPLAY_EMOTE_HERO_01A_ERROR_FULL_MINIONS	Tengo demasiados esbirros.	
GAMEPLAY_EMOTE_HERO_01A_ERROR_GENERIC	No puedo hacer eso.	
GAMEPLAY_EMOTE_HERO_01A_ERROR_HAND_FULL	¡Mi mano está completa!	
GAMEPLAY_EMOTE_HERO_01A_ERROR_I_ATTACKED	Ya he atacado.	
GAMEPLAY_EMOTE_HERO_01A_ERROR_JUST_PLAYED	Ese esbirro necesita un turno de descanso.	
GAMEPLAY_EMOTE_HERO_01A_ERROR_MINION_ATTACKED	Ese esbirro ya atacó.	
GAMEPLAY_EMOTE_HERO_01A_ERROR_NEED_MANA	No tengo suficiente maná.	
GAMEPLAY_EMOTE_HERO_01A_ERROR_NEED_WEAPON	Necesito un arma.	
GAMEPLAY_EMOTE_HERO_01A_ERROR_PLAY	No puedo hacer esa jugada.	
GAMEPLAY_EMOTE_HERO_01A_ERROR_STEALTH	No puedo hacer objetivo en esbirros en Sigilo.	
GAMEPLAY_EMOTE_HERO_01A_ERROR_TARGET	Ese no es un objetivo válido.	
GAMEPLAY_EMOTE_HERO_01A_ERROR_TAUNT	Debo atacar a ese esbirro con Provocación.	
GAMEPLAY_EMOTE_HERO_01A_EVENT_LUNAR_NEW_YEAR	Saludos.	
GAMEPLAY_EMOTE_HERO_01A_FIRE_FESTIVAL	¡Feliz Festival de Fuego del Solsticio de Verano!	
GAMEPLAY_EMOTE_HERO_01A_GOOD_GAME	Buena partida.	
GAMEPLAY_EMOTE_HERO_01A_GREETINGS	Saludos.	
GAMEPLAY_EMOTE_HERO_01A_HALLOWS_END	Que tengas un feliz Halloween.	
GAMEPLAY_EMOTE_HERO_01A_LOW_CARDS	Casi no me quedan cartas.	
GAMEPLAY_EMOTE_HERO_01A_MIRROR_START	¡Sí, Khaz'Modan!	
GAMEPLAY_EMOTE_HERO_01A_NO_CARDS	¡No me quedan cartas!	
GAMEPLAY_EMOTE_HERO_01A_NOBLEGARDEN	¡Feliz Jardín Noble!	
GAMEPLAY_EMOTE_HERO_01A_OOPS	Eso... no salió como esperaba.	
GAMEPLAY_EMOTE_HERO_01A_PIRATE_DAY	¡Arrr! ¡Soy el rey de los mares!	
GAMEPLAY_EMOTE_HERO_01A_SORRY	Oh, lo siento tanto.	
GAMEPLAY_EMOTE_HERO_01A_START	¡Por Khaz Modan!	
GAMEPLAY_EMOTE_HERO_01A_THANKS	¡Gracias!	
GAMEPLAY_EMOTE_HERO_01A_THINK1	Mmm...	
GAMEPLAY_EMOTE_HERO_01A_THINK2	¿Qué tal si...? No, no...	
GAMEPLAY_EMOTE_HERO_01A_THINK3	Tantas opciones...	
GAMEPLAY_EMOTE_HERO_01A_THREATEN	¡Siente la furia de la montaña!	
GAMEPLAY_EMOTE_HERO_01A_TIMER	¡Tengo que moverme!	
GAMEPLAY_EMOTE_HERO_01A_WELL_PLAYED	Buena jugada.	
GAMEPLAY_EMOTE_HERO_01A_WINTERVEIL_GREETINGS	¡Feliz festín del Festival de Invierno!	
GAMEPLAY_EMOTE_HERO_01A_WOW	¡Por mi barba!	
GAMEPLAY_EMOTE_HERO_02_CONCEDE	Esta vez ganas, amigo.	
GAMEPLAY_EMOTE_HERO_02_ERROR_FULL_MINIONS	Tengo demasiados esbirros.	
GAMEPLAY_EMOTE_HERO_02_ERROR_GENERIC	No puedo hacer eso.	
GAMEPLAY_EMOTE_HERO_02_ERROR_HAND_FULL	¡Mi mano está demasiado llena!	
GAMEPLAY_EMOTE_HERO_02_ERROR_I_ATTACKED	Ya ataqué.	
GAMEPLAY_EMOTE_HERO_02_ERROR_JUST_PLAYED	Ese esbirro necesita un turno de descanso.	
GAMEPLAY_EMOTE_HERO_02_ERROR_MINION_ATTACKED	Ese esbirro ya atacó.	
GAMEPLAY_EMOTE_HERO_02_ERROR_NEED_MANA	No tengo suficiente maná.	
GAMEPLAY_EMOTE_HERO_02_ERROR_NEED_WEAPON	Necesito un arma.	
GAMEPLAY_EMOTE_HERO_02_ERROR_PLAY	No puedo hacer esa jugada.	
GAMEPLAY_EMOTE_HERO_02_ERROR_STEALTH	No puedo hacer objetivo en esbirros en Sigilo.	
GAMEPLAY_EMOTE_HERO_02_ERROR_TARGET	Ese objetivo no es válido.	
GAMEPLAY_EMOTE_HERO_02_ERROR_TAUNT	Hay un esbirro con Provocación en el camino.	
GAMEPLAY_EMOTE_HERO_02_EVENT_FIRE_FESTIVAL	¡Un festival digno de los elementos!	
GAMEPLAY_EMOTE_HERO_02_EVENT_LUNAR_NEW_YEAR	Mucho gusto.	
GAMEPLAY_EMOTE_HERO_02_GOOD_GAME	Buena partida.	
GAMEPLAY_EMOTE_HERO_02_GREETINGS	Mucho gusto.	
GAMEPLAY_EMOTE_HERO_02_HALLOWS_END	Feliz Halloween.	
GAMEPLAY_EMOTE_HERO_02_LOW_CARDS	¡Casi no me quedan cartas!	
GAMEPLAY_EMOTE_HERO_02_MIRROR_START	¡Por los Lobos gélidos!	
GAMEPLAY_EMOTE_HERO_02_NO_CARDS	¡No me quedan cartas!	
GAMEPLAY_EMOTE_HERO_02_NOBLEGARDEN	Feliz Jardín Noble.	
GAMEPLAY_EMOTE_HERO_02_OOPS	Eso fue un error.	
GAMEPLAY_EMOTE_HERO_02_PIRATE_DAY	Arrrrrr, ¡ha llegado el Día de los Piratas, camarada!	
GAMEPLAY_EMOTE_HERO_02_SORRY	Lo siento mucho.	
GAMEPLAY_EMOTE_HERO_02_START	¡Por Martillo Maldito!	
GAMEPLAY_EMOTE_HERO_02_THANKS	Gracias.	
GAMEPLAY_EMOTE_HERO_02_THINK1	Mmm...	
GAMEPLAY_EMOTE_HERO_02_THINK2	Me pregunto...	
GAMEPLAY_EMOTE_HERO_02_THINK3	Mmm... qué debería hacer...	
GAMEPLAY_EMOTE_HERO_02_THREATEN	¡Los Elementos te destruirán!	
GAMEPLAY_EMOTE_HERO_02_TIMER	¡Queda poco tiempo!	
GAMEPLAY_EMOTE_HERO_02_WELL_PLAYED	Buena jugada.	
GAMEPLAY_EMOTE_HERO_02_WINTERVEIL_GREETINGS	¡Feliz festín del Festival de Invierno!	
GAMEPLAY_EMOTE_HERO_02_WOW	¡Increíble!	
GAMEPLAY_EMOTE_HERO_02A_CELEBRATE	<¡Celebraciones!>	
GAMEPLAY_EMOTE_HERO_02A_CONCEDE	<Me han derrotado.>	
GAMEPLAY_EMOTE_HERO_02A_ERROR_FULL_MINIONS	<Tengo \ndemasiados esbirros.>	
GAMEPLAY_EMOTE_HERO_02A_ERROR_GENERIC	<Eso\nes imposible.>	
GAMEPLAY_EMOTE_HERO_02A_ERROR_HAND_FULL	<Mi mano\nestá llena.>	
GAMEPLAY_EMOTE_HERO_02A_ERROR_I_ATTACKED	<Ya\nataqué.>	VO_HERO_15_ERROR04_43.wav
GAMEPLAY_EMOTE_HERO_02A_ERROR_JUST_PLAYED	<Ese esbirro\ntiene que esperar.>	
GAMEPLAY_EMOTE_HERO_02A_ERROR_MINION_ATTACKED	<Ese esbirro\nya atacó.>	
GAMEPLAY_EMOTE_HERO_02A_ERROR_NEED_MANA	<Necesito más maná.>	
GAMEPLAY_EMOTE_HERO_02A_ERROR_NEED_WEAPON	<Necesito un arma.>	
GAMEPLAY_EMOTE_HERO_02A_ERROR_PLAY	<No puedo hacer esa jugada.>	
GAMEPLAY_EMOTE_HERO_02A_ERROR_STEALTH	<¡No puedo enfrentarme\na un esbirro en Sigilo!>	
GAMEPLAY_EMOTE_HERO_02A_ERROR_TARGET	<Ese objetivo\nno es válido.>	
GAMEPLAY_EMOTE_HERO_02A_ERROR_TAUNT	<No puedo evitar\nal esbirro con Provocación.>	
GAMEPLAY_EMOTE_HERO_02A_EVENT_LUNAR_NEW_YEAR	<¡Que tengas un próspero\naño nuevo!>	
GAMEPLAY_EMOTE_HERO_02A_FIRE_FESTIVAL	<De donde yo vengo no hay Festival\nde Fuego.>	
GAMEPLAY_EMOTE_HERO_02A_GREETINGS	<Hola, camarada.>	
GAMEPLAY_EMOTE_HERO_02A_HALLOWS_END	<Que tengan un espeluznante\nHalloween, renacuajos.>	
GAMEPLAY_EMOTE_HERO_02A_LOW_CARDS	<¡Estoy quedándome\nsin cartas!>	
GAMEPLAY_EMOTE_HERO_02A_MIRROR_START	<¿¡Joven!? Tienes\nmucho que aprender.>	
GAMEPLAY_EMOTE_HERO_02A_NO_CARDS	<¡No me quedan cartas!>	
GAMEPLAY_EMOTE_HERO_02A_NOBLEGARDEN	<¡Feliz Jardín Noble!>	
GAMEPLAY_EMOTE_HERO_02A_OOPS	<¡Maldición!>	
GAMEPLAY_EMOTE_HERO_02A_PIRATE_DAY	<¡¿Piratas?! ¡Pero si nosotros\nllegamos primero!>	
GAMEPLAY_EMOTE_HERO_02A_SORRY	<Lo siento,\njoven.>	
GAMEPLAY_EMOTE_HERO_02A_START	<¡Es hora de una lección,\njovencito!>	
GAMEPLAY_EMOTE_HERO_02A_THANKS	<Mi más sincero\nagradecimiento.>	
GAMEPLAY_EMOTE_HERO_02A_THINK1	<¿Qué tal si....?>	VO_HERO_15_Thinking1_13.wav
GAMEPLAY_EMOTE_HERO_02A_THINK2	<Qué idea\ntan interesante....>	
GAMEPLAY_EMOTE_HERO_02A_THINK3	<Una posibilidad...>	
GAMEPLAY_EMOTE_HERO_02A_THREATEN	<¡Enfréntate a la sabiduría\nde las mareas!>	
GAMEPLAY_EMOTE_HERO_02A_TIMER	<¡Rápido, \nrápido!>	
GAMEPLAY_EMOTE_HERO_02A_WELL_PLAYED	<Bien hecho.>	
GAMEPLAY_EMOTE_HERO_02A_WINTERVEIL_GREETINGS	<¡Que tengas un feliz\nFestival de Invierno!>	
GAMEPLAY_EMOTE_HERO_02A_WOW	<¡Inconcebible!>	
GAMEPLAY_EMOTE_HERO_03_CONCEDE	Me rindo.	
GAMEPLAY_EMOTE_HERO_03_ERROR_FULL_MINIONS	Tengo demasiados esbirros.	
GAMEPLAY_EMOTE_HERO_03_ERROR_GENERIC	No puedo hacer eso.	
GAMEPLAY_EMOTE_HERO_03_ERROR_HAND_FULL	¡Mi mano está demasiado llena!	
GAMEPLAY_EMOTE_HERO_03_ERROR_I_ATTACKED	Ya ataqué.	
GAMEPLAY_EMOTE_HERO_03_ERROR_JUST_PLAYED	Ese esbirro necesita un turno de descanso.	
GAMEPLAY_EMOTE_HERO_03_ERROR_MINION_ATTACKED	Ese esbirro ya atacó.	
GAMEPLAY_EMOTE_HERO_03_ERROR_NEED_MANA	No tengo suficiente maná.	
GAMEPLAY_EMOTE_HERO_03_ERROR_NEED_WEAPON	Necesito un arma.	
GAMEPLAY_EMOTE_HERO_03_ERROR_PLAY	No puedo hacer esa jugada.	
GAMEPLAY_EMOTE_HERO_03_ERROR_STEALTH	No puedo hacer objetivo en esbirros en Sigilo.	
GAMEPLAY_EMOTE_HERO_03_ERROR_TARGET	Ese objetivo no es válido.	
GAMEPLAY_EMOTE_HERO_03_ERROR_TAUNT	Hay un esbirro con Provocación en el camino.	
GAMEPLAY_EMOTE_HERO_03_EVENT_LUNAR_NEW_YEAR	El placer es mío.	
GAMEPLAY_EMOTE_HERO_03_FIRE_FESTIVAL	Feliz Solsticio de Verano.	
GAMEPLAY_EMOTE_HERO_03_GOOD_GAME	Buena partida.	
GAMEPLAY_EMOTE_HERO_03_GREETINGS	El placer es mío.	
GAMEPLAY_EMOTE_HERO_03_HALLOWS_END	Feliz Halloween.	
GAMEPLAY_EMOTE_HERO_03_LOW_CARDS	¡Casi no me quedan cartas!	
GAMEPLAY_EMOTE_HERO_03_MIRROR_START	SIEMPRE tengo cuidado.	
GAMEPLAY_EMOTE_HERO_03_NO_CARDS	¡No me quedan cartas!	
GAMEPLAY_EMOTE_HERO_03_NOBLEGARDEN	Feliz Jardín Noble.	
GAMEPLAY_EMOTE_HERO_03_OOPS	Se han cometido errores.	
GAMEPLAY_EMOTE_HERO_03_PIRATE_DAY	¡Aarrrr!	
GAMEPLAY_EMOTE_HERO_03_SORRY	Lo siento.	
GAMEPLAY_EMOTE_HERO_03_START	Ten cuidado.	
GAMEPLAY_EMOTE_HERO_03_THANKS	Gracias.	
GAMEPLAY_EMOTE_HERO_03_THINK1	Mmm...	
GAMEPLAY_EMOTE_HERO_03_THINK2	Me pregunto...	
GAMEPLAY_EMOTE_HERO_03_THINK3	Tantas posibilidades...	
GAMEPLAY_EMOTE_HERO_03_THREATEN	¡Seré tu muerte!	
GAMEPLAY_EMOTE_HERO_03_TIMER	¡Debo decidir pronto!	
GAMEPLAY_EMOTE_HERO_03_WELL_PLAYED	Buena jugada.	
GAMEPLAY_EMOTE_HERO_03_WINTERVEIL_GREETINGS	Feliz festín del Festival de Invierno.	
GAMEPLAY_EMOTE_HERO_03_WOW	Increíble.	
GAMEPLAY_EMOTE_HERO_04_CONCEDE	La victoria es tuya.	
GAMEPLAY_EMOTE_HERO_04_ERROR_FULL_MINIONS	Tengo demasiados esbirros.	
GAMEPLAY_EMOTE_HERO_04_ERROR_GENERIC	No puedo hacer eso.	
GAMEPLAY_EMOTE_HERO_04_ERROR_HAND_FULL	¡Mi mano está demasiado llena!	
GAMEPLAY_EMOTE_HERO_04_ERROR_I_ATTACKED	Ya ataqué.	
GAMEPLAY_EMOTE_HERO_04_ERROR_JUST_PLAYED	Ese esbirro necesita un turno de descanso.	
GAMEPLAY_EMOTE_HERO_04_ERROR_MINION_ATTACKED	Ese esbirro ya atacó.	
GAMEPLAY_EMOTE_HERO_04_ERROR_NEED_MANA	No tengo suficiente maná.	
GAMEPLAY_EMOTE_HERO_04_ERROR_NEED_WEAPON	Necesito un arma.	
GAMEPLAY_EMOTE_HERO_04_ERROR_PLAY	No puedo hacer esa jugada.	
GAMEPLAY_EMOTE_HERO_04_ERROR_STEALTH	No puedo hacer objetivo en esbirros en Sigilo.	
GAMEPLAY_EMOTE_HERO_04_ERROR_TARGET	Ese objetivo no es válido.	
GAMEPLAY_EMOTE_HERO_04_ERROR_TAUNT	Hay un esbirro con Provocación en el camino.	
GAMEPLAY_EMOTE_HERO_04_EVENT_LUNAR_NEW_YEAR	¡Un gusto!	
GAMEPLAY_EMOTE_HERO_04_FIRE_FESTIVAL	¡Feliz Festival de Fuego del Solsticio de Verano!	
GAMEPLAY_EMOTE_HERO_04_GOOD_GAME	Buena partida.	
GAMEPLAY_EMOTE_HERO_04_GREETINGS	¡Un gusto!	
GAMEPLAY_EMOTE_HERO_04_HALLOWS_END	¡Feliz Halloween, adalid!	VO_HERO_04_HAPPY_HALLOWEEN_13.wav
GAMEPLAY_EMOTE_HERO_04_LOW_CARDS	¡Casi no me quedan cartas!	
GAMEPLAY_EMOTE_HERO_04_MIRROR_START	¡Dominaré la Luz!	
GAMEPLAY_EMOTE_HERO_04_NO_CARDS	¡No me quedan cartas!	
GAMEPLAY_EMOTE_HERO_04_NOBLEGARDEN	¡Feliz Jardín Noble, adalid!	VO_HERO_04_HAPPY_NOBLEGARDEN_17.wav
GAMEPLAY_EMOTE_HERO_04_OOPS	Eso fue un error.	
GAMEPLAY_EMOTE_HERO_04_PIRATE_DAY	¡A cubierta, perros de agua dulce!	VO_HERO_04_PIRATE_DAY_33.wav
GAMEPLAY_EMOTE_HERO_04_SORRY	Lo siento.	
GAMEPLAY_EMOTE_HERO_04_START	¡Pelearé con honor!	
GAMEPLAY_EMOTE_HERO_04_THANKS	Gracias.	
GAMEPLAY_EMOTE_HERO_04_THINK1	Mmm...	
GAMEPLAY_EMOTE_HERO_04_THINK2	Me pregunto...	
GAMEPLAY_EMOTE_HERO_04_THINK3	Déjame pensar...	
GAMEPLAY_EMOTE_HERO_04_THREATEN	¡La justicia exige represalias!	
GAMEPLAY_EMOTE_HERO_04_TIMER	¡Debo moverme rápido!	
GAMEPLAY_EMOTE_HERO_04_WELL_PLAYED	Buena jugada.	
GAMEPLAY_EMOTE_HERO_04_WINTERVEIL_GREETINGS	¡Feliz festín del Festival de Invierno, adalid!	
GAMEPLAY_EMOTE_HERO_04_WOW	¡Por la Luz sagrada!	
GAMEPLAY_EMOTE_HERO_04A_CELEBRATE	¡La Luz brilla este glorioso día!	
GAMEPLAY_EMOTE_HERO_04A_CONCEDE	Tú ganas. Me rindo.	
GAMEPLAY_EMOTE_HERO_04A_ERROR_FULL_MINIONS	Tengo demasiados esbirros.	
GAMEPLAY_EMOTE_HERO_04A_ERROR_GENERIC	No puedo hacer eso.	
GAMEPLAY_EMOTE_HERO_04A_ERROR_HAND_FULL	¡Mi mano está completa!	
GAMEPLAY_EMOTE_HERO_04A_ERROR_I_ATTACKED	Ya he atacado.	
GAMEPLAY_EMOTE_HERO_04A_ERROR_JUST_PLAYED	Ese esbirro necesita un turno de descanso.	
GAMEPLAY_EMOTE_HERO_04A_ERROR_MINION_ATTACKED	Ese esbirro ya atacó.	
GAMEPLAY_EMOTE_HERO_04A_ERROR_NEED_MANA	No tengo suficiente maná.	
GAMEPLAY_EMOTE_HERO_04A_ERROR_NEED_WEAPON	Necesito un arma.	
GAMEPLAY_EMOTE_HERO_04A_ERROR_PLAY	No puedo hacer esa jugada.	
GAMEPLAY_EMOTE_HERO_04A_ERROR_STEALTH	No puedo hacer objetivo en esbirros en Sigilo.	
GAMEPLAY_EMOTE_HERO_04A_ERROR_TARGET	Ese objetivo no es válido.	
GAMEPLAY_EMOTE_HERO_04A_ERROR_TAUNT	Debo atacar a ese esbirro con Provocación.	
GAMEPLAY_EMOTE_HERO_04A_FIRE_FESTIVAL	¡Feliz Festival de Fuego!	
GAMEPLAY_EMOTE_HERO_04A_GOOD_GAME	Buena partida.	
GAMEPLAY_EMOTE_HERO_04A_GREETINGS	Saludos, rival.	
GAMEPLAY_EMOTE_HERO_04A_HALLOWS_END	Feliz Halloween.	
GAMEPLAY_EMOTE_HERO_04A_LOW_CARDS	¡Casi no me quedan cartas!	
GAMEPLAY_EMOTE_HERO_04A_LUNAR_NEW_YEAR	Saludos, rival.	
GAMEPLAY_EMOTE_HERO_04A_MIRROR_START	Fuego sagrado es mi segundo nombre.	
GAMEPLAY_EMOTE_HERO_04A_NO_CARDS	¡No me quedan cartas!	
GAMEPLAY_EMOTE_HERO_04A_NOBLEGARDEN	Feliz Jardín Noble.	
GAMEPLAY_EMOTE_HERO_04A_OOPS	Un error, sin dudas.	
GAMEPLAY_EMOTE_HERO_04A_PIRATE_DAY	Yarrr, ahora me llevaré tu tesoro.	
GAMEPLAY_EMOTE_HERO_04A_SORRY	Mis disculpas.	
GAMEPLAY_EMOTE_HERO_04A_START	¡Mi espada arde con fuego sagrado!	
GAMEPLAY_EMOTE_HERO_04A_THANKS	Tienes mi más sincero agradecimiento.	
GAMEPLAY_EMOTE_HERO_04A_THINK1	Mmm...	
GAMEPLAY_EMOTE_HERO_04A_THINK2	Opciones, opciones...	
GAMEPLAY_EMOTE_HERO_04A_THINK3	Quizá deba... Mmm...	
GAMEPLAY_EMOTE_HERO_04A_THREATEN	¡Pagarás por eso, miserable!	
GAMEPLAY_EMOTE_HERO_04A_TIMER	¡Vamos!	
GAMEPLAY_EMOTE_HERO_04A_WELL_PLAYED	Buena jugada.	
GAMEPLAY_EMOTE_HERO_04A_WINTERVEIL_GREETINGS	¡Feliz festín del Festival de Invierno!	
GAMEPLAY_EMOTE_HERO_04A_WOW	¡Increíble!	
GAMEPLAY_EMOTE_HERO_05_CONCEDE	Buena pelea. Admito mi derrota.	
GAMEPLAY_EMOTE_HERO_05_ERROR_FULL_MINIONS	Tengo demasiados esbirros.	
GAMEPLAY_EMOTE_HERO_05_ERROR_GENERIC	No puedo hacer eso.	
GAMEPLAY_EMOTE_HERO_05_ERROR_HAND_FULL	¡Mi mano está demasiado llena!	
GAMEPLAY_EMOTE_HERO_05_ERROR_I_ATTACKED	Ya ataqué.	
GAMEPLAY_EMOTE_HERO_05_ERROR_JUST_PLAYED	Ese esbirro necesita un turno de descanso.	
GAMEPLAY_EMOTE_HERO_05_ERROR_MINION_ATTACKED	Ese esbirro ya atacó.	
GAMEPLAY_EMOTE_HERO_05_ERROR_NEED_MANA	No tengo suficiente maná.	
GAMEPLAY_EMOTE_HERO_05_ERROR_NEED_WEAPON	Necesito un arma.	
GAMEPLAY_EMOTE_HERO_05_ERROR_PLAY	No puedo hacer esa jugada.	
GAMEPLAY_EMOTE_HERO_05_ERROR_STEALTH	No puedo hacer objetivo en esbirros en Sigilo.	
GAMEPLAY_EMOTE_HERO_05_ERROR_TARGET	Ese objetivo no es válido.	
GAMEPLAY_EMOTE_HERO_05_ERROR_TAUNT	Hay un esbirro con Provocación en el camino.	
GAMEPLAY_EMOTE_HERO_05_EVENT_LUNAR_NEW_YEAR	Qué tal, viajero.	
GAMEPLAY_EMOTE_HERO_05_FIRE_FESTIVAL	Feliz Solsticio de Verano.	
GAMEPLAY_EMOTE_HERO_05_GOOD_GAME	Buena partida.	
GAMEPLAY_EMOTE_HERO_05_GREETINGS	Qué tal, viajero.	
GAMEPLAY_EMOTE_HERO_05_HALLOWS_END	Feliz Halloween.	
GAMEPLAY_EMOTE_HERO_05_LOW_CARDS	¡Casi no me quedan cartas!	
GAMEPLAY_EMOTE_HERO_05_MIRROR_START	¡Veamos qué tienes!	
GAMEPLAY_EMOTE_HERO_05_NO_CARDS	¡No me quedan cartas!	
GAMEPLAY_EMOTE_HERO_05_NOBLEGARDEN	¡Feliz Jardín Noble!	
GAMEPLAY_EMOTE_HERO_05_OOPS	No funcionó como esperaba.	
GAMEPLAY_EMOTE_HERO_05_PIRATE_DAY	¡Suelten a los canes de agua dulce!	
GAMEPLAY_EMOTE_HERO_05_SORRY	Discúlpame.	
GAMEPLAY_EMOTE_HERO_05_START	¡Que empiece la cacería!	
GAMEPLAY_EMOTE_HERO_05_THANKS	Gracias.	
GAMEPLAY_EMOTE_HERO_05_THINK1	Mmm...	
GAMEPLAY_EMOTE_HERO_05_THINK2	Me pregunto...	
GAMEPLAY_EMOTE_HERO_05_THINK3	Mmm...	
GAMEPLAY_EMOTE_HERO_05_THREATEN	¡Te cazaré!	
GAMEPLAY_EMOTE_HERO_05_TIMER	¡El tiempo pasa rápido!	
GAMEPLAY_EMOTE_HERO_05_WELL_PLAYED	Buena jugada.	
GAMEPLAY_EMOTE_HERO_05_WINTERVEIL_GREETINGS	¡Feliz festín del Festival de Invierno!	
GAMEPLAY_EMOTE_HERO_05_WOW	¡Increíble!	
GAMEPLAY_EMOTE_HERO_05A_CELEBRATE	¡Ja, ja, sí! ¡SÍ!	
GAMEPLAY_EMOTE_HERO_05A_CONCEDE	¡Brillante! Me rindo.	
GAMEPLAY_EMOTE_HERO_05A_ERROR_FULL_MINIONS	Tengo demasiados esbirros.	
GAMEPLAY_EMOTE_HERO_05A_ERROR_GENERIC	No puedo hacer eso.	
GAMEPLAY_EMOTE_HERO_05A_ERROR_HAND_FULL	¡Mi mano está completa!	
GAMEPLAY_EMOTE_HERO_05A_ERROR_I_ATTACKED	Ya he atacado.	
GAMEPLAY_EMOTE_HERO_05A_ERROR_JUST_PLAYED	Ese esbirro necesita un turno de descanso.	
GAMEPLAY_EMOTE_HERO_05A_ERROR_MINION_ATTACKED	Ese esbirro ya atacó.	
GAMEPLAY_EMOTE_HERO_05A_ERROR_NEED_MANA	No tengo suficiente maná.	
GAMEPLAY_EMOTE_HERO_05A_ERROR_NEED_WEAPON	Necesito un arma.	
GAMEPLAY_EMOTE_HERO_05A_ERROR_PLAY	No puedo hacer esa jugada.	
GAMEPLAY_EMOTE_HERO_05A_ERROR_STEALTH	No puedo hacer objetivo en esbirros en Sigilo.	
GAMEPLAY_EMOTE_HERO_05A_ERROR_TARGET	Ese no es un objetivo válido.	
GAMEPLAY_EMOTE_HERO_05A_ERROR_TAUNT	Debo atacar al esbirro con Provocación.	
GAMEPLAY_EMOTE_HERO_05A_EVENT_FIRE_FESTIVAL	Se acerca el Festival de Fuego.	
GAMEPLAY_EMOTE_HERO_05A_EVENT_HALLOWS_END	Feliz Halloween.	
GAMEPLAY_EMOTE_HERO_05A_EVENT_LUNAR_NEW_YEAR	Hola, caminante.	
GAMEPLAY_EMOTE_HERO_05A_EVENT_NOBLEGARDEN	Feliz Jardín Noble.	
GAMEPLAY_EMOTE_HERO_05A_EVENT_PIRATE_DAY	¡Yarrr! ¡Te enviaré al fondo del mar!	
GAMEPLAY_EMOTE_HERO_05A_GOOD_GAME	Buena partida.	
GAMEPLAY_EMOTE_HERO_05A_GREETINGS	Hola, caminante.	
GAMEPLAY_EMOTE_HERO_05A_LOW_CARDS	Casi no me quedan cartas.	
GAMEPLAY_EMOTE_HERO_05A_MIRROR_START	Yo nunca tiemblo.	
GAMEPLAY_EMOTE_HERO_05A_NO_CARDS	¡No me quedan cartas!	
GAMEPLAY_EMOTE_HERO_05A_OOPS	Un error.	
GAMEPLAY_EMOTE_HERO_05A_SORRY	Lo lamento.	
GAMEPLAY_EMOTE_HERO_05A_START	¡Tiembla ante el poder de los elfos!	
GAMEPLAY_EMOTE_HERO_05A_THANKS	Gracias.	
GAMEPLAY_EMOTE_HERO_05A_THINK1	Mmm...	
GAMEPLAY_EMOTE_HERO_05A_THINK2	¿A quién le dispararé?	
GAMEPLAY_EMOTE_HERO_05A_THINK3	¿Qué debería hacer?	
GAMEPLAY_EMOTE_HERO_05A_THREATEN	¡Mi venganza será rápida!	
GAMEPLAY_EMOTE_HERO_05A_TIMER	¡A moverse! ¡Ahora!	
GAMEPLAY_EMOTE_HERO_05A_WELL_PLAYED	Buena jugada.	
GAMEPLAY_EMOTE_HERO_05A_WINTERVEIL_GREETING	Feliz festín del Festival de Invierno.	
GAMEPLAY_EMOTE_HERO_05A_WOW	¡Increíble!	
GAMEPLAY_EMOTE_HERO_06_CONCEDE	Admito mi derrota.	
GAMEPLAY_EMOTE_HERO_06_ERROR_FULL_MINIONS	Tengo demasiados esbirros.	
GAMEPLAY_EMOTE_HERO_06_ERROR_GENERIC	No puedo hacer eso.	
GAMEPLAY_EMOTE_HERO_06_ERROR_HAND_FULL	¡Mi mano está demasiado llena!	
GAMEPLAY_EMOTE_HERO_06_ERROR_I_ATTACKED	Ya ataqué.	
GAMEPLAY_EMOTE_HERO_06_ERROR_JUST_PLAYED	Ese esbirro necesita un turno de descanso.	
GAMEPLAY_EMOTE_HERO_06_ERROR_MINION_ATTACKED	Ese esbirro ya atacó.	
GAMEPLAY_EMOTE_HERO_06_ERROR_NEED_MANA	No tengo suficiente maná.	
GAMEPLAY_EMOTE_HERO_06_ERROR_NEED_WEAPON	Necesito un arma.	
GAMEPLAY_EMOTE_HERO_06_ERROR_PLAY	No puedo hacer esa jugada.	
GAMEPLAY_EMOTE_HERO_06_ERROR_STEALTH	No puedo hacer objetivo en esbirros en Sigilo.	
GAMEPLAY_EMOTE_HERO_06_ERROR_TARGET	Ese objetivo no es válido.	
GAMEPLAY_EMOTE_HERO_06_ERROR_TAUNT	Hay un esbirro con Provocación en el camino.	
GAMEPLAY_EMOTE_HERO_06_EVENT_LUNAR_NEW_YEAR	Qué tal.	
GAMEPLAY_EMOTE_HERO_06_FIRE_FESTIVAL	¡Feliz Solsticio de Verano! Y cuidado con los incendios forestales.	
GAMEPLAY_EMOTE_HERO_06_GOOD_GAME	Buena partida.	
GAMEPLAY_EMOTE_HERO_06_GREETINGS	Qué tal.	
GAMEPLAY_EMOTE_HERO_06_HALLOWS_END	¡Feliz Halloween!	
GAMEPLAY_EMOTE_HERO_06_LOW_CARDS	¡Casi no me quedan cartas!	
GAMEPLAY_EMOTE_HERO_06_MIRROR_START	¡Debo proteger a la naturaleza!	
GAMEPLAY_EMOTE_HERO_06_NO_CARDS	¡No me quedan cartas!	
GAMEPLAY_EMOTE_HERO_06_NOBLEGARDEN	¡Feliz Jardín Noble!	
GAMEPLAY_EMOTE_HERO_06_OOPS	Un error natural.	
GAMEPLAY_EMOTE_HERO_06_PIRATE_DAY	¡Yarrrrr!	
GAMEPLAY_EMOTE_HERO_06_SORRY	Lo siento.	
GAMEPLAY_EMOTE_HERO_06_START	¡Debo proteger a lo salvaje!	
GAMEPLAY_EMOTE_HERO_06_START_TYRANDE	Mi amada Tyrande.	
GAMEPLAY_EMOTE_HERO_06_THANKS	Te lo agradezco.	
GAMEPLAY_EMOTE_HERO_06_THINK1	Mmm...	
GAMEPLAY_EMOTE_HERO_06_THINK2	Mmm... me pregunto...	
GAMEPLAY_EMOTE_HERO_06_THINK3	Qué debo hacer...	
GAMEPLAY_EMOTE_HERO_06_THREATEN	¡La naturaleza se alzará contra ti!	
GAMEPLAY_EMOTE_HERO_06_TIMER	¡El tiempo no espera a nadie!	
GAMEPLAY_EMOTE_HERO_06_WELL_PLAYED	Mmm... buena jugada.	
GAMEPLAY_EMOTE_HERO_06_WINTERVEIL_GREETINGS	Feliz festín del Festival de Invierno.	
GAMEPLAY_EMOTE_HERO_06_WOW	¡Espectacular!	
GAMEPLAY_EMOTE_HERO_07_CONCEDE	Ganaste... esta vez.	
GAMEPLAY_EMOTE_HERO_07_ERROR_FULL_MINIONS	Tengo demasiados esbirros.	
GAMEPLAY_EMOTE_HERO_07_ERROR_GENERIC	No puedo hacer eso.	
GAMEPLAY_EMOTE_HERO_07_ERROR_HAND_FULL	¡Mi mano está demasiado llena!	
GAMEPLAY_EMOTE_HERO_07_ERROR_I_ATTACKED	Ya ataqué.	
GAMEPLAY_EMOTE_HERO_07_ERROR_JUST_PLAYED	Ese esbirro necesita un turno de descanso.	
GAMEPLAY_EMOTE_HERO_07_ERROR_MINION_ATTACKED	Ese esbirro ya atacó.	
GAMEPLAY_EMOTE_HERO_07_ERROR_NEED_MANA	No tengo suficiente maná.	
GAMEPLAY_EMOTE_HERO_07_ERROR_NEED_WEAPON	Necesito un arma.	
GAMEPLAY_EMOTE_HERO_07_ERROR_PLAY	No puedo hacer esa jugada.	
GAMEPLAY_EMOTE_HERO_07_ERROR_STEALTH	No puedo hacer objetivo en esbirros en Sigilo.	
GAMEPLAY_EMOTE_HERO_07_ERROR_TARGET	Ese objetivo no es válido.	
GAMEPLAY_EMOTE_HERO_07_ERROR_TAUNT	Hay un esbirro con Provocación en el camino.	
GAMEPLAY_EMOTE_HERO_07_EVENT_LUNAR_NEW_YEAR	Un placer.	
GAMEPLAY_EMOTE_HERO_07_FIRE_FESTIVAL	Que las llamas ardan.	
GAMEPLAY_EMOTE_HERO_07_GOOD_GAME	Buena partida.	
GAMEPLAY_EMOTE_HERO_07_GREETINGS	Un placer.	
GAMEPLAY_EMOTE_HERO_07_HALLOWS_END	¡Halloween! Mi festividad favorita.	
GAMEPLAY_EMOTE_HERO_07_LOW_CARDS	¡Casi no me quedan cartas!	
GAMEPLAY_EMOTE_HERO_07_MIRROR_START	¡Soy tu pesadilla!	
GAMEPLAY_EMOTE_HERO_07_NO_CARDS	¡No me quedan cartas!	
GAMEPLAY_EMOTE_HERO_07_NOBLEGARDEN	Feliz Jardín Noble.	
GAMEPLAY_EMOTE_HERO_07_OOPS	Eso fue un error.	
GAMEPLAY_EMOTE_HERO_07_PIRATE_DAY	¿Día de los Piratas? No entiendo.	
GAMEPLAY_EMOTE_HERO_07_SORRY	Lo siento.	
GAMEPLAY_EMOTE_HERO_07_START	¡Tu alma será mía!	
GAMEPLAY_EMOTE_HERO_07_THANKS	Gracias.	
GAMEPLAY_EMOTE_HERO_07_THINK1	Mmm...	
GAMEPLAY_EMOTE_HERO_07_THINK2	Me pregunto...	
GAMEPLAY_EMOTE_HERO_07_THINK3	Hay tantas posibilidades...	
GAMEPLAY_EMOTE_HERO_07_THREATEN	¡Tu alma sufrirá!	
GAMEPLAY_EMOTE_HERO_07_TIMER	¡Casi no me queda tiempo!	
GAMEPLAY_EMOTE_HERO_07_WELL_PLAYED	Buena jugada.	
GAMEPLAY_EMOTE_HERO_07_WINTERVEIL_GREETINGS	Que tengas un grato festín del Festival de Invierno...	
GAMEPLAY_EMOTE_HERO_07_WOW	Extraordinario.	
GAMEPLAY_EMOTE_HERO_08_CONCEDE	Ganaste esta vez.	
GAMEPLAY_EMOTE_HERO_08_ERROR_FULL_MINIONS	Tengo demasiados esbirros.	
GAMEPLAY_EMOTE_HERO_08_ERROR_GENERIC	No puedo hacer eso.	
GAMEPLAY_EMOTE_HERO_08_ERROR_HAND_FULL	¡Mi mano está demasiado llena!	
GAMEPLAY_EMOTE_HERO_08_ERROR_I_ATTACKED	Ya ataqué.	
GAMEPLAY_EMOTE_HERO_08_ERROR_JUST_PLAYED	Ese esbirro necesita un turno de descanso.	
GAMEPLAY_EMOTE_HERO_08_ERROR_MINION_ATTACKED	Ese esbirro ya atacó.	
GAMEPLAY_EMOTE_HERO_08_ERROR_NEED_MANA	No tengo suficiente maná.	
GAMEPLAY_EMOTE_HERO_08_ERROR_NEED_WEAPON	Necesito un arma.	
GAMEPLAY_EMOTE_HERO_08_ERROR_PLAY	No puedo hacer esa jugada.	
GAMEPLAY_EMOTE_HERO_08_ERROR_STEALTH	No puedo hacer objetivo en esbirros en Sigilo.	
GAMEPLAY_EMOTE_HERO_08_ERROR_TARGET	Ese objetivo no es válido.	
GAMEPLAY_EMOTE_HERO_08_ERROR_TAUNT	Hay un esbirro con Provocación en el camino.	
GAMEPLAY_EMOTE_HERO_08_EVENT_LUNAR_NEW_YEAR	Hola.	
GAMEPLAY_EMOTE_HERO_08_FIRE_FESTIVAL	¡Feliz Festival de Fuego del Solsticio de Verano!	
GAMEPLAY_EMOTE_HERO_08_GOOD_GAME	Buena partida.	
GAMEPLAY_EMOTE_HERO_08_GREETINGS	Hola.	
GAMEPLAY_EMOTE_HERO_08_HALLOWS_END	Feliz Halloween.	
GAMEPLAY_EMOTE_HERO_08_LOW_CARDS	¡Casi no me quedan cartas!	
GAMEPLAY_EMOTE_HERO_08_MIRROR_START	¡Y tú lo lamentarás!	
GAMEPLAY_EMOTE_HERO_08_NO_CARDS	¡No me quedan cartas!	
GAMEPLAY_EMOTE_HERO_08_NOBLEGARDEN	Feliz Jardín Noble.	
GAMEPLAY_EMOTE_HERO_08_OOPS	Ups.	
GAMEPLAY_EMOTE_HERO_08_PIRATE_DAY	¡Arrr! ¡Alcen las velas!	
GAMEPLAY_EMOTE_HERO_08_SORRY	Lo siento.	
GAMEPLAY_EMOTE_HERO_08_START	¡Tú te lo buscaste!	
GAMEPLAY_EMOTE_HERO_08_THANKS	Gracias.	
GAMEPLAY_EMOTE_HERO_08_THINK1	Mmm...	
GAMEPLAY_EMOTE_HERO_08_THINK2	Me pregunto...	
GAMEPLAY_EMOTE_HERO_08_THINK3	Qué debería hacer... qué debería hacer...	
GAMEPLAY_EMOTE_HERO_08_THREATEN	¡Mi magia te hará pedazos!	
GAMEPLAY_EMOTE_HERO_08_TIMER	¡Se acaba el tiempo!	
GAMEPLAY_EMOTE_HERO_08_WELL_PLAYED	Buena jugada.	
GAMEPLAY_EMOTE_HERO_08_WINTERVEIL_GREETINGS	¡Feliz festín del Festival de Invierno!	
GAMEPLAY_EMOTE_HERO_08_WOW	Alucinante.	
GAMEPLAY_EMOTE_HERO_08A_CELEBRATE	¡Sí, sí! ¡Ja, ja!	
GAMEPLAY_EMOTE_HERO_08A_CONCEDE	¡Jaque mate! Bien hecho.	
GAMEPLAY_EMOTE_HERO_08A_ERROR_FULL_MINIONS	¡Tengo demasiados esbirros!	
GAMEPLAY_EMOTE_HERO_08A_ERROR_GENERIC	No puedo hacer eso.	
GAMEPLAY_EMOTE_HERO_08A_ERROR_HAND_FULL	¡Mi mano está completa!	
GAMEPLAY_EMOTE_HERO_08A_ERROR_I_ATTACKED	Ya he atacado.	
GAMEPLAY_EMOTE_HERO_08A_ERROR_JUST_PLAYED	Ese esbirro necesita un turno de descanso.	
GAMEPLAY_EMOTE_HERO_08A_ERROR_MINION_ATTACKED	Ese esbirro ya atacó.	
GAMEPLAY_EMOTE_HERO_08A_ERROR_NEED_MANA	No tengo suficiente maná.	
GAMEPLAY_EMOTE_HERO_08A_ERROR_NEED_WEAPON	Necesito un arma.	
GAMEPLAY_EMOTE_HERO_08A_ERROR_PLAY	No puedo hacer esa jugada.	
GAMEPLAY_EMOTE_HERO_08A_ERROR_STEALTH	No puedo hacer objetivo en esbirros en Sigilo.	
GAMEPLAY_EMOTE_HERO_08A_ERROR_TARGET	Ese no es un objetivo válido.	
GAMEPLAY_EMOTE_HERO_08A_ERROR_TAUNT	Debo atacar a ese esbirro con Provocación.	
GAMEPLAY_EMOTE_HERO_08A_FIRE_FESTIVAL	¡El Festival de Fuego del Solsticio de Verano ha llegado! 	
GAMEPLAY_EMOTE_HERO_08A_GOOD_GAME	Buena partida.	
GAMEPLAY_EMOTE_HERO_08A_GREETINGS	Ah, saludos.	
GAMEPLAY_EMOTE_HERO_08A_HALLOWS_END	Feliz Halloween.	
GAMEPLAY_EMOTE_HERO_08A_LOW_CARDS	Casi no me quedan cartas.	
GAMEPLAY_EMOTE_HERO_08A_LUNAR_NEW_YEAR	Ah, saludos.	
GAMEPLAY_EMOTE_HERO_08A_MIRROR_START	Oh, ya han comenzado.	
GAMEPLAY_EMOTE_HERO_08A_NO_CARDS	¡No me quedan cartas!	
GAMEPLAY_EMOTE_HERO_08A_NOBLEGARDEN	¡Feliz Jardín Noble!	
GAMEPLAY_EMOTE_HERO_08A_OOPS	Eso fue imprudente.	
GAMEPLAY_EMOTE_HERO_08A_PIRATE_DAY	¡Soy Medivh, el guarrrrrdián!	
GAMEPLAY_EMOTE_HERO_08A_SORRY	Mis más sinceras disculpas.	
GAMEPLAY_EMOTE_HERO_08A_START	¡Que comiencen los juegos!	
GAMEPLAY_EMOTE_HERO_08A_THANKS	Te lo agradezco.	
GAMEPLAY_EMOTE_HERO_08A_THINK1	Mmm...	
GAMEPLAY_EMOTE_HERO_08A_THINK2	Qué interesante...	
GAMEPLAY_EMOTE_HERO_08A_THINK3	Mmm.... Tal vez.	
GAMEPLAY_EMOTE_HERO_08A_THREATEN	¡Nada puede detenerme! ¡Nada!	
GAMEPLAY_EMOTE_HERO_08A_TIMER	¡No debo confiarme tanto!	
GAMEPLAY_EMOTE_HERO_08A_WELL_PLAYED	Buena jugada.	
GAMEPLAY_EMOTE_HERO_08A_WINTERVEIL_GREETINGS	Feliz festín, digno oponente.	
GAMEPLAY_EMOTE_HERO_08A_WOW	Increíble	
GAMEPLAY_EMOTE_HERO_08B_CONCEDE	Bien hecho. Me has vencido.	
GAMEPLAY_EMOTE_HERO_08B_ERROR_FULL_MINIONS	Tengo demasiados esbirros.	
GAMEPLAY_EMOTE_HERO_08B_ERROR_GENERIC	No puedo hacer eso.	
GAMEPLAY_EMOTE_HERO_08B_ERROR_HAND_FULL	¡Mi mano está llena!	
GAMEPLAY_EMOTE_HERO_08B_ERROR_I_ATTACKED	Ya he atacado.	
GAMEPLAY_EMOTE_HERO_08B_ERROR_JUST_PLAYED	Ese esbirro necesita un turno de descanso.	
GAMEPLAY_EMOTE_HERO_08B_ERROR_MINION_ATTACKED	Ese esbirro ya atacó.	
GAMEPLAY_EMOTE_HERO_08B_ERROR_NEED_MANA	No tengo suficiente maná.	
GAMEPLAY_EMOTE_HERO_08B_ERROR_NEED_WEAPON	Necesito un arma.	
GAMEPLAY_EMOTE_HERO_08B_ERROR_PLAY	No puedo hacer esa jugada.	
GAMEPLAY_EMOTE_HERO_08B_ERROR_STEALTH	No puedo hacer objetivo en esbirros en Sigilo.	
GAMEPLAY_EMOTE_HERO_08B_ERROR_TARGET	Ese objetivo no es válido.	
GAMEPLAY_EMOTE_HERO_08B_ERROR_TAUNT	Hay un esbirro con Provocación en el camino.	
GAMEPLAY_EMOTE_HERO_08B_FIRE_FESTIVAL	Que tengas un Solsticio de Verano espléndido.	
GAMEPLAY_EMOTE_HERO_08B_GOOD_GAME	¡Esta sí que ha sido una buena partida!	
GAMEPLAY_EMOTE_HERO_08B_GREETINGS	Te saludo, compañero en la búsqueda de la verdad.	
GAMEPLAY_EMOTE_HERO_08B_HALLOWS_END	Feliz Halloween.	
GAMEPLAY_EMOTE_HERO_08B_LOW_CARDS	Casi no me quedan cartas.	
GAMEPLAY_EMOTE_HERO_08B_LUNAR_NEW_YEAR	Te saludo, compañero en la búsqueda de la verdad.	
GAMEPLAY_EMOTE_HERO_08B_MIRROR_START	Espero que aprendamos mucho juntos.	
GAMEPLAY_EMOTE_HERO_08B_NO_CARDS	¡No me quedan cartas!	
GAMEPLAY_EMOTE_HERO_08B_NOBLEGARDEN	¡Feliz Jardín Noble!	
GAMEPLAY_EMOTE_HERO_08B_OOPS	Ay. Qué pena.	
GAMEPLAY_EMOTE_HERO_08B_PIRATE_DAY	Ah, ¿ahora celebramos el día de los delincuentes marinos?	
GAMEPLAY_EMOTE_HERO_08B_SORRY	Oh, lo siento mucho.	
GAMEPLAY_EMOTE_HERO_08B_START	El conocimiento es poder.	
GAMEPLAY_EMOTE_HERO_08B_THANKS	Te lo agradezco.	
GAMEPLAY_EMOTE_HERO_08B_THINK1	Mmm...	
GAMEPLAY_EMOTE_HERO_08B_THINK2	Observar y reflexionar...	
GAMEPLAY_EMOTE_HERO_08B_THINK3	Debe haber una forma...	
GAMEPLAY_EMOTE_HERO_08B_THREATEN	¡Hora de la lección, cría insolente!	
GAMEPLAY_EMOTE_HERO_08B_TIMER	¡Mira la hora que es!	
GAMEPLAY_EMOTE_HERO_08B_WELL_PLAYED	Buena jugada.	
GAMEPLAY_EMOTE_HERO_08B_WINTERVEIL_GREETINGS	¡Feliz festín del Festival de Invierno!	
GAMEPLAY_EMOTE_HERO_08B_WOW	Maravilloso.	
GAMEPLAY_EMOTE_HERO_09_CONCEDE	Me has vencido.	
GAMEPLAY_EMOTE_HERO_09_ERROR_FULL_MINIONS	Tengo demasiados esbirros.	
GAMEPLAY_EMOTE_HERO_09_ERROR_GENERIC	No puedo hacer eso.	
GAMEPLAY_EMOTE_HERO_09_ERROR_HAND_FULL	¡Mi mano está demasiado llena!	
GAMEPLAY_EMOTE_HERO_09_ERROR_I_ATTACKED	Ya ataqué.	
GAMEPLAY_EMOTE_HERO_09_ERROR_JUST_PLAYED	Ese esbirro necesita un turno de descanso.	
GAMEPLAY_EMOTE_HERO_09_ERROR_MINION_ATTACKED	Ese esbirro ya atacó.	
GAMEPLAY_EMOTE_HERO_09_ERROR_NEED_MANA	No tengo suficiente maná.	
GAMEPLAY_EMOTE_HERO_09_ERROR_NEED_WEAPON	Necesito un arma.	
GAMEPLAY_EMOTE_HERO_09_ERROR_PLAY	No puedo hacer esa jugada.	
GAMEPLAY_EMOTE_HERO_09_ERROR_STEALTH	No puedo hacer objetivo en esbirros en Sigilo.	
GAMEPLAY_EMOTE_HERO_09_ERROR_TARGET	Ese objetivo no es válido.	
GAMEPLAY_EMOTE_HERO_09_ERROR_TAUNT	Hay un esbirro con Provocación en el camino.	
GAMEPLAY_EMOTE_HERO_09_EVENT_LUNAR_NEW_YEAR	Un placer saludarte.	
GAMEPLAY_EMOTE_HERO_09_FIRE_FESTIVAL	¡No veo la hora de que lleguen los fuegos artificiales!	
GAMEPLAY_EMOTE_HERO_09_GOOD_GAME	Buena partida.	
GAMEPLAY_EMOTE_HERO_09_GREETINGS	Un placer saludarte.	
GAMEPLAY_EMOTE_HERO_09_GREETINGS_DISABLED	¡Mmm!	
GAMEPLAY_EMOTE_HERO_09_HALLOWS_END	¡Feliz Halloween!	
GAMEPLAY_EMOTE_HERO_09_LOW_CARDS	¡Casi no me quedan cartas!	
GAMEPLAY_EMOTE_HERO_09_MIRROR_START	¡Y sonreirá sobre los justos!	
GAMEPLAY_EMOTE_HERO_09_NO_CARDS	¡No me quedan cartas!	
GAMEPLAY_EMOTE_HERO_09_NOBLEGARDEN	¡Feliz Jardín Noble!	
GAMEPLAY_EMOTE_HERO_09_OOPS	No era lo que tenía en mente.	
GAMEPLAY_EMOTE_HERO_09_OOPS_DISABLED	¿Mmm?	
GAMEPLAY_EMOTE_HERO_09_PIRATE_DAY	¡Arrrr! ¡Unámonos a la Tripulación aterradora!	
GAMEPLAY_EMOTE_HERO_09_SORRY	Discúlpame.	
GAMEPLAY_EMOTE_HERO_09_START	¡La Luz traerá la victoria!	
GAMEPLAY_EMOTE_HERO_09_THANKS	Gracias.	
GAMEPLAY_EMOTE_HERO_09_THANKS_DISABLED	Mmm.	
GAMEPLAY_EMOTE_HERO_09_THINK1	Mmm...	
GAMEPLAY_EMOTE_HERO_09_THINK2	Me pregunto...	
GAMEPLAY_EMOTE_HERO_09_THINK3	Debo pensar...	
GAMEPLAY_EMOTE_HERO_09_THREATEN	¡La Luz te quemará!	
GAMEPLAY_EMOTE_HERO_09_THREATEN_DISABLED	¡Mmmmmm!	
GAMEPLAY_EMOTE_HERO_09_TIMER	¡Debo decidir rápido!	
GAMEPLAY_EMOTE_HERO_09_WELL_PLAYED	Buena jugada.	
GAMEPLAY_EMOTE_HERO_09_WELL_PLAYED_DISABLED	Mmm...	
GAMEPLAY_EMOTE_HERO_09_WINTERVEIL_GREETINGS	¡Feliz festín del Festival de Invierno!	
GAMEPLAY_EMOTE_HERO_09_WOW	Guau...	
GAMEPLAY_EMOTE_HERO_09_WOW_DISABLED	¡Mmmmmmm…!	
GAMEPLAY_EMOTE_HERO_TBKTRAF_KT_CONCEDE	Re... gresaré...	
GAMEPLAY_EMOTE_HERO_TBKTRAF_KT_GREETINGS	¡Al fin nos conocemos!	
GAMEPLAY_EMOTE_HERO_TBKTRAF_KT_LOW_CARDS	¡Me estoy quedando sin cartas!	
GAMEPLAY_EMOTE_HERO_TBKTRAF_KT_NO_CARDS	¡No! ¡Maldito seas, intruso!	
GAMEPLAY_EMOTE_HERO_TBKTRAF_KT_OOPS	*suspiro* A dibujar otra vez.	
GAMEPLAY_EMOTE_HERO_TBKTRAF_KT_SORRY	¡NO! ¡MALDITO SEAS, INTRUSO!	
GAMEPLAY_EMOTE_HERO_TBKTRAF_KT_START	Ven y enfréntate a mí, intruso.	
GAMEPLAY_EMOTE_HERO_TBKTRAF_KT_THANKS	Ehh... ¿de nada?	
GAMEPLAY_EMOTE_HERO_TBKTRAF_KT_THINK1	Tal vez. 	
GAMEPLAY_EMOTE_HERO_TBKTRAF_KT_THINK2	¡Sí... sí!	
GAMEPLAY_EMOTE_HERO_TBKTRAF_KT_THINK3	¿Qué opinas, Baldomero?	
GAMEPLAY_EMOTE_HERO_TBKTRAF_KT_THREATEN	¡Te congelaré la sangre de las venas!	
GAMEPLAY_EMOTE_HERO_TBKTRAF_KT_WELL_PLAYED	Pfff, qué novedad... ¡Soy el maldito Kel'Thuzad!	
GAMEPLAY_EMOTE_HERO_TBKTRAF_RAF_CONCEDE	¡NO! NADIE PUEDE DERROTARME...	
GAMEPLAY_EMOTE_HERO_TBKTRAF_RAF_GREETINGS	Hola, explorador.	
GAMEPLAY_EMOTE_HERO_TBKTRAF_RAF_LOW_CARDS	¡Me estoy quedando sin cartas!	
GAMEPLAY_EMOTE_HERO_TBKTRAF_RAF_NO_CARDS	¡Mis hermosos tesoros!	
GAMEPLAY_EMOTE_HERO_TBKTRAF_RAF_OOPS	¡Error!	
GAMEPLAY_EMOTE_HERO_TBKTRAF_RAF_SORRY	Me das pena.	
GAMEPLAY_EMOTE_HERO_TBKTRAF_RAF_START	¡RAFAAM, EL ARQUEÓLOGO SUPREMO!	
GAMEPLAY_EMOTE_HERO_TBKTRAF_RAF_THANKS	Ah, gracias.	
GAMEPLAY_EMOTE_HERO_TBKTRAF_RAF_THINK1	Mmm...	
GAMEPLAY_EMOTE_HERO_TBKTRAF_RAF_THINK2	¿Qué me llevaré?	
GAMEPLAY_EMOTE_HERO_TBKTRAF_RAF_THINK3	Tentador...	
GAMEPLAY_EMOTE_HERO_TBKTRAF_RAF_THREATEN	¡PODER SOBRECOGEDOR!	
GAMEPLAY_EMOTE_HERO_TBKTRAF_RAF_WELL_PLAYED	Bien hecho...	
GAMEPLAY_EMOTE_HERO_TBMECHWAR01_CONCEDE	<Rendición>	The text is in brackets because the VO files is just Annoy-o-Tron's greeting
GAMEPLAY_EMOTE_HERO_TBMECHWAR01_ERROR_FULL_MINIONS	<¡Error!>	The text is in brackets because the VO files is just Annoy-o-Tron's greeting
GAMEPLAY_EMOTE_HERO_TBMECHWAR01_ERROR_HAND_FULL	<¡Error!>	The text is in brackets because the VO files is just Annoy-o-Tron's greeting
GAMEPLAY_EMOTE_HERO_TBMECHWAR01_ERROR_I_ATTACKED	<¡Error!>	The text is in brackets because the VO files is just Annoy-o-Tron's greeting
GAMEPLAY_EMOTE_HERO_TBMECHWAR01_ERROR_JUST_PLAYED	<¡Error!>	The text is in brackets because the VO files is just Annoy-o-Tron's greeting
GAMEPLAY_EMOTE_HERO_TBMECHWAR01_ERROR_MINION_ATTACKED	<¡Error!>	The text is in brackets because the VO files is just Annoy-o-Tron's greeting
GAMEPLAY_EMOTE_HERO_TBMECHWAR01_ERROR_NEED_MANA	<¡Error!>	The text is in brackets because the VO files is just Annoy-o-Tron's greeting
GAMEPLAY_EMOTE_HERO_TBMECHWAR01_ERROR_NEED_WEAPON	<¡Error!>	The text is in brackets because the VO files is just Annoy-o-Tron's greeting
GAMEPLAY_EMOTE_HERO_TBMECHWAR01_ERROR_PLAY	<¡Error!>	The text is in brackets because the VO files is just Annoy-o-Tron's greeting
GAMEPLAY_EMOTE_HERO_TBMECHWAR01_ERROR_STEALTH	<¡Error!>	The text is in brackets because the VO files is just Annoy-o-Tron's greeting
GAMEPLAY_EMOTE_HERO_TBMECHWAR01_ERROR_TARGET	<¡Error!>	The text is in brackets because the VO files is just Annoy-o-Tron's greeting
GAMEPLAY_EMOTE_HERO_TBMECHWAR01_ERROR_TAUNT	<¡Error!>	The text is in brackets because the VO files is just Annoy-o-Tron's greeting
GAMEPLAY_EMOTE_HERO_TBMECHWAR01_GREETINGS	<Saludos>	The text is in brackets because the VO files is just Annoy-o-Tron's greeting
GAMEPLAY_EMOTE_HERO_TBMECHWAR01_LOW_CARDS	<Pocas cartas>	The text is in brackets because the VO files is just Annoy-o-Tron's greeting
GAMEPLAY_EMOTE_HERO_TBMECHWAR01_NO_CARDS	<Sin cartas>	The text is in brackets because the VO files is just Annoy-o-Tron's greeting
GAMEPLAY_EMOTE_HERO_TBMECHWAR01_OOPS	<Error>	The text is in brackets because the VO files is just Annoy-o-Tron's greeting
GAMEPLAY_EMOTE_HERO_TBMECHWAR01_SORRY	<Lo siento>	The text is in brackets because the VO files is just Annoy-o-Tron's greeting
GAMEPLAY_EMOTE_HERO_TBMECHWAR01_START	<Comenzar>	The text is in brackets because the VO files is just Annoy-o-Tron's greeting
GAMEPLAY_EMOTE_HERO_TBMECHWAR01_THANKS	<Gracias>	The text is in brackets because the VO files is just Annoy-o-Tron's greeting
GAMEPLAY_EMOTE_HERO_TBMECHWAR01_THINK1	<Procesando...>	The text is in brackets because the VO files is just Annoy-o-Tron's greeting
GAMEPLAY_EMOTE_HERO_TBMECHWAR01_THINK2	<Buscando objetivo...>	The text is in brackets because the VO files is just Annoy-o-Tron's greeting
GAMEPLAY_EMOTE_HERO_TBMECHWAR01_THINK3	<Ciclos desperdiciados...>	The text is in brackets because the VO files is just Annoy-o-Tron's greeting
GAMEPLAY_EMOTE_HERO_TBMECHWAR01_THREATEN	<Amenazar>	The text is in brackets because the VO files is just Annoy-o-Tron's attack
GAMEPLAY_EMOTE_HERO_TBMECHWAR01_TIMER	<Poco tiempo>	The text is in brackets because the VO files is just Annoy-o-Tron's greeting
GAMEPLAY_EMOTE_HERO_TBMECHWAR01_WELL_PLAYED	<Buena jugada>	The text is in brackets because the VO files is just Annoy-o-Tron's greeting
GAMEPLAY_EMOTE_HERO_TBMECHWAR01_WOW	<¡Increíble!>	The text is in brackets because the VO files is just Annoy-o-Tron's greeting
GAMEPLAY_EMOTE_HERO_TBMECHWAR02_CONCEDE	<Fin del camino>	The text is in brackets because the VO files is just Boom Bot's greeting
GAMEPLAY_EMOTE_HERO_TBMECHWAR02_ERROR_FULL_MINIONS	<¡Error!>	The text is in brackets because the VO files is just Boom Bot's greeting
GAMEPLAY_EMOTE_HERO_TBMECHWAR02_ERROR_HAND_FULL	<¡Error!>	The text is in brackets because the VO files is just Boom Bot's greeting
GAMEPLAY_EMOTE_HERO_TBMECHWAR02_ERROR_I_ATTACKED	<¡Error!>	The text is in brackets because the VO files is just Boom Bot's greeting
GAMEPLAY_EMOTE_HERO_TBMECHWAR02_ERROR_JUST_PLAYED	<¡Error!>	The text is in brackets because the VO files is just Boom Bot's greeting
GAMEPLAY_EMOTE_HERO_TBMECHWAR02_ERROR_MINION_ATTACKED	<¡Error!>	The text is in brackets because the VO files is just Boom Bot's greeting
GAMEPLAY_EMOTE_HERO_TBMECHWAR02_ERROR_NEED_MANA	<¡Error!>	The text is in brackets because the VO files is just Boom Bot's greeting
GAMEPLAY_EMOTE_HERO_TBMECHWAR02_ERROR_NEED_WEAPON	<¡Error!>	The text is in brackets because the VO files is just Boom Bot's greeting
GAMEPLAY_EMOTE_HERO_TBMECHWAR02_ERROR_PLAY	<¡Error!>	The text is in brackets because the VO files is just Boom Bot's greeting
GAMEPLAY_EMOTE_HERO_TBMECHWAR02_ERROR_STEALTH	<¡Error!>	The text is in brackets because the VO files is just Boom Bot's greeting
GAMEPLAY_EMOTE_HERO_TBMECHWAR02_ERROR_TARGET	<¡Error!>	The text is in brackets because the VO files is just Boom Bot's greeting
GAMEPLAY_EMOTE_HERO_TBMECHWAR02_ERROR_TAUNT	<¡Error!>	The text is in brackets because the VO files is just Boom Bot's greeting
GAMEPLAY_EMOTE_HERO_TBMECHWAR02_GREETINGS	<Saludos>	The text is in brackets because the VO files is just Annoy-o-Tron's greeting
GAMEPLAY_EMOTE_HERO_TBMECHWAR02_LOW_CARDS	<Pocas cartas>	The text is in brackets because the VO files is just Boom Bot's greeting
GAMEPLAY_EMOTE_HERO_TBMECHWAR02_NO_CARDS	<¡Sin cartas!>	The text is in brackets because the VO files is just Boom Bot's greeting
GAMEPLAY_EMOTE_HERO_TBMECHWAR02_OOPS	<¡Error!>	The text is in brackets because the VO files is just Boom Bot's greeting
GAMEPLAY_EMOTE_HERO_TBMECHWAR02_SORRY	<Disculpas>	The text is in brackets because the VO files is just Boom Bot's greeting
GAMEPLAY_EMOTE_HERO_TBMECHWAR02_START	<Comenzar>	The text is in brackets because the VO files is just Boom Bot's greeting
GAMEPLAY_EMOTE_HERO_TBMECHWAR02_THANKS	<Gracias>	The text is in brackets because the VO files is just Boom Bot's greeting
GAMEPLAY_EMOTE_HERO_TBMECHWAR02_THINK1	<Procesando...>	The text is in brackets because the VO files is just Boom Bot's greeting
GAMEPLAY_EMOTE_HERO_TBMECHWAR02_THINK2	<Buscando objetivo...>	The text is in brackets because the VO files is just Boom Bot's greeting
GAMEPLAY_EMOTE_HERO_TBMECHWAR02_THINK3	<Ciclos desperdiciados...>	The text is in brackets because the VO files is just Boom Bot's greeting
GAMEPLAY_EMOTE_HERO_TBMECHWAR02_THREATEN	<¡Amenaza!>	The text is in brackets because the VO files is just Boom Bot's Attack sound
GAMEPLAY_EMOTE_HERO_TBMECHWAR02_TIMER	<Poco tiempo>	The text is in brackets because the VO files is just Boom Bot's greeting
GAMEPLAY_EMOTE_HERO_TBMECHWAR02_WELL_PLAYED	<Buena jugada>	The text is in brackets because the VO files is just Boom Bot's greeting
GAMEPLAY_EMOTE_HERO_TBMECHWAR02_WOW	<¡Fabuloso!>	The text is in brackets because the VO files is just Annoy-o-Tron's greeting
GAMEPLAY_EMOTE_ICC_481_CONCEDE	Que la victoria te brinde un frío consuelo.	
GAMEPLAY_EMOTE_ICC_481_GREETINGS	Acepta el frío abrazo de la muerte.	
GAMEPLAY_EMOTE_ICC_481_LOW_CARDS	¡Casi no me quedan cartas!	
GAMEPLAY_EMOTE_ICC_481_NO_CARDS	¡No me quedan cartas!	
GAMEPLAY_EMOTE_ICC_481_OOPS	Un grave error.	
GAMEPLAY_EMOTE_ICC_481_START	¡Por Martillo Maldito!	
GAMEPLAY_EMOTE_ICC_481_THANKS	Gracias.	
GAMEPLAY_EMOTE_ICC_481_THINK1	Mmm...	
GAMEPLAY_EMOTE_ICC_481_THINK2	Los elementos están en silencio...	
GAMEPLAY_EMOTE_ICC_481_THINK3	La decisión es solo mía.	
GAMEPLAY_EMOTE_ICC_481_THREATEN	¡Te destruiré!	
GAMEPLAY_EMOTE_ICC_481_TIMER	¡Hay que elegir un camino!	
GAMEPLAY_EMOTE_ICC_481_WELL_PLAYED	Buena jugada.	
GAMEPLAY_EMOTE_ICC_481_WOW	¡Tremendo!	
GAMEPLAY_EMOTE_ICC_827_CONCEDE	El día es tuyo.	
GAMEPLAY_EMOTE_ICC_827_GREETINGS	¿Dónde te estabas escondiendo?	
GAMEPLAY_EMOTE_ICC_827_LOW_CARDS	¡Casi no me quedan cartas!	
GAMEPLAY_EMOTE_ICC_827_NO_CARDS	¡No me quedan cartas!	
GAMEPLAY_EMOTE_ICC_827_OOPS	Qué tragedia.	
GAMEPLAY_EMOTE_ICC_827_START	Ten cuidado.	
GAMEPLAY_EMOTE_ICC_827_THANKS	Gracias.	
GAMEPLAY_EMOTE_ICC_827_THINK1	Mmm...	
GAMEPLAY_EMOTE_ICC_827_THINK2	La sombra de la muerte crece...	
GAMEPLAY_EMOTE_ICC_827_THINK3	El tiempo se desvanece...	
GAMEPLAY_EMOTE_ICC_827_THREATEN	Aprenderás a temerle a tu sombra.	
GAMEPLAY_EMOTE_ICC_827_TIMER	¡Debo decidir pronto!	
GAMEPLAY_EMOTE_ICC_827_WELL_PLAYED	Encantador.	
GAMEPLAY_EMOTE_ICC_827_WOW	¡De otro mundo!	
GAMEPLAY_EMOTE_ICC_828_CONCEDE	Esta cacería te pertenece.	
GAMEPLAY_EMOTE_ICC_828_GREETINGS	Empieza a correr, presa.	
GAMEPLAY_EMOTE_ICC_828_LOW_CARDS	¡Casi no me quedan cartas!	
GAMEPLAY_EMOTE_ICC_828_NO_CARDS	¡No me quedan cartas!	
GAMEPLAY_EMOTE_ICC_828_OOPS	Eso fue un error.	
GAMEPLAY_EMOTE_ICC_828_START	¡Que empiece la cacería!	
GAMEPLAY_EMOTE_ICC_828_THANKS	Te lo agradezco.	
GAMEPLAY_EMOTE_ICC_828_THINK1	Mmm...	
GAMEPLAY_EMOTE_ICC_828_THINK2	Qué huellas seguiré...	
GAMEPLAY_EMOTE_ICC_828_THINK3	Me pregunto...	
GAMEPLAY_EMOTE_ICC_828_THREATEN	Te perseguiré... para siempre.	
GAMEPLAY_EMOTE_ICC_828_TIMER	¡La esencia se desvanece!	
GAMEPLAY_EMOTE_ICC_828_WELL_PLAYED	Buena jugada.	
GAMEPLAY_EMOTE_ICC_828_WOW	Impresionante.	
GAMEPLAY_EMOTE_ICC_829_CONCEDE	Has triunfado... Esta vez.	
GAMEPLAY_EMOTE_ICC_829_GREETINGS	Ahora solo existe mi justicia.	
GAMEPLAY_EMOTE_ICC_829_LOW_CARDS	¡Casi no me quedan cartas!	
GAMEPLAY_EMOTE_ICC_829_NO_CARDS	¡No me quedan cartas!	
GAMEPLAY_EMOTE_ICC_829_OOPS	Qué decepción.	
GAMEPLAY_EMOTE_ICC_829_START	¡Pelearé con honor!	
GAMEPLAY_EMOTE_ICC_829_THANKS	Gracias.	
GAMEPLAY_EMOTE_ICC_829_THINK1	Mmm...	
GAMEPLAY_EMOTE_ICC_829_THINK2	Agonía de escarcha llama...	
GAMEPLAY_EMOTE_ICC_829_THINK3	El Trono Helado llama...	
GAMEPLAY_EMOTE_ICC_829_THREATEN	Suplicarás clemencia y te la negaré.	
GAMEPLAY_EMOTE_ICC_829_TIMER	¡El final está cerca!	
GAMEPLAY_EMOTE_ICC_829_WELL_PLAYED	Buena jugada.	
GAMEPLAY_EMOTE_ICC_829_WOW	¡Increíble!	
GAMEPLAY_EMOTE_ICC_830_CONCEDE	¡No, tu victoria no significa nada!	
GAMEPLAY_EMOTE_ICC_830_GREETINGS	Mi venganza será la oscuridad.	
GAMEPLAY_EMOTE_ICC_830_LOW_CARDS	¡Casi no me quedan cartas!	
GAMEPLAY_EMOTE_ICC_830_NO_CARDS	¡No me quedan cartas!	
GAMEPLAY_EMOTE_ICC_830_OOPS	Errar es humano.	
GAMEPLAY_EMOTE_ICC_830_START	¡La oscuridad anuncia la victoria!	
GAMEPLAY_EMOTE_ICC_830_THANKS	Gracias.	
GAMEPLAY_EMOTE_ICC_830_THINK1	Mmm...	
GAMEPLAY_EMOTE_ICC_830_THINK2	La oscuridad es mi compañera...	
GAMEPLAY_EMOTE_ICC_830_THINK3	Pensamientos oscuros...	
GAMEPLAY_EMOTE_ICC_830_THREATEN	¡La oscuridad te consumirá!	
GAMEPLAY_EMOTE_ICC_830_TIMER	¡Las sombras se disipan!	
GAMEPLAY_EMOTE_ICC_830_WELL_PLAYED	Buena jugada.	
GAMEPLAY_EMOTE_ICC_830_WOW	¡Asombroso!	
GAMEPLAY_EMOTE_ICC_831_CONCEDE	Tú ganas... por ahora.	
GAMEPLAY_EMOTE_ICC_831_GREETINGS	Teme mi presencia.	
GAMEPLAY_EMOTE_ICC_831_LOW_CARDS	¡Casi no me quedan cartas!	
GAMEPLAY_EMOTE_ICC_831_NO_CARDS	¡No me quedan cartas!	
GAMEPLAY_EMOTE_ICC_831_OOPS	Eso no tuvo sentido.	
GAMEPLAY_EMOTE_ICC_831_START	¡Tu alma será mía!	
GAMEPLAY_EMOTE_ICC_831_THANKS	Ah, gracias.	
GAMEPLAY_EMOTE_ICC_831_THINK1	Mmm...	
GAMEPLAY_EMOTE_ICC_831_THINK2	Mi sed de sangre es cada vez mayor…	
GAMEPLAY_EMOTE_ICC_831_THINK3	Tantas opciones para matar...	
GAMEPLAY_EMOTE_ICC_831_THREATEN	Tu sufrimiento será... ¡legendario!	
GAMEPLAY_EMOTE_ICC_831_TIMER	¡Debo alimentarme, ahora!	
GAMEPLAY_EMOTE_ICC_831_WELL_PLAYED	Bien hecho.	
GAMEPLAY_EMOTE_ICC_831_WOW	Malditas llamas infernales.	
GAMEPLAY_EMOTE_ICC_832_CONCEDE	Tú ganas. Ahora puedo descansar.	
GAMEPLAY_EMOTE_ICC_832_GREETINGS	El ciclo de la peste ha comenzado.	
GAMEPLAY_EMOTE_ICC_832_LOW_CARDS	¡Casi no me quedan cartas!	
GAMEPLAY_EMOTE_ICC_832_NO_CARDS	¡No me quedan cartas!	
GAMEPLAY_EMOTE_ICC_832_OOPS	La telaraña se desarma.	
GAMEPLAY_EMOTE_ICC_832_START	¡El círculo de la vida ha llegado a su fin!	
GAMEPLAY_EMOTE_ICC_832_THANKS	Te lo agradezco.	
GAMEPLAY_EMOTE_ICC_832_THINK1	Mmm...	
GAMEPLAY_EMOTE_ICC_832_THINK2	Una red enmarañada...	
GAMEPLAY_EMOTE_ICC_832_THINK3	Mis pensamientos están infestados...	
GAMEPLAY_EMOTE_ICC_832_THREATEN	Te marchitarás y te pudrirás.	
GAMEPLAY_EMOTE_ICC_832_TIMER	La muerte es eterna... ¡pero mi turno no!	
GAMEPLAY_EMOTE_ICC_832_WELL_PLAYED	Una jugada maestra.	
GAMEPLAY_EMOTE_ICC_832_WOW	¡Sorprendente!	
GAMEPLAY_EMOTE_ICC_833_CONCEDE	Me rindo ante tu poder.	
GAMEPLAY_EMOTE_ICC_833_GREETINGS	¿Por qué tiemblas? ¿Tienes miedo?	
GAMEPLAY_EMOTE_ICC_833_LOW_CARDS	¡Casi no me quedan cartas!	
GAMEPLAY_EMOTE_ICC_833_NO_CARDS	¡No me quedan cartas!	
GAMEPLAY_EMOTE_ICC_833_OOPS	Un error fatal.	
GAMEPLAY_EMOTE_ICC_833_START	¡Tú te lo buscaste!	
GAMEPLAY_EMOTE_ICC_833_THANKS	Gracias.	
GAMEPLAY_EMOTE_ICC_833_THINK1	Mmm...	
GAMEPLAY_EMOTE_ICC_833_THINK2	El tiempo se desvanece...	
GAMEPLAY_EMOTE_ICC_833_THINK3	Mmm, tengo que decidir...	
GAMEPLAY_EMOTE_ICC_833_THREATEN	¡Inclínate ante tu reina!	
GAMEPLAY_EMOTE_ICC_833_TIMER	¡Es el momento de actuar!	
GAMEPLAY_EMOTE_ICC_833_WELL_PLAYED	Buena jugada.	
GAMEPLAY_EMOTE_ICC_833_WOW	¡Me quedé helada!	
GAMEPLAY_EMOTE_ICC_834_CONCEDE	Elijo la muerte.	
GAMEPLAY_EMOTE_ICC_834_GREETINGS	¡No escaparás de la ira de Grito Infernal!	
GAMEPLAY_EMOTE_ICC_834_LOW_CARDS	Casi no me quedan cartas.	
GAMEPLAY_EMOTE_ICC_834_NO_CARDS	No me quedan cartas.	
GAMEPLAY_EMOTE_ICC_834_OOPS	Error.	
GAMEPLAY_EMOTE_ICC_834_START	Victoria o muerte.	
GAMEPLAY_EMOTE_ICC_834_THANKS	Te lo agradezco.	
GAMEPLAY_EMOTE_ICC_834_THINK1	Mmm...	
GAMEPLAY_EMOTE_ICC_834_THINK2	Se acaba el tiempo...	
GAMEPLAY_EMOTE_ICC_834_THINK3	Ahora qué...	
GAMEPLAY_EMOTE_ICC_834_THREATEN	Serás el primero en arrodillarse.	
GAMEPLAY_EMOTE_ICC_834_TIMER	¡Debo elegir!	
GAMEPLAY_EMOTE_ICC_834_WELL_PLAYED	Un oponente digno.	
GAMEPLAY_EMOTE_ICC_834_WOW	¡Asombroso!	
VO_Arthas_Male_Human_Attack_01	¡PURIFICAREMOS el mal!	
VO_Arthas_Male_Human_CONCEDE_01	La batalla ha terminado. Tú ganas.	
VO_Arthas_Male_Human_ERROR_FULL_MINIONS_01	¡Tengo demasiados esbirros!	
VO_Arthas_Male_Human_ERROR_GENERIC_01	No puedo hacer eso.	
VO_Arthas_Male_Human_ERROR_HAND_FULL_01	¡Mi mano está llena!	
VO_Arthas_Male_Human_ERROR_I_ATTACKED_01	Ya ataqué.	
VO_Arthas_Male_Human_ERROR_JUST_PLAYED_01	Ese esbirro necesita un turno de descanso.	
VO_Arthas_Male_Human_ERROR_MINION_ATTACKED_01	Ese esbirro ya atacó.	
VO_Arthas_Male_Human_ERROR_NEED_MANA_01	No tengo suficiente maná.	
VO_Arthas_Male_Human_ERROR_NEED_WEAPON_01	Necesito un arma.	
VO_Arthas_Male_Human_ERROR_PLAY_01	No puedo hacer esa jugada.	
VO_Arthas_Male_Human_ERROR_STEALTH_01	No puedo atacar esbirros en Sigilo.	
VO_Arthas_Male_Human_ERROR_TARGET_01	Ese objetivo no es válido.	
VO_Arthas_Male_Human_ERROR_TAUNT_01	Hay un esbirro con Provocación en el camino.	
VO_Arthas_Male_Human_FIRE_FESTIVAL_01	¡Enciendan las fogatas!	
VO_Arthas_Male_Human_GREETINGS_01	Es un gusto verte.	
VO_Arthas_Male_Human_HAPPY_HALLOWEEN_01	Feliz Halloween...	
VO_Arthas_Male_Human_HAPPY_HOLIDAYS_01	¡Feliz festín del Festival de Invierno!	
VO_Arthas_Male_Human_HAPPY_NEW_YEAR_01	¡Feliz año nuevo!	
VO_Arthas_Male_Human_HAPPY_NEW_YEAR_LUNAR_01	¡Feliz año nuevo!	
VO_Arthas_Male_Human_HAPPY_NOBLEGARDEN	Feliz Jardín Noble.	
VO_Arthas_Male_Human_LOW_CARDS_01	Casi no me quedan cartas.	
VO_Arthas_Male_Human_MIRROR_GREETINGS_01	¡El gusto es todo mío!	
VO_Arthas_Male_Human_MIRROR_START_01	¡Por mi padre, el rey!	
VO_Arthas_Male_Human_NO_CARDS_01	¡No me quedan cartas!	
VO_Arthas_Male_Human_OOPS_01	Una equivocación.	
VO_Arthas_Male_Human_PIRATE_DAY_01	¡Aahh, marineros, se siente bien ser Arrrthas!	
VO_Arthas_Male_Human_SORRY_01	Lo siento mucho, de verdad.	
VO_Arthas_Male_Human_START_01	¡Por Lordaeron!	
VO_Arthas_Male_Human_THANKS_01	Te has ganado mi gratitud.	
VO_Arthas_Male_Human_THINK1_01	Mmm...	
VO_Arthas_Male_Human_THINK2_01	Cuál será el camino correcto...	
VO_Arthas_Male_Human_THINK3_01	¿Qué haría Uther en esta situación...?	
VO_Arthas_Male_Human_THREATEN_01	¡No tienes salvación!	
VO_Arthas_Male_Human_TIMER_01	¡Debo actuar ahora!	
VO_Arthas_Male_Human_WELL_PLAYED_01	Buena jugada.	
VO_Arthas_Male_Human_WOW_01	¡Por la Luz!	
VO_BRM_027h__LUNAR_NEW_YEAR	¡QUE EL FUEGO TE PURIFIQUE!	
VO_BRM_027h_Attack_15	¡PRUEBA LAS LLAMAS DE SULFURON!	
VO_BRM_027h_Concede_11	TÚ GANAS. ¡BIEN HECHO!	
VO_BRM_027h_Emote_Start	¡Me vengaré, dragón!	
VO_BRM_027h_ERROR01_51	NECESITO UN ARMA.	
VO_BRM_027h_ERROR02_52	NO TENGO SUFICIENTE MANÁ.	
VO_BRM_027h_ERROR03_53	YA ATACÓ.	
VO_BRM_027h_ERROR04_54	YA ATAQUÉ.	
VO_BRM_027h_ERROR05_55	LOS MORTALES NECESITAN UN TURNO DE PREPARACIÓN.	
VO_BRM_027h_ERROR06_56	HAY DEMASIADAS CARTAS.	
VO_BRM_027h_ERROR07_57	HAY DEMASIADOS ESBIRROS.	
VO_BRM_027h_ERROR08_58	ESTÁ EN SIGILO.	
VO_BRM_027h_ERROR09_59	NO PUEDO HACER ESA JUGADA.	
VO_BRM_027h_ERROR10_60	NO ES VÁLIDO.	
VO_BRM_027h_ERROR11_61	ESE ESBIRRO CON PROVOCACIÓN ESTÁ EN MI CAMINO.	
VO_BRM_027h_ERROR12_62	NO PUEDO HACER ESO.	
VO_BRM_027h_FIRE_FESTIVAL	¡ESTE ES MI FESTIVAL!	
VO_BRM_027h_GG_16	¡BUENA PARTIDA!	
VO_BRM_027h_Greetings_04	¡QUE EL FUEGO TE PURIFIQUE!	
VO_BRM_027h_HALLOWS_END	¡FELIZ HALLOWEEN!	
VO_BRM_027h_HAPPY_NEW_YEAR_38	¡EL AÑO NUEVO LLEGARÁ EN LLAMAS!	
VO_BRM_027h_LowCards_49	YA HE QUEMADO CASI TODAS MIS CARTAS.	
VO_BRM_027h_NOBLEGARDEN	¡NO ES JUSTO! LOS HUEVOS QUE ENCUENTRO... ¡SE COCINAN!	
VO_BRM_027h_NoCards_50	HE QUEMADO TODAS MIS CARTAS.	
VO_BRM_027h_Oops_07	¡AH! ¡UNA EQUIVOCACIÓN!	
VO_BRM_027h_PIRATE_DAY	¡CONTEMPLEN AL SEÑOR ARRRRDIENTE!	
VO_BRM_027h_Sorry_10	LO SIENTO.	
VO_BRM_027h_Thanks_09	MI MÁS CÁLIDO AGRADECIMIENTO.	
VO_BRM_027h_Thinking1_12	MMM...	
VO_BRM_027h_Thinking2_13	ME PREGUNTO...	
VO_BRM_027h_Thinking3_14	¿QUÉ QUEMARÉ PRIMERO...?	
VO_BRM_027h_Threaten_08	¡PERECERÁS EN LAS LLAMAS!	
VO_BRM_027h_Time_48	¡EL TIEMPO SE CONSUME!	
VO_BRM_027h_Well_Played_06	BUENA JUGADA.	
VO_BRM_027h_Winterveil_Greetings	¡EL INVIERNO DEBERÍA SER MÁS CÁLIDO!	
VO_BRM_027h_WOW_20	ESTO SÍ QUE ESTÁ CALIENTE.	
VO_EX1_323h_HAPPY_NEW_YEAR_13	¡FELIZ AÑO NUEVO!	
VO_GIL_504_Female_Orc_Concede_01	Tú ganas esta vez.	
VO_GIL_504_Female_Orc_Greetings_02	Bienvenido a mis dominios.	
VO_GIL_504_Female_Orc_LowCards_01	¡Casi no me quedan cartas!	
VO_GIL_504_Female_Orc_NoCards_01	¡No me quedan cartas!	
VO_GIL_504_Female_Orc_Oops_01	Eso no fue sensato.	
VO_GIL_504_Female_Orc_Start_01	Los bosques son peligrosos por la noche.	
VO_GIL_504_Female_Orc_Thanks_01	Gracias.	
VO_GIL_504_Female_Orc_Thinking_01	Mmm...	
VO_GIL_504_Female_Orc_Thinking_02	Desconcertante...	
VO_GIL_504_Female_Orc_Thinking_03	Hay poca luz en esta senda...	
VO_GIL_504_Female_Orc_Threaten_02	¡La maldición se apoderará de ti!	
VO_GIL_504_Female_Orc_Time_01	¡Tengo que decidirme!	
VO_GIL_504_Female_Orc_Well_Played_01	Buena jugada.	
VO_GIL_504_Female_Orc_Wow_01	¡Por la noche!	
VO_GILA_400h_Male_Human_Concede_01	¡Eres demasiado para mí!	
VO_GILA_400h_Male_Human_Death_02	<Muerte>	
VO_GILA_400h_Male_Human_ERROR_FULL_MINIONS_01	No hay lugar para nadie más.	
VO_GILA_400h_Male_Human_ERROR_GENERIC_01	No puedo hacerlo.	
VO_GILA_400h_Male_Human_ERROR_GENERIC_04	Simplemente no puedo.	
VO_GILA_400h_Male_Human_ERROR_HAND_FULL_01	¡Tengo demasiadas cartas!	
VO_GILA_400h_Male_Human_ERROR_I_ATTACKED_01	Ya ataqué.	
VO_GILA_400h_Male_Human_ERROR_MINION_ATTACKED_01	Ese ya atacó.	
VO_GILA_400h_Male_Human_ERROR_NEED_MANA_02	¡Ya no tengo más maná!	
VO_GILA_400h_Male_Human_ERROR_NEED_WEAPON_02	¡Necesito un arma!	
VO_GILA_400h_Male_Human_ERROR_STEALTH_01	¡Qué sigiloso!	
VO_GILA_400h_Male_Human_ERROR_SUMMON_SICKNESS_01	Ese no está listo.	
VO_GILA_400h_Male_Human_ERROR_TARGET_01	No puedo hacer objetivo en eso.	
VO_GILA_400h_Male_Human_ERROR_TAUNT_01	Hay un esbirro con Provocación bloqueándonos.	
VO_GILA_400h_Male_Human_Greetings_01	No me agradas. Y a mis perros tampoco.	
VO_GILA_400h_Male_Human_LowCards_01	Casi no me quedan cartas…	
VO_GILA_400h_Male_Human_NoCards_01	¡No me quedan cartas!	
VO_GILA_400h_Male_Human_Oops_01	Eso fue de lo peor.	
VO_GILA_400h_Male_Human_Sorry_01	Lo siento tanto.	
VO_GILA_400h_Male_Human_Start_01	Mira lo que desenterraron los perros.	
VO_GILA_400h_Male_Human_Thanks_01	Gracias por eso.	
VO_GILA_400h_Male_Human_Thinking_01	Eh...	
VO_GILA_400h_Male_Human_Thinking_03	Tengo que pensarlo bien...	
VO_GILA_400h_Male_Human_Thinking_04	Vamos, vamos...	
VO_GILA_400h_Male_Human_Threaten_04	Será mejor que te hagas el muerto.	
VO_GILA_400h_Male_Human_Time_01	No queda mucho tiempo.	
VO_GILA_400h_Male_Human_Well_Played_01	¡Qué buen truco!	
VO_GILA_400h_Male_Human_WOW_01	¡Guuaau!	
VO_GILA_500h3_Female_Human_Concede_01	¡No puedo derrotarte!	
VO_GILA_500h3_Female_Human_ERROR_FULL_MINIONS_01	No hay suficiente lugar.	
VO_GILA_500h3_Female_Human_ERROR_GENERIC_04	¡Eso no está permitido!	
VO_GILA_500h3_Female_Human_ERROR_HAND_FULL_02	¡Mi mano está demasiado llena!	
VO_GILA_500h3_Female_Human_ERROR_I_ATTACKED_02	¡No puedo atacar dos veces!	
VO_GILA_500h3_Female_Human_ERROR_MINION_ATTACKED_01	Ya atacó.	
VO_GILA_500h3_Female_Human_ERROR_NEED_MANA_02	No tengo suficiente maná.	
VO_GILA_500h3_Female_Human_ERROR_NEED_WEAPON_02	Voy a necesitar un arma.	
VO_GILA_500h3_Female_Human_ERROR_PLAY_01	No puedo romper las reglas.	
VO_GILA_500h3_Female_Human_ERROR_STEALTH_01	¡No lo encuentro!	
VO_GILA_500h3_Female_Human_ERROR_SUMMON_SICKNESS_01	Ese esbirro no está listo.	
VO_GILA_500h3_Female_Human_ERROR_TARGET_01	No puedo hacer objetivo en eso.	
VO_GILA_500h3_Female_Human_ERROR_TAUNT_01	¡Hay un esbirro con Provocación bloqueándome!	
VO_GILA_500h3_Female_Human_Greetings_01	Los Descoronados envían sus saludos.	
VO_GILA_500h3_Female_Human_LowCards_01	No me quedan muchas cartas...	
VO_GILA_500h3_Female_Human_NoCards_01	¡No me quedan cartas!	
VO_GILA_500h3_Female_Human_Oops_02	Eso... no fue intencional.	
VO_GILA_500h3_Female_Human_Sorry_01	Lamento eso.	
VO_GILA_500h3_Female_Human_Start_01	El rastro llega hasta aquí.	
VO_GILA_500h3_Female_Human_Thanks_01	Gracias.	
VO_GILA_500h3_Female_Human_Thinking_02	Debe haber una forma...	
VO_GILA_500h3_Female_Human_Thinking_03	Piensa, Tess. Piensa.	
VO_GILA_500h3_Female_Human_Thinking_05	Ahhh... mmm.	
VO_GILA_500h3_Female_Human_Threaten_03	¡Te aniquilaré!	
VO_GILA_500h3_Female_Human_Time_01	Debo actuar rápido.	
VO_GILA_500h3_Female_Human_Well_Played_01	Muy buenas tácticas. 	
VO_GILA_500h3_Female_Human_WOW_01	Absolutamente increíble.	
VO_GILA_600h_Male_Worgen_Concede_01	¡Fuiste superior a mí!	
VO_GILA_600h_Male_Worgen_ERROR_FULL_MINIONS_02	Tengo demasiados esbirros en el campo de batalla.	
VO_GILA_600h_Male_Worgen_ERROR_GENERIC_01	Eso es imposible.	
VO_GILA_600h_Male_Worgen_ERROR_GENERIC_02	No puedo hacer eso.	
VO_GILA_600h_Male_Worgen_ERROR_HAND_FULL_01	¡Demasiadas cartas!	
VO_GILA_600h_Male_Worgen_ERROR_I_ATTACKED_01	Ya ataqué.	
VO_GILA_600h_Male_Worgen_ERROR_MINION_ATTACKED_01	Ese esbirro ya atacó.	
VO_GILA_600h_Male_Worgen_ERROR_NEED_MANA_01	No me queda maná. 	
VO_GILA_600h_Male_Worgen_ERROR_NEED_WEAPON_02	Necesito un arma.	
VO_GILA_600h_Male_Worgen_ERROR_STEALTH_01	¡Ese esbirro está ocultándose!	
VO_GILA_600h_Male_Worgen_ERROR_SUMMON_SICKNESS_01	Todavía no está listo para moverse.	
VO_GILA_600h_Male_Worgen_ERROR_TARGET_01	No puedo hacer objetivo en eso.	
VO_GILA_600h_Male_Worgen_ERROR_TAUNT_01	¡Hay un esbirro con Provocación en el camino!	
VO_GILA_600h_Male_Worgen_Greetings_01	Saluda a mi amigote.	
VO_GILA_600h_Male_Worgen_LowCards_01	Casi no me quedan cartas.	
VO_GILA_600h_Male_Worgen_NoCards_01	¡Ya no me quedan cartas!	
VO_GILA_600h_Male_Worgen_Oops_01	¡Eso estuvo mal!	
VO_GILA_600h_Male_Worgen_Sorry_01	Lo... siento.	
VO_GILA_600h_Male_Worgen_Start_01	Estoy en posición.	
VO_GILA_600h_Male_Worgen_Thanks_01	Gracias.	
VO_GILA_600h_Male_Worgen_Thinking_01	Mmm....	
VO_GILA_600h_Male_Worgen_Thinking_02	Qué puedo hacer ahora...	
VO_GILA_600h_Male_Worgen_Thinking_04	Encontraré una forma...	
VO_GILA_600h_Male_Worgen_Threaten_01	¡Te haré pedazos!	
VO_GILA_600h_Male_Worgen_Time_01	¡No me apures!	
VO_GILA_600h_Male_Worgen_Well_Played_01	Una maniobra excelente.	
VO_GILA_600h_Male_Worgen_WOW_01	¡Increíble!	
VO_GILA_900h_Female_Gnome_Concede_01	Ya lo intenté todo. ¡Tú ganas!	
VO_GILA_900h_Female_Gnome_ERROR_FULL_MINIONS_02	No puedo tener más esbirros.	
VO_GILA_900h_Female_Gnome_ERROR_GENERIC_01	No puedo hacer eso.	
VO_GILA_900h_Female_Gnome_ERROR_HAND_FULL_01	¡Tengo demasiadas cartas!	
VO_GILA_900h_Female_Gnome_ERROR_I_ATTACKED_02	¡Todavía no puedo atacar de nuevo!	
VO_GILA_900h_Female_Gnome_ERROR_MINION_ATTACKED_01	Ese esbirro ya atacó.	
VO_GILA_900h_Female_Gnome_ERROR_NEED_MANA_01	No tengo suficiente maná.	
VO_GILA_900h_Female_Gnome_ERROR_NEED_WEAPON_01	No tengo un arma.	
VO_GILA_900h_Female_Gnome_ERROR_PLAY_01	Ni siquiera yo puedo hacer eso. 	
VO_GILA_900h_Female_Gnome_ERROR_STEALTH_01	Ese objetivo sí que es sigiloso.	
VO_GILA_900h_Female_Gnome_ERROR_SUMMON_SICKNESS_01	Ese esbirro necesita tiempo para prepararse.	
VO_GILA_900h_Female_Gnome_ERROR_TARGET_01	Ese no es un buen objetivo.	
VO_GILA_900h_Female_Gnome_ERROR_TAUNT_01	¡Hay un esbirro con Provocación en el camino!	
VO_GILA_900h_Female_Gnome_GG_01	¡Vaya, qué buena partida!	
VO_GILA_900h_Female_Gnome_Greetings_01	Ah, hola. Tú otra vez.	
VO_GILA_900h_Female_Gnome_LowCards_01	No me quedan muchas cartas...	
VO_GILA_900h_Female_Gnome_NoCards_01	¡No me quedan cartas!	
VO_GILA_900h_Female_Gnome_Oops_02	Creo que eso fue un error.	
VO_GILA_900h_Female_Gnome_Sorry_01	Eh, ¿perdón?	
VO_GILA_900h_Female_Gnome_Start_01	¡Se te acabó el tiempo!	
VO_GILA_900h_Female_Gnome_Thanks_01	Gracias.	
VO_GILA_900h_Female_Gnome_Thinking_02	Mmm...	
VO_GILA_900h_Female_Gnome_Thinking_03	…tengo que pensar en cuatro dimensiones...	
VO_GILA_900h_Female_Gnome_Thinking_05	…las ruedas giran...	
VO_GILA_900h_Female_Gnome_Threaten_01	¡Te borraré de la línea temporal!	
VO_GILA_900h_Female_Gnome_Time_01	¿Cómo puede ser que a MÍ se me acabe el tiempo?	
VO_GILA_900h_Female_Gnome_Well_Played_01	¡No podría haberlo hecho mejor!	
VO_GILA_900h_Female_Gnome_WOW_02	¡Inconcebible!	
VO_HERO_01_HAPPY_NEW_YEAR_06	¡Feliz año nuevo!	
VO_HERO_02_HAPPY_NEW_YEAR_07	¡Feliz año nuevo!	
VO_HERO_03_HAPPY_NEW_YEAR_06	¡Feliz año nuevo!	
VO_HERO_03a_Attack_15	¡La justicia es MÍA!	
VO_HERO_03a_CONCEDE_06	Has jugado muy bien. Me rindo.	
VO_HERO_03a_ERROR_FULL_MINIONS_25	¡Tengo demasiados esbirros!	
VO_HERO_03a_ERROR_GENERIC_30	No puedo hacer eso.	
VO_HERO_03a_ERROR_HAND_FULL_24	¡Mi mano está llena!	
VO_HERO_03a_ERROR_I_ATTACKED_22	Ya he atacado.	
VO_HERO_03a_ERROR_JUST_PLAYED_23	Ese esbirro necesita un turno de descanso.	
VO_HERO_03a_ERROR_MINION_ATTACKED_21	Ese esbirro ya atacó.	
VO_HERO_03a_ERROR_NEED_MANA_20	No tengo suficiente maná.	
VO_HERO_03a_ERROR_NEED_WEAPON_19	Necesito un arma.	
VO_HERO_03a_ERROR_PLAY_27	No puedo hacer esa jugada.	
VO_HERO_03a_ERROR_STEALTH_26	No puedo hacer objetivo en esbirros en Sigilo.	
VO_HERO_03a_ERROR_TARGET_28	Ese objetivo no es válido.	
VO_HERO_03a_ERROR_TAUNT_29	Hay un esbirro con Provocación en el camino.	
VO_HERO_03a_FIRE_FESTIVAL	Feliz festival del Solsticio de Verano.	
VO_HERO_03a_GREETINGS_03	Saludos.	
VO_HERO_03a_HALLOWS_END	Feliz Halloween.	
VO_HERO_03a_HAPPY_HOLIDAYS_52	¡Feliz festín del Festival de Invierno!	
VO_HERO_03a_HAPPY_NEW_YEAR_53	¡Feliz año nuevo!	
VO_HERO_03a_LOW_CARDS_17	Casi no me quedan cartas.	
VO_HERO_03a_MIRROR_GREETINGS_04	Qué agradable sorpresa. ¡Hola!	
VO_HERO_03a_MIRROR_START_02	¡Soy la mano de hierro de la justicia!	
VO_HERO_03a_NO_CARDS_18	¡No me quedan cartas!	
VO_HERO_03a_NOBLEGARDEN	¡Feliz Jardín Noble! ¿Dónde están los huevos?	
VO_HERO_03a_OOPS_08	Solo un error táctico.	
VO_HERO_03a_PICKED_11	¡Este es el momento!	
VO_HERO_03a_PIRATE_DAY	¡Arr, camarada!	
VO_HERO_03a_SORRY_10	Lo siento.	
VO_HERO_03a_START_01	¡Nadie escapa a mi furia!	
VO_HERO_03a_THANKS_09	Gracias.	
VO_HERO_03a_THINK1_12	Mmm...	
VO_HERO_03a_THINK2_13	Me pregunto...	
VO_HERO_03a_THINK3_14	Déjame pensar...	
VO_HERO_03a_THREATEN_05	¡Despiertas mi cólera!	
VO_HERO_03a_TIMER_16	¡Rápido!	
VO_HERO_03a_WELL_PLAYED_07	Buena jugada.	
VO_HERO_03a_WOW_35	Alucinante.	
VO_HERO_04_HAPPY_NEW_YEAR_15	¡Feliz año nuevo, adalid!	
VO_HERO_05_HAPPY_NEW_YEAR_15	¡Feliz año nuevo!	
VO_HERO_06_HAPPY_NEW_YEAR_15	¡Feliz año nuevo!	
VO_HERO_07_HAPPY_NEW_YEAR_15	¡Feliz año nuevo!	
VO_HERO_08_HAPPY_NEW_YEAR_15	¡Feliz año nuevo!	
VO_HERO_08b_HAPPY_NEW_YEAR_53	¡Feliz año nuevo!	
VO_HERO_09_HAPPY_NEW_YEAR_15	¡Feliz año nuevo!	
VO_HERO_09a_Attack_15	¡Por Elune!	
VO_HERO_09a_CONCEDE_06	No hay nada más que hacer. Tú ganas.	
VO_HERO_09a_ERROR_FULL_MINIONS_25	¡Tengo demasiados esbirros!	
VO_HERO_09a_ERROR_GENERIC_30	No puedo hacer eso.	
VO_HERO_09a_ERROR_HAND_FULL_24	¡Mi mano está llena!	
VO_HERO_09a_ERROR_I_ATTACKED_22	Ya he atacado.	
VO_HERO_09a_ERROR_JUST_PLAYED_23	Ese esbirro necesita un turno de descanso.	
VO_HERO_09a_ERROR_MINION_ATTACKED_21	Ese esbirro ya atacó.	
VO_HERO_09a_ERROR_NEED_MANA_20	No tengo suficiente maná.	
VO_HERO_09a_ERROR_NEED_WEAPON_19	Necesito un arma.	
VO_HERO_09a_ERROR_PLAY_27	No puedo hacer esa jugada.	
VO_HERO_09a_ERROR_STEALTH_26	No puedo hacer objetivo en esbirros en Sigilo.	
VO_HERO_09a_ERROR_TARGET_28	Ese objetivo no es válido.	
VO_HERO_09a_ERROR_TAUNT_29	Hay un esbirro con Provocación en el camino.	
VO_HERO_09a_FIRE_FESTIVAL	Feliz festival del Solsticio de Verano.	
VO_HERO_09a_GREETINGS_03	Bendiciones.	
VO_HERO_09a_HALLOWS_END	Feliz Halloween.	
VO_HERO_09a_HAPPY_HOLIDAYS_52	¡Feliz festín del Festival de Invierno!	
VO_HERO_09a_HAPPY_NEW_YEAR_01	¡Feliz año nuevo!	
VO_HERO_09a_HAPPY_NEW_YEAR_LUNAR_53	Bendiciones.	
VO_HERO_09a_LOW_CARDS_17	Casi no me quedan cartas.	
VO_HERO_09a_MIRROR_GREETINGS_04	Lo mismo para ti.	
VO_HERO_09a_MIRROR_START_02	La diosa es mi escudo.	
VO_HERO_09a_NO_CARDS_18	¡No me quedan cartas!	
VO_HERO_09a_NOBLEGARDEN	Feliz Jardín Noble.	
VO_HERO_09a_OOPS_08	Un error.	
VO_HERO_09a_PICKED_11	¡La diosa llama!	
VO_HERO_09a_PIRATE_DAY	Palabra de poder: ¡Arrr!	
VO_HERO_09a_SORRY_10	Perdóname.	
VO_HERO_09a_START_01	Elune, dame fuerzas.	
VO_HERO_09a_START_MALFURION	Mi querido Malfurion.	
VO_HERO_09a_THANKS_09	Gracias.	
VO_HERO_09a_THINK1_12	Mmm...	
VO_HERO_09a_THINK2_13	Me pregunto...	
VO_HERO_09a_THINK3_14	Cuál será la voluntad de Elune...	
VO_HERO_09a_THREATEN_05	¡Te arrepentirás!	
VO_HERO_09a_TIMER_16	¡Date prisa!	
VO_HERO_09a_WELL_PLAYED_07	Buena jugada.	
VO_HERO_09a_WOW_10	¡Brillante!	
VO_HERO_11_HAPPY_NEW_YEAR_20	¡Feliz año nuevo!	
VO_HERO_12_HAPPY_NEW_YEAR_20	¡Feliz año nuevo!	
VO_HERO_13_HAPPY_NEW_YEAR_20	¡Feliz año nuevo!	
VO_HERO_14_HAPPY_NEW_YEAR_20	¡Feliz año nuevo!	
VO_HERO_15_HAPPY_NEW_YEAR_24	<¡Feliz año nuevo!>	
VO_HERO_16_Female_Dryad_Concede_01	No puedo ganar siempre.	
VO_HERO_16_Female_Dryad_ERROR_01	No tengo ningún arma.	
VO_HERO_16_Female_Dryad_ERROR_02	¡Necesito más maná!	
VO_HERO_16_Female_Dryad_ERROR_03	¡Ese esbirro no puede volver a atacar!	
VO_HERO_16_Female_Dryad_ERROR_04	Ya ataqué.	
VO_HERO_16_Female_Dryad_ERROR_05	Ese esbirro no puede atacar todavía.	
VO_HERO_16_Female_Dryad_ERROR_06	¡Mi mano está rebosante!	
VO_HERO_16_Female_Dryad_ERROR_07	¡Tengo demasiados esbirros!	
VO_HERO_16_Female_Dryad_ERROR_08	Ese esbirro cobarde está escondiéndose.	
VO_HERO_16_Female_Dryad_ERROR_09	No puedo hacer eso.	
VO_HERO_16_Female_Dryad_ERROR_10	Eso no es posible.	
VO_HERO_16_Female_Dryad_ERROR_11	¡Primero debo atacar al esbirro con Provocación!	
VO_HERO_16_Female_Dryad_ERROR_12	Eso no va a pasar.	
VO_HERO_16_Female_Dryad_FIRE_FESTIVAL_01	¡Me encanta el festival de fuego!	
VO_HERO_16_Female_Dryad_Greetings_01	¡Que la naturaleza te bendiga!	
VO_HERO_16_Female_Dryad_HAPPY_HALLOWEEN_01	¡Feliz Halloween!	
VO_HERO_16_Female_Dryad_HAPPY_HOLIDAYS_01	¡Feliz festín del Festival de Invierno!	
VO_HERO_16_Female_Dryad_HAPPY_NEW_YEAR_01	¡Celebremos el año nuevo!	
VO_HERO_16_Female_Dryad_HAPPY_NOBLEGARDEN_01	¡Feliz Jardín Noble!	
VO_HERO_16_Female_Dryad_LowCards_01	¡Me estoy quedando sin cartas!	
VO_HERO_16_Female_Dryad_MALFURION_START_01	Ishnu'alah, archidruida.	
VO_HERO_16_Female_Dryad_MIRROR_GREETINGS_01	¡Y a ti también!	
VO_HERO_16_Female_Dryad_MIRROR_START_01	¡Por las tierras salvajes!	
VO_HERO_16_Female_Dryad_NoCards_01	¡Ya no me quedan cartas!	
VO_HERO_16_Female_Dryad_Oops_02	Un error de cálculo salvaje.	
VO_HERO_16_Female_Dryad_PIRATE_DAY_01	¡Arr! ¡Soy una pirata!	
VO_HERO_16_Female_Dryad_Sorry_01	Tengo que disculparme por eso.	
VO_HERO_16_Female_Dryad_Start_01	El bosque contraataca.	
VO_HERO_16_Female_Dryad_Thanks_01	Agradezco tu esfuerzo.	
VO_HERO_16_Female_Dryad_Thinking_01	Veamos...	
VO_HERO_16_Female_Dryad_Thinking_02	¿Y si trato de...?	
VO_HERO_16_Female_Dryad_Thinking_03	¿Qué tal si...?	
VO_HERO_16_Female_Dryad_Threaten_01	¡Sufre como las tierras salvajes!	
VO_HERO_16_Female_Dryad_Time_01	El tiempo se acaba.	
VO_HERO_16_Female_Dryad_Well_Played_01	Buena jugada.	
VO_HERO_16_Female_Dryad_WOW_01	¡Eso fue salvaje!	
VO_HERO_18_Female_Gnome_Concede_01	¡Impresionante! Esta vez ganaste.	
VO_HERO_18_Female_Gnome_ERROR_01	¿No necesito un arma?	
VO_HERO_18_Female_Gnome_ERROR_03	No tengo suficiente maná.	
VO_HERO_18_Female_Gnome_ERROR_04	Ya atacó.	
VO_HERO_18_Female_Gnome_ERROR_06	No puedo atacar dos veces.	
VO_HERO_18_Female_Gnome_ERROR_07	¡Shhh! todavía sigue durmiendo.	
VO_HERO_18_Female_Gnome_ERROR_08	¡Uoo! ¡Demasiadas cartas!	
VO_HERO_18_Female_Gnome_ERROR_10	¡Solo se permiten siete esbirros!	
VO_HERO_18_Female_Gnome_ERROR_12	¡Se oculta con el Sigilo!	
VO_HERO_18_Female_Gnome_ERROR_14	Mmm. No puedo hacerlo.	
VO_HERO_18_Female_Gnome_ERROR_15	No puedo hacer objetivo en eso.	
VO_HERO_18_Female_Gnome_ERROR_17	Hay alguien con Provocación en el camino.	
VO_HERO_18_Female_Gnome_FIRE_FESTIVAL_01	¡Los fuegos artificiales del Solsticio de Verano son lo máximo!	
VO_HERO_18_Female_Gnome_Greetings_01	Holis, ¿cómo estás?	
VO_HERO_18_Female_Gnome_HAPPY_HALLOWEEN_01	¡¿Halloween?! Qué miedo....	
VO_HERO_18_Female_Gnome_HAPPY_HOLIDAYS_01	Feliz festín del Festival de Invierno.	
VO_HERO_18_Female_Gnome_HAPPY_NEW_YEAR_01	¡Feliz año nuevo!	
VO_HERO_18_Female_Gnome_HAPPY_NEW_YEAR_LUNAR_16	¡Feliz año nuevo!	
VO_HERO_18_Female_Gnome_LowCards_01	¡Me quedan pocas cartas!	
VO_HERO_18_Female_Gnome_MIRROR_START_01	¡Sí! ¡Esto será increíble!	
VO_HERO_18_Female_Gnome_NOBLEGARDEN	¡Me encanta Jardín Noble!	
VO_HERO_18_Female_Gnome_NoCards_01	¡No me quedan cartas!	
VO_HERO_18_Female_Gnome_Oops_02	¡Upsi!	
VO_HERO_18_Female_Gnome_PIRATE_DAY_01	Arr, ¡soy una pirata! ¡ARRR!	
VO_HERO_18_Female_Gnome_Sorry_01	Ooh, lo siento.	
VO_HERO_18_Female_Gnome_Start_01	¡Vamos a divertirnos!	
VO_HERO_18_Female_Gnome_Thanks_02	¡Ooh, gracias!	
VO_HERO_18_Female_Gnome_Thinking_01	Mmmmm...	
VO_HERO_18_Female_Gnome_Thinking_03	Mmm... taram taram dam...	
VO_HERO_18_Female_Gnome_Thinking_04	Me pregunto si...	
VO_HERO_18_Female_Gnome_Threaten_01	Serías una marioneta preciosa.	
VO_HERO_18_Female_Gnome_Time_01	¡Tengo que apurarme!	
VO_HERO_18_Female_Gnome_Well_Played_01	¡Guau, qué buena jugada!	
VO_HERO_18_Female_Gnome_WOW_01	¡Eso fue GENIAL!	
VO_ICC08_LichKing_Male_Human_YoungArthas_02	Odio tener que acabar conmigo mismo.	
VO_TBA01_4__Concede	*Rugido*	
VO_TBA01_4__Error_Full_Minions	*Rugido*	
VO_TBA01_4__Error_Generic	*Rugido*	
VO_TBA01_4__Error_Hand_Full	*Rugido*	
VO_TBA01_4__Error_I_Attacked	*Rugido*	
VO_TBA01_4__Error_Just_Played	*Rugido*	
VO_TBA01_4__Error_Minion_Attacked	*Rugido*	
VO_TBA01_4__Error_Need_Mana	*Rugido*	
VO_TBA01_4__Error_Need_Weapon	*Rugido*	
VO_TBA01_4__Error_Play	*Rugido*	
VO_TBA01_4__Error_Stealth	*Rugido*	
VO_TBA01_4__Good_Game	*Rugido*	
VO_TBA01_4__Greetings	¡Que comiencen los juegos!	
VO_TBA01_4__Low_Cards	*Rugido*	
VO_TBA01_4__No_Cards	*Rugido*	
VO_TBA01_4__Oops	Ups.	
VO_TBA01_4__Sorry	Lo siento.	
VO_TBA01_4__Start	¡Yo soy el amo aquí!	
VO_TBA01_4__Thanks	Gracias.	
VO_TBA01_4__Threaten	¡Contempla el verdadero poder de NEFARIAN!	
VO_TBA01_4__Timer	*Rugido*	
VO_TBA01_4__Well_Played	Buena jugada.	
