TAG	TEXT	COMMENT
FB_BUILDABRAWL_001	¡Por el poder de la competencia de invocadores!	
FB_BUILDABRAWL_002	¡Por la máscara de Ragnaros!	
FB_BUILDABRAWL_003	¡Por el poder de Yogg-Saron!	
FB_BUILDABRAWL_004	¡Por el poder de los esbirros!	
FB_BUILDABRAWL_005	Competencia de invocaleamónium	
FB_BUILDABRAWL_006	La mascaradeamónium	
FB_BUILDABRAWL_007	Prueba para sirviente de Yogg-Aleamónium	
FB_BUILDABRAWL_008	Esbirramónium	
FB_BUILDABRAWL_009	La batalla de la competencia de invocadores 	
FB_BUILDABRAWL_010	La batalla de la mascarada	
FB_BUILDABRAWL_011	La batalla de las pruebas de Yogg-Saron	
FB_BUILDABRAWL_012	La batalla furiosa de esbirros	
FB_BUILDABRAWL_013	La competencia de invocadores sangrienta	
FB_BUILDABRAWL_014	La mascarada sangrienta	
FB_BUILDABRAWL_015	La magia de Yogg-Saron	
FB_BUILDABRAWL_016	La sangre de los esbirros	
FB_BUILDABRAWL_INTRO	La Gresca actual es:	
FB_BUILDABRAWL_NOTSTARTED	La Gresca Fireside no se ha iniciado, ¡comunícate con tu tabernero para usar el Grescamático!	
FB_CHAMPS_FIREBAT_DRUID	Firebat comenzó la final con su druida... ¡y nunca perdió! ¡Es el campeón de 2014!	
FB_CHAMPS_FIREBAT_HUNTER	Firebat eligió a este Cazador para enfrentar al Brujo de DTwo, en revancha por haber perdido su mazo de Pícaro...	
FB_CHAMPS_FIREBAT_ROGUE	Firebat derrotó claramente al Sacerdote de DTwo en 2014, ¡y dio el golpe de gracia con un milagroso Subastador 12/4!	
FB_CHAMPS_FIREBAT_WARLOCK	El Brujo de Firebat fue vetado en la final por Tiddler Celestial. ¿Cómo le irá esta vez?	
FB_CHAMPS_OSTKAKA_MAGE	Ostkaka jugó este Mago de congelación contra el Mago tempo de Hotform, y lo quemó con bolas de fuego. ¡Qué ironía!	
FB_CHAMPS_OSTKAKA_ROGUE	En la última partida de las finales de 2015, Ostkaka derrotó al Druida de Hotform y se ganó un lugar en la Sala de los Campeones.	
FB_CHAMPS_OSTKAKA_WARRIOR	Los Parroquianos lúgubres ayudaron a Ostkaka a ganar... aun sin el Comandante Grito de guerra. ¡Eso sí que es saber jugar!	
FB_CHAMPS_PAVEL_DRUID	Pavel derrotó a DrHippi en un enfrentamiento de Druidas con este mazo. ¡Cuídate de los esbirros grandes!	
FB_CHAMPS_PAVEL_MAGE	El Mago de Pavel estuvo muy cerca de ganar varias veces en el Campeonato de 2016 con este mazo. ¿Y tú?	
FB_CHAMPS_PAVEL_ROGUE	Aunque el Pícaro de Pavel no sea ideal para enfrentar a mazos agresivos, ¡es una fuerza más que temible!	
FB_CHAMPS_PAVEL_SHAMAN	El Chamán de Pavel siempre fue vetado por sus adversarios. ¡Pero nadie lo veta aquí!	
FB_CHAMPS_PAVEL_WARRIOR	Pavel jugó este Guerrero C'thun dos veces en la final, y perdió contra el Guerrero de DrHippi pero ganó contra su Druida.	
FB_ELO_EVEN	¡Tú y tu adversario están muy parejos! ¡Los dos podrán elegir una bonificación mayor!	
FB_ELO_FAVORED	Eres el favorito para ganar. Tu adversario recibirá una bonificación mayor.	
FB_ELO_UNDERDOG	Eres el relegado del encuentro, ¡así que podrás elegir una bonificación mayor!	
FB_IKC_CHOSE_SETUP	Juega una carta nueva y se convertirá en la recomendación del tabernero.	
FB_IKC_ENDGAME	¡La nueva carta está elegida! Terminemos la partida.	
FB_IKC_NEWCARD	¿Conservas la carta vieja o usas la nueva?	
FB_IKC_SETUP	¡Tabernero! Una pregunta...	
FB_JUGGERNAUT_CHOOSE_OPPONENT	Elige a tu capitán rival...	
FB_JUGGERNAUT_DRUID	Druida	
FB_JUGGERNAUT_FIRSTLINE	¡Disparen!	
FB_JUGGERNAUT_HUNTER	Cazador	
FB_JUGGERNAUT_MAGE	Mago	
FB_JUGGERNAUT_PALADIN	Paladín	
FB_JUGGERNAUT_PRIEST	Sacerdote	
FB_JUGGERNAUT_ROGUE	Pícaro	
FB_JUGGERNAUT_SHAMAN	Chamán	
FB_JUGGERNAUT_UNKNOWN	Desconocido	
FB_JUGGERNAUT_WARLOCK	Brujo	
FB_JUGGERNAUT_WARRIOR	Guerrero	
FB_LK_BOSSSWITCH	¡Derrota al Teniente del Rey Exánime para obligarlo a regresar!	
FB_LK_DEAD_01	¡Felicidades, campeones!\n¡Han derrotado al Rey Exánime!	
FB_LK_DEAD_02	¡Comuníquense con su Tabernero Fireside para volver a desafiarlo!	
FB_LK_HERO_01	Rey Exánime supremo	
FB_LK_HERO_02	Reina de sangre Lana'thel	
FB_LK_HERO_03	Profesor Putricidio	
FB_LK_HERO_04	Lord Tuétano	
FB_LK_HERO_05	Sindragosa	
FB_LK_HEROSWITCH	¡Es el turno del jugador 2! ¡Sigue así!	
FB_LK_INTRO_01	¡La mejor manera de jugar esta Gresca es con dos\njugadores sentados uno junto al otro!	
FB_LK_INTRO_02	El jugador 1 empieza.\n¡Trabajen en equipo para derrotar\nal Rey Exánime!	
ICC_01_LICH_KING_SUBTEXT	Legendario	
ICC_01_TIRION_SUBTEXT	No tan Legendario	
ICC_01_TIRIONTURNS_01	Turnos hasta la llegada de Tirion: 1	
ICC_01_TIRIONTURNS_02	Turnos hasta la llegada de Tirion: 2	
ICC_01_TIRIONTURNS_03	Turnos hasta la llegada de Tirion: 3	
ICC_05_LANATHEL_01	¡<b>Debes</b> morder a un esbirro! ¡Incluso puede ser uno de tu enemigo!	
ICCDruidVictory_01	En una época, era un protector de la vida y cuidaba la naturaleza de Azeroth. Ahora, Malfurion el Pestilente cuida un jardín de muerte y se encarga de mantener el equilibrio de la naturaleza.	
ICCHunterVictory_01	Rexxar liberó las almas que habían sido presas del Rey Exánime. Sacó una flecha negra de su carcaj. "¡Vamos, Misha!", dijo. "La cacería comienza..."	
ICCMageVictory_01	La recientemente coronada Exánime gélida contempló sus dominios. Legiones de no-muertos acudieron y le otorgaron su poder. Ni siquiera se dio cuenta cuando su sangre se congeló.	
ICCPaladinVictory_01	El alguna vez noble Paladín aceptó su nuevo destino. Los que habían llevado una vida digna no tenían nada que temer. Pero al morir, los perversos se enfrentarían a su juicio... 	
ICCPriestVictory_01	El cuerpo del joven príncipe se convirtió en sombras. "Ahora entiendo", dijo mientras las llamas azules ardían en sus ojos. "He sido tan ingenuo..."	
ICCRogueVictory_01	Valeera la Impasible desapareció en la noche. Sus sombras y penumbras lo ven todo, y nadie está a salvo de su filo gélido...	
ICCShamanVictory_01	La mente del chamán se vio abrumada de voces, una cacofonía de los muertos. El Muertevidente cerró los ojos y pronunció una sola palabra: "Duerme..."	
ICCWarlockVictory_01	Finalmente, Gul'dan se sentó en el Trono Helado. El Portal Oscuro se abrió una vez más, y una infinidad de mundos temblaron ante él.	
ICCWarriorVictory_01	El otrora Jefe de guerra de la Horda aceptó su nuevo poder. Los cadáveres congelados de las víctimas de su ejército se alzarían para servir, hasta que él fuera el único amo de todo lo que su vista alcanzaba.	
LOEA16_2_STAFF_TEXT_CHARGE_0	<b>Poder de héroe pasivo</b>\nTu héroe es <b>Inmune</b>. Quedan tres turnos.	
LOEA16_2_STAFF_TEXT_CHARGE_1	<b>Poder de héroe pasivo</b>\nTu héroe es <b>Inmune</b>. Quedan dos turnos.	
LOEA16_2_STAFF_TEXT_CHARGE_2	<b>Poder de héroe pasivo</b>\nTu héroe es <b>Inmune</b>. ¡Solo queda un turno!	
LOEA16_2_STAFF_TEXT_CHARGE_EXPLODED	<b>Poder de héroe pasivo</b>\nHas invocado un jefe, pero perdiste la <b>Inmunidad</b>.	
MISSION_DEFAULTCOUNTERNAME	|4(turno,turnos) para escapar	
MISSION_GLOWING_POOL	Poza brillante	
MISSION_NEFARIAN_TITLE	Asesino de esbirros estúpidos, incompetentes y decepcionantes	
MISSION_PIT_OF_SPIKES	Trampa de púas	
MISSION_PRE_TUTORIAL_WANTED	Se busca	
MISSION_STATUES_EYE	El ojo de la estatua	
MISSION_TAKE_THE_SHORTCUT	¿Quieres tomar el atajo?	
TB_100TH_BANANA_INFO_OPP	El mazo de tu oponente está compuesto por cartas aleatorias. Cada vez que uno de sus esbirros muere, recibe una banana. 	
TB_100TH_BANANA_INFO_YOU	Tu mazo está compuesto por cartas aleatorias. Cada vez que uno de tus esbirros muere, recibes una banana. 	
TB_100TH_BANANA_OPP	Tu oponente está jugando la gresca ¡Gresca de bananas!, que debutó como la 2.ª gresca el 24 de junio de 2015.	
TB_100TH_BANANA_YOU	Estás jugando la gresca ¡Gresca de bananas!, que debutó como la 2.ª gresca el 24 de junio de 2015.	
TB_100TH_CLONEBALL_INFO_OPP	El mazo de tu oponente está compuesto por varias copias de algunas cartas legendarias aleatorias. 	
TB_100TH_CLONEBALL_INFO_YOU	Tu mazo está compuesto por varias copias de algunas cartas legendarias aleatorias. 	
TB_100TH_CLONEBALL_OPP	Tu oponente está jugando con la gresca ¡Clonabol!, que debutó como la 52.ª gresca el 8 de junio de 2016.	
TB_100TH_CLONEBALL_YOU	Estás jugando la gresca ¡Clonabol!, que debutó como la 52.ª gresca el 8 de junio de 2016.	
TB_100TH_PARTYPORTAL_INFO_OPP	El mazo de este jugador está compuesto por varias cartas de portales aleatorias. 	
TB_100TH_PARTYPORTAL_INFO_YOU	El mazo de este jugador está compuesto por varias cartas de portales aleatorias. 	
TB_100TH_PARTYPORTAL_OPP	Tu adversario está jugando la gresca ¡Portales festivos!, que debutó como la 64.ª gresca el 31 de agosto de 2016.	
TB_100TH_PARTYPORTAL_YOU	Estás jugando la gresca ¡Portales festivos!, que debutó como la 64.ª gresca el 31 de agosto de 2016.	
TB_100TH_PORTALS_INFO_OPP	El mazo de tu adversario está compuesto principalmente por Portales inestables y algunas otras cartas. 	
TB_100TH_PORTALS_INFO_YOU	Tu mazo está compuesto principalmente por Portales inestables y algunas otras cartas. 	
TB_100TH_PORTALS_OPP	Tu adversario está jugando la gresca ¡Portales a raudales!, que debutó como la 7.ª gresca el 29 de julio de 2015.	
TB_100TH_PORTALS_YOU	Estás jugando la gresca ¡Portales a raudales!, que debutó como la 7.ª gresca el 29 de julio de 2015.	
TB_100TH_RANDEMONIUM_INFO_OPP	El mazo de tu adversario está compuesto por cartas aleatorias que cambian de costo en cada turno. 	
TB_100TH_RANDEMONIUM_INFO_YOU	Tu mazo está compuesto por cartas aleatorias que cambian de costo en cada turno. 	
TB_100TH_RANDOMONIUM_OPP	Tu oponente está jugando la gresca Aleamónium, que debutó como la 18.ª gresca el 14 de octubre de 2015.	
TB_100TH_RANDOMONIUM_YOU	Estás jugando la gresca Aleamónium, que debutó como la 18.ª gresca el 14 de octubre de 2015.	
TB_100TH_RAVENIDOL_INFO_OPP	El mazo de tu adversario está compuesto por 30 Ídolos cuervo. 	
TB_100TH_RAVENIDOL_INFO_YOU	Tu mazo está compuesto por 30 Ídolos cuervo. 	
TB_100TH_RAVENIDOL_OPP	Tu adversario está jugando la gresca Ídolos de Azeroth, que debutó como la 45.ª gresca el 20 de abril de 2016.	
TB_100TH_RAVENIDOL_YOU	Estás jugando la gresca Ídolos de Azeroth, que debutó como la 45.ª gresca el 20 de abril de 2016.	
TB_100TH_SHIFTER_INFO_OPP	El mazo de tu adversario está compuesto principalmente por Transfiguradores Zerus y algunas otras cartas. 	
TB_100TH_SHIFTER_INFO_YOU	Tu mazo está compuesto principalmente por Transfiguradores Zerus y algunas otras cartas. 	
TB_100TH_SHIFTER_OPP	Tu adversario está jugando la gresca TransfiguCon, que debutó como la 55.ª gresca el 29 de junio de 2016.	
TB_100TH_SHIFTER_YOU	Estás jugando la gresca TransfiguCon, que debutó como la 55.ª gresca el 29 de junio de 2016.	
TB_100TH_SPELLBAG_INFO_OPP	El mazo de tu adversario está compuesto por 30 hechizos aleatorios que invocan un esbirro cuando los juegas. 	
TB_100TH_SPELLBAG_INFO_YOU	Tu mazo está compuesto por 30 hechizos aleatorios que invocan un esbirro cuando los juegas. 	
TB_100TH_SPELLBAG_OPP	Tu adversario está jugando la gresca Bolsa de hechizos robados de Valeera, que debutó como la 76.ª gresca el 23 de noviembre de 2016.	
TB_100TH_SPELLBAG_YOU	Estás jugando la gresca Bolsa de hechizos robados de Valeera, que debutó como la 76.ª gresca el 23 de noviembre de 2016.	
TB_100TH_YOGG_INFO_OPP	El mazo de tu adversario está compuesto por esbirros aleatorios que lanzan un hechizo aleatorio cuando los juegas. 	
TB_100TH_YOGG_INFO_YOU	Tu mazo está compuesto por esbirros aleatorios que lanzan un hechizo aleatorio cuando los juegas. 	
TB_100TH_YOGG_OPP	Tu adversario está jugando la gresca Prueba para sirviente de Yogg-Saron, que debutó como la 57.ª gresca el 13 de julio de 2016.	
TB_100TH_YOGG_YOU	Estás jugando la gresca Prueba para sirviente de Yogg-Saron, que debutó como la 57.ª gresca el 13 de julio de 2016.	
TB_DECKBUILDING_FIRSTCARDPLAYED	Después de jugar una carta, coloca una copia en tu mazo.	
TB_DECKBUILDING_FIRSTENDTURN	Ahora devuelve tu mano al mazo y vuelve a robar tus cartas.	
TB_DECKBUILDING_FIRSTPICKTHREE	Elige una carta nueva para tu mano.	
TB_DECKBUILDING_STARTOFGAME	Crea tu equipo mientras juegas. ¡Buena suerte!	
TB_DECKBUILDING_STARTOFGAME_START	¡Comienza!	
TB_DECKRECIPE_MSG_DRUID	Fórmula para mazo: <b>Los gólems del Loto</b>.	
TB_DECKRECIPE_MSG_HUNTER	Fórmula para mazo: <b>Banda bestial</b>.	
TB_DECKRECIPE_MSG_MAGE	Fórmula para mazo: <b>Mixología Kabal</b>.	
TB_DECKRECIPE_MSG_PALADIN	Fórmula para mazo: <b>El mercado negro</b>.	
TB_DECKRECIPE_MSG_PRIEST	Fórmula para mazo: <b>Corazón de dragón</b>.	
TB_DECKRECIPE_MSG_ROGUE	Fórmula para mazo: <b>Muelles de Gadgetzan</b>.	
TB_DECKRECIPE_MSG_SHAMAN	Fórmula para mazo: <b>Asociación múrloc</b>.	
TB_DECKRECIPE_MSG_WARLOCK	Fórmula para mazo: <b>Demonios de los Kabal</b>.	
TB_DECKRECIPE_MSG_WARRIOR	Fórmula para mazo: <b>El imperio de los Matones</b>.	
TB_DECKRECIPE_OG_DRUID	Aprovecha los hechizos de Druida que generan maná para invocar a los sirvientes de los dioses antiguos con mucha anticipación.  	
TB_DECKRECIPE_OG_HUNTER	No temas, héroe; tus esbirros te servirán en la vida y en la muerte. Sacrifícalos para eliminar a los de tu enemigo y tarde o temprano la ventaja será tuya.	
TB_DECKRECIPE_OG_MAGE	Lanza tantos hechizos como puedas. ¡Todos sirven para alimentar el despertar de Yogg-Saron!	
TB_DECKRECIPE_OG_PALADIN	¡Protege a tus esbirros con Escudo divino para que puedan enfrentarse a dos enemigos a la vez!	
TB_DECKRECIPE_OG_PRIEST	¡Sana a tus esbirros y mantenlos con vida lo suficiente para que presencien el surgimiento del horroroso C'Thun!	
TB_DECKRECIPE_OG_ROGUE	¡Intercambia esbirros sin contemplaciones! La mayoría te da una ventaja cuando muere, así que puedes sacrificar sin culpa.	
TB_DECKRECIPE_OG_SHAMAN	¡Invoca la mayor cantidad posible de esbirros antes de evolucionarlos! Evoluciona esbirros que ya hayan visto la acción en el campo de batalla para aprovechar su valor al máximo.	
TB_DECKRECIPE_OG_WARLOCK	Fortalece a tus ejércitos con los incontables esbirros de los dioses antiguos. Inunda el tablero con esbirros más pequeños para arrollar a tu adversario.	
TB_DECKRECIPE_OG_WARRIOR	Defiéndete y demuestra tu devoción infinita por C'Thun. ¡Reúne suficiente Armadura para que los esfuerzos de tu adversario sean inútiles contra los dioses antiguos!	
TB_DPROMO_2NDHERO	El Rey Vaca	
TB_DPROMO_2NDHEROPOPUP	¡Has llegado al nivel secreto!	
TB_DPROMO_COWKINGEMOTES	Muu	
TB_FIREFEST_FIRST	¡Mini Ragnaros obtiene ataque cuando incinera esbirros!	
TB_FIREFEST_SECOND	¡Bien hecho! ¡Incinera todos los que puedes para recibir una recompenza especial!	
TB_GIFTEXCHANGE_GIFTSPAWNED	Si no hay ninguna caja de tu lado, se te entregará una.	
TB_GIFTEXCHANGE_GIFTSTOLEN	¡Tienes un regalo! ¿Qué podrá ser?	
TB_GIFTEXCHANGE_START	¡Feliz Festival de Invierno! ¡Esos regalos son para ti!	
TB_HEADLESS_HORSEMAN_POISON	No puedes envenenar a este no-muerto, ¡es demasiado poderoso!	
TB_HEADLESSREDUX_01	¡Eres el Jinete decapitado, protege tu cementerio!	
TB_HEADLESSREDUX_02	¡Destruye a los aventureros disfrazados Hazel, Johnny y Flynn para ganar!	
TB_HEADLESSREDUX_03	¡Te has adentrado en el cementerio del Jinete decapitado! 	
TB_HEADLESSREDUX_04	¡Protege a los aventureros disfrazados Hazel, Johnny y Flynn o perderás!	
TB_KOBOLDGIFTS_01	"¡Miren, en el cielo! ¡Es el Gran Padre Kóbold!"	
TB_KOBOLDGIFTS_02	"¡El Gran Padre Kóbold regresará en el próximo turno! ¡Háganle lugar!"	
TB_LETHAL_NAME	Este turno está que arde	
TB_LETHALPUZZLES_FAILURE	 ¡Prueba otra vez!	
TB_LETHALPUZZLES_START	Tendrás que derrotar a tu rival en cada ronda... ¡Buena suerte!	
TB_LETHALPUZZLES_SUCCESS	¡Lo lograste!	
TB_MARIN_QUEST	¡El primero en completar la misión tendrá una ventaja para conseguir el tesoro!	
TB_MP_BOSS	Ventormenta decorada	
TB_MP_BOSS2	Ciudad festiva	
TB_MP_BOSS3	Capital de la fiesta	
TB_MP_COOP_1STSPELL	Oh, oh... Parece que los Kabal metieron mano en el ponche...	
TB_MP_COOP_2NDSPELL	¡No enciendan fuegos artificiales adentro!	
TB_MP_COOP_CRASHER_DISCARD	El Colado se aburre de estar en la mano del jugador y se marcha.	
TB_MP_COOP_ENDING	¡Lo lograron! Gracias por celebrar el año del mamut con nosotros.	
TB_MP_COOP_FIRST_CRASHER	¡Cuidado! Esos tipos están intentando colarse en la fiesta. ¡Desháganse de ellos!	
TB_MP_COOP_PINATA	¡Lo lograron! Llegó la hora la Piñata. Pero los Colados se nos están yendo de las manos...	
TB_MP_COOP_TEXT_START	Usa tu Poder de héroe para decorar la taberna junto al otro jugador. 	
TB_MP_CROSSROADS	Ey, ¿y ese quién es?	
TB_MP_CROSSROADS_CRASHER	¿Qué está haciendo aquí?	
TB_MP_STORMWIND_SUCCESS	¡Lo lograste! ¿Cuánto más podrás aguantar?	
TB_PICKYOURFATE_BUILDAROUND_FIRSTFATE	¡Los destinos elegidos afectan a ambos jugadores!	
TB_PICKYOURFATE_BUILDAROUND_NEWFATE	Recuerda, esta bonificación es solo para ti.	
TB_PICKYOURFATE_BUILDAROUND_OPPONENT_FIRSTFATE	¡El destino de tu adversario también te afecta a ti!	
TB_PICKYOURFATE_BUILDAROUND_OPPONENTFATE	Recuerda, esta bonificación es solo para tu adversario.	
TB_PICKYOURFATE_RANDOM_FIRSTFATE	¡Los destinos elegidos afectan a ambos jugadores!	
TB_PICKYOURFATE_RANDOM_NEWFATE	¡Necesitas un nuevo destino!	
TB_PICKYOURFATE_RANDOM_OPPONENTFATE	¡Tu adversario necesita un nuevo destino!	
TB_SHADOWTOWERS_ADJACENTMINIONS	Los esbirros que están junto a una torre quedan en <b>Sigilo</b> y no pueden atacar.	
TB_SHADOWTOWERS_SHADOWSPAWNED	Si uno de los lados no tiene una torre, se invoca una.	
TB_SHADOWTOWERS_SHADOWSPAWNEDNEXT	Las torres faltantes se reemplazan cuando comienza el turno de su dueño.	
