TAG	TEXT	COMMENT
ChromaggusBoss_Death_1	¡Rrraaaaaarrr!	
ChromaggusBoss_EmoteResponse_1	*Rugido*	
ChromaggusBoss_Start_1	¡Rrrraaarr!	
GiantRat_LOOTA_BOSS_18h_DefeatPlayer	<Chillido>	
GiantRat_LOOTA_BOSS_18h_EmoteResponse	<Chillido>	
GILA_BOSS_65h_Gobbles_DefeatPlayer	¡Reeeaaaooo!	
GILA_BOSS_65h_Gobbles_EmoteResponse	¡Baahaauuaaoowr!	
GILA_BOSS_65h_Gobbles_Intro	¡Uwaauuoooo!	
LOE_07_MINE_CART_EMOTES	Clonk	
LOOTA_BOSS_21h_GnoshTheGreatWorm_EmoteResponse	<Rugido>	
LOOTA_BOSS_47h_Lava_FilledRoom_Emote	<Furia>	
LOOTA_BOSS_52h_TreasureVault_Emote	<Cling>	
OnyxiaBoss_Death_1	¡Rrraaaaaarrr!	
OnyxiaBoss_EmoteResponse_1	*Rugido*	
OnyxiaBoss_Start_1	¡Rrrraaarr!	
POPUP_FROST_BRAWL	¡Fatiga! Quien tenga más salud al final del próximo turno ganará la partida.	
POPUP_FROST_BRAWL_ARMOR	¡No habrá armadura que te proteja en esta gresca!	
TheMothergloop_LOOTA_BOSS_24h_EmoteResponse	<Eructo>	
TrappedRoom_LOOTA_BOSS_48h_EmoteResponse	<Clanc>	
VO_Ahune_Male_Elemental_Brawl_01	¡SÍ! ¡APLASTA A RAGNAROS!	
VO_Ahune_Male_Elemental_Brawl_02	¡¿QUIÉN TIENE EL PODER AHORA, IDIOTA EN LLAMAS?! 	
VO_Ahune_Male_Elemental_Brawl_03	¡SABOREA MI VENGANZA!	
VO_Ahune_Male_Elemental_Brawl_04	¡¿QUIÉN ES EL GANADOR EN LA CATEGORÍA "MÁS ASESINADO POR AVENTUREROS DE AZEROTH" AHORA?!	
VO_Ahune_Male_Elemental_Brawl_05	¡¿QUIÉN ES EL INSECTO AHORA?!	
VO_Ahune_Male_Elemental_Brawl_07	¡LA PIEDRA DE HIELO SE HA DERRETIDO!	
VO_Ahune_Male_Elemental_Brawl_08	¡¿QUIÉN SERÁ EL QUE ASESINE MÁS INEPTOS?!	
VO_Ahune_Male_Elemental_Brawl_11	¡EXCELENTE PUNTAJE!	
VO_Ahune_Male_Elemental_Brawl_15	¡REDUCE A RAGNAROS A CENIZAS!	
VO_Ahune_Male_Elemental_Brawl_16	¡GUAU! ¡TÚ SÍ QUE ODIAS A RAGNAROS!	
VO_Aran_Male_Shade_AranCrackle_01	Pff. En mi época, Chisporroteo siempre infligía seis de daño.	
VO_Aran_Male_Shade_AranDeath_02	Otra vez no...	
VO_Aran_Male_Shade_AranEmoteResponse_01	¡Fuera! ¡Fuera!	
VO_Aran_Male_Shade_AranHeroPower_01	¡Ardan, vándalos!	
VO_Aran_Male_Shade_AranMedivhSkin_01	¿Medivh? No, no... ¡No estaba molestando a los invitados!	
VO_Aran_Male_Shade_AranOpen_01	¡A ver si aprendes modales!	
VO_Aran_Male_Shade_AranSpell_03	¡Regresa a la fría oscuridad!	
VO_Aran_Male_Shade_AranSpell_04	El maestro es poderoso, ¡pero yo también tengo mis trucos bajo la manga!	
VO_Aran_Male_Shade_AranTrons_02	¡NO! ¡NO! ¡Odio el ruido! ¡Todos esos "holas"!	
VO_Aran_Male_Shade_AranTurn1_01	¡Nada de música fuerte en mi torre!	
VO_Aran_Male_Shade_AranTurn5_01	¡No soy un simple bufón! ¡Soy Nielas Aran!	
VO_Barnes_Male_Human_FinalNazraTurn5_02	¡Socorro! ¡Nos quedamos sin bananas! ¡Mukla está destruyendo toda la despensa!	
VO_Barnes_Male_Human_JulianneTurn5_01	¿Qué es una fiesta sin una obra? ¿Y qué es una obra sin público?	
VO_Barnes_Male_Human_JulianneWin_01	¡Ha finalizado un acto! ¡Restan dos!	
VO_Barnes_Male_Human_Wing2Intro_02	¡Bienvenido al teatro! Soy Barnes, el director de escena. Los portales para salvar a Medivh están en el piso de arriba, pero primero, ¡tenemos un espectáculo que no te puedes perder!	
VO_Barnes_Male_Human_WolfBigMinion_01	¡Oh, abuelita, pero qué esbirros tan grandes tienes!	
VO_Barnes_Male_Human_WolfClaws_01	¡No te preocupes! ¡Esas garras enormes son de utilería!	
VO_Barnes_Male_Human_WolfTurn5_01	¡Me encanta involucrar al público! ¡Corre, invitado, corre!	
VO_Barnes_Male_Human_WolfTurn9_01	¡Jaja! ¡Qué gran espectáculo! ¡Mejor que ese ogro que perseguimos la semana pasada!	
VO_Barnes_Male_Human_WolfWin_01	¡Ajá! ¡El gran final espera!	
VO_BigBadWolf_Male_Worgen_WolfBigMinion_01	¡Para aplastarte mejor!	
VO_BigBadWolf_Male_Worgen_WolfDeath_01	¿Cazado? No...	
VO_BigBadWolf_Male_Worgen_WolfDireWolfAlpha_01	*Gruñido*	
VO_BigBadWolf_Male_Worgen_WolfDireWolfAlpha_02	*Quejido*	
VO_BigBadWolf_Male_Worgen_WolfEmoteResponse_01	Mmmm...\nDelicioso...	
VO_BigBadWolf_Male_Worgen_WolfOpen_01	¡Huye, pequeña! ¡Corre!	
VO_BigBadWolf_Male_Worgen_WolfScarletCrusader_01	Oh, capita roja, ¿a dónde vas?	
VO_BigBadWolf_Male_Worgen_WolfTurn1_01	Mira a tus esbirros. ¿Ves cómo se acobardan ante mi presencia?	
VO_BlackKing_Male_ChessPiece_ChessEmoteGreetings_01	Siempre.	
VO_BlackKing_Male_ChessPiece_ChessEmoteOops_01	¿O será una trampa?	
VO_BlackKing_Male_ChessPiece_ChessEmoteSorry_01	Fue un sacrificio necesario.	
VO_BlackKing_Male_ChessPiece_ChessEmoteThanks	Cuando quieras.	
VO_BlackKing_Male_ChessPiece_ChessEmoteThanks_01	Cuando quieras.	
VO_BlackKing_Male_ChessPiece_ChessEmoteThreaten_01	Veo una gran jugada en 3 movimientos.	
VO_BlackKing_Male_ChessPiece_ChessEmoteWellPlayed_01	Todavía no.	
VO_BlackKing_Male_ChessPiece_ChessEmoteWow_01	Naturalmente.	
VO_BlackKing_Male_ChessPiece_ChessOpen_01	¡Nadie pasará!	
VO_BOSS_AYA_Female_Pandaren_BC_0_Jade_Golem_02	¿Más gólems? ¡Súper!	
VO_BOSS_AYA_Female_Pandaren_BC_0_Jade_Golem_03	¡Jeje! ¡Adelante, mi ejército!	
VO_BOSS_AYA_Female_Pandaren_BC_0_Jade_Golem_04	¡Otro! ¡OTRO!	
VO_BOSS_AYA_Female_Pandaren_BC_2_1st_Turn_Start_01	Sí, claro... ¡Quiero Gadgetzan para MÍ!	
VO_BOSS_AYA_Female_Pandaren_BC_2_2nd_Turn_Start_01	¡Gadgetzan le pertenece al Loto de jade, y el Loto me pertenece a mí!	
VO_BOSS_AYA_Female_Pandaren_BC_2_Arms_Dealing1_01	Más armas. ¡Qué original!	
VO_BOSS_AYA_Female_Pandaren_BC_2_Fill1_01	Ooooh, ¡esto te va a encantar!	
VO_BOSS_AYA_Female_Pandaren_BC_2_Fill2_01	Nahhh, me gusta este lugar. Creo que me quedaré.	
VO_BOSS_AYA_Female_Pandaren_BC_2_Goons_Win_01	¡Nonononono! ¡Esto APEEESTA!	
VO_BOSS_AYA_Female_Pandaren_BC_2_Goons_Winning_02	¡Tal vez deberías CALLARTE!	
VO_BOSS_AYA_Female_Pandaren_BC_2_Jade_Win_01	¡El Loto de jade vuelve a ganar! ¡Soy la mejor!	
VO_BOSS_AYA_Female_Pandaren_BC_2_Lotus_Winning_01	*je je* ¡Sigue jugando, sigue jugando!	
VO_BOSS_AYA_Female_Pandaren_BC_3_1st_Turn_Start_01	¡Gadgetzan es LO MÁXIMO! ¡La quiero toda para mí!	
VO_BOSS_AYA_Female_Pandaren_BC_3_1st_Turn_Start_02	Jejeje, con gusto....	
VO_BOSS_AYA_Female_Pandaren_BC_3_2nd_Turn_Start_01	Ay, ustedes los Kabal son taaaan aburridos....	
VO_BOSS_AYA_Female_Pandaren_BC_3_Fill1_01	Qué día tan bonito, ¿no crees, Kazzy?	
VO_BOSS_AYA_Female_Pandaren_BC_3_Fill2_01	Ay, por favor, Kazzy, relájate un poco. Diviértete.	
VO_BOSS_AYA_Female_Pandaren_BC_3_Jade_Golem3_01	¡Jejejeje!	
VO_BOSS_AYA_Female_Pandaren_BC_3_Kabal_Winning_01	Pero solo porque eres tan aburrido.	
VO_BOSS_AYA_Female_Pandaren_BC_3_Kabal_Wins_01	¡Esto no puede estar pasando! NO NO NO NO Y NO!	
VO_BOSS_AYA_Female_Pandaren_BC_3_Lotus_Winning_01	Oh, ¿qué pasa, Kazzy? No te ves nada bien.	
VO_BOSS_AYA_Female_Pandaren_BC_3_Lotus_Wins_01	Bueno, eso fue divertido. Gracias por jugar, Kazzy	
VO_BOSS_AYA_Female_Pandaren_BC_3_Potion1_02	Bla bla pociones bla bla... ¡VEN AQUÍ A PELEAR!	
VO_BOSS_AYA_Female_Pandaren_BC_3_Potion3_01	¡Puaj! Esto es asqueroso.	
VO_BOSS_AYA_Female_Pandaren_Concede_01	Oh, eso no fue divertido.	
VO_BOSS_AYA_Female_Pandaren_Greetings_01	¡Holis!	
VO_BOSS_AYA_Female_Pandaren_Oops_01	¡Upsi!	
VO_BOSS_AYA_Female_Pandaren_START_01	¡Preparen a los gólems!	
VO_BOSS_AYA_Female_Pandaren_Thanks_02	¡Gracias!	
VO_BOSS_AYA_Female_Pandaren_Threaten_02	Mm, supongo que ahora vas a tener que morir.	
VO_BOSS_AYA_Female_Pandaren_Well_Played_01	¡Eso fue genial!	
VO_BOSS_AYA_Female_Pandaren_Wow_02	¡Guau!	
VO_BOSS_CHO_Male_Ogre_BC_1_1st_Turn_Start_01	¡LOS MATONES MALOSOS LAS HACEN PELIGROSAS!	
VO_BOSS_CHO_Male_Ogre_BC_1_Fill2_01	¡A ELLOS, MUCHACHOS!	
VO_BOSS_CHO_Male_Ogre_BC_2_Fill1_01	¡ESA CHICA TIENE MIRADA LOCA!	
VO_BOSS_CHO_Male_Ogre_Concede_01	¡SÍ! ¡EY! NO, ES TUYA.	
VO_BOSS_CHO_Male_Ogre_Oops_02	¡ERROR COMETIDO!	
VO_BOSS_CHO_Male_Ogre_Thanks_01	GRACIAS.	
VO_BOSS_HAN_Male_Ogre_BC_0_Arms_Dealing_01	Ey, mira lo que encontré en la calle, je je…	
VO_BOSS_HAN_Male_Ogre_BC_0_Arms_Dealing_02	¡Reúnan a los Matones!	
VO_BOSS_HAN_Male_Ogre_BC_0_Arms_Dealing_03	¡Pónganle un traje a ese matón y sáquenlo de aquí!	
VO_BOSS_HAN_Male_Ogre_BC_0_Arms_Dealing_04	Los Matones malosos se reúnen.	
VO_BOSS_HAN_Male_Ogre_BC_1_1st_Turn_Start_01	Estas son calles peligrosas, Kazakus.	
VO_BOSS_HAN_Male_Ogre_BC_1_2nd_Turn_Start_01	¡Gadgetzan le pertenece a los Matones!	
VO_BOSS_HAN_Male_Ogre_BC_1_2nd_Turn_Start_02	Sí, todo muy bonito. Pero Gadgetzan le pertenece a los Matones.	
VO_BOSS_HAN_Male_Ogre_BC_1_Fill1_01	¡Empaca tus pociones y lárgate!	
VO_BOSS_HAN_Male_Ogre_BC_1_Fill2_01	Ey, Cho, reúne a los Matones. Este trol necesita una lección.	test
VO_BOSS_HAN_Male_Ogre_BC_1_Goons_Win_01	Lo siento, Kazakus. Negocios son negocios.	
VO_BOSS_HAN_Male_Ogre_BC_1_Goons_Winning_01	Oh, parece que tuviste un accidente, Kazakus...	
VO_BOSS_HAN_Male_Ogre_BC_1_Kabal_Win_02	Esto... no ha... terminado... Kazakus.	
VO_BOSS_HAN_Male_Ogre_BC_1_Kabal_Winning_02	Je. Nada mal, anciano.	
VO_BOSS_HAN_Male_Ogre_BC_1_Potion1_01	¿Sabes? Nunca me gustaron las pociones.	
VO_BOSS_HAN_Male_Ogre_BC_1_Potion2_01	¡Oye! ¡Cuidado con dónde tiras eso!	
VO_BOSS_HAN_Male_Ogre_BC_2_1st_Turn_Start_01	Gadgetzan nos pertenece. ¡Lárgate, niñita!	
VO_BOSS_HAN_Male_Ogre_BC_2_1st_Turn_Start_04	¿Sí? Pues los Matones malosos tenemos una opinión al respecto.	
VO_BOSS_HAN_Male_Ogre_BC_2_Fill1_01	No me gusta esa mirada, Aya...	
VO_BOSS_HAN_Male_Ogre_BC_2_Goons_Win_01	Tómate un descanso, Aya. Jeje. Te hará bien.	
VO_BOSS_HAN_Male_Ogre_BC_2_Goons_Winning_01	Tal vez te convendría reconsiderar tu postura.	
VO_BOSS_HAN_Male_Ogre_BC_2_Jade_Golem2_01	Ya me estoy cansando de estos muchachitos de jade.	
VO_BOSS_HAN_Male_Ogre_BC_2_Lotus_Win_01	*Gah* Gadgetzan será nuestra....	
VO_BOSS_HAN_Male_Ogre_BC_2_Lotus_Winning_01	¡Que alguien saque a esta niñita de aquí!	
VO_BOSS_HAN_Male_Ogre_Concede_01	¿Sabes que todo esto es tu culpa?	
VO_BOSS_HAN_Male_Ogre_Greetings_01	Ey, bienvenido a Gadgetzan.	
VO_BOSS_HAN_Male_Ogre_INTRO_PACK_OPEN_7	Jojooo... ¿Quién es ese muchachote tan apuesto?	
VO_BOSS_HAN_Male_Ogre_Oops_01	Eso no está bien.	
VO_BOSS_HAN_Male_Ogre_START_01	¡Ahora estás en nuestro territorio!	
VO_BOSS_HAN_Male_Ogre_Thanks_01	Nos has prestado un gran servicio.	test
VO_BOSS_HAN_Male_Ogre_Threaten_01	No deberías negarte.	
VO_BOSS_HAN_Male_Ogre_Well_Played_02	Debo decir que estoy impresionado.	
VO_BOSS_HAN_Male_Ogre_WOW_01	Nada mal.	
VO_BOSS_KAZAKUS_Male_Troll_BC_0_Potion_01	Ahhh, qué refrescante....	
VO_BOSS_KAZAKUS_Male_Troll_BC_0_Potion_02	¡Toma esto!	
VO_BOSS_KAZAKUS_Male_Troll_BC_0_Potion_04	Bebe hasta la última gota....	
VO_BOSS_KAZAKUS_Male_Troll_BC_0_Potion_05	¿A qué sabe?	
VO_BOSS_KAZAKUS_Male_Troll_BC_1_1st_Turn_Start_01	¡Gadgetzan será mía, Han'Cho!	
VO_BOSS_KAZAKUS_Male_Troll_BC_1_2nd_Turn_Start_01	¡Los Kabal están por todos lados! ¡Gadgetzan nos obedece!	
VO_BOSS_KAZAKUS_Male_Troll_BC_1_Arms_Dealing1_01	Mmm, típica cobardía de los Matones. ¡YA DEJEN DE OCULTARSE EN LA MANO! 	
VO_BOSS_KAZAKUS_Male_Troll_BC_1_Fill1_01	¡Mis Kabal controlan un poder ilimitado!	
VO_BOSS_KAZAKUS_Male_Troll_BC_1_Goons_Win_01	¡Volveré... más poderoso que nunca!	
VO_BOSS_KAZAKUS_Male_Troll_BC_1_Goons_Winning_01	Sufrirás, Han'Cho....	
VO_BOSS_KAZAKUS_Male_Troll_BC_1_Kabal_Win_01	Oh. Claro que sí.	
VO_BOSS_KAZAKUS_Male_Troll_BC_1_Kabal_Winning_01	Tu destino se acerca, Han'Cho.	
VO_BOSS_KAZAKUS_Male_Troll_BC_3_1st_Turn_Start_01	Jejeje. Tendrás que eliminarme para quedártela....	
VO_BOSS_KAZAKUS_Male_Troll_BC_3_Fill1_01	¡NO ME LLAMES ASÍ, NIÑA ARROGANTE!	
VO_BOSS_KAZAKUS_Male_Troll_BC_3_Fill2_01	¡Arrodíllate ante el poder de los Kabal!	
VO_BOSS_KAZAKUS_Male_Troll_BC_3_Jade_Golem2_01	¡Niña insolente! ¿Cómo te atreves a burlarte del líder más poderoso de Gadgetzan?	
VO_BOSS_KAZAKUS_Male_Troll_BC_3_Jade_Golem3_01	¡Niña insolente! ¡Ya estoy harto de este jueguito con los gólems!	
VO_BOSS_KAZAKUS_Male_Troll_BC_3_Kabal_Winning_01	Jeje, te ves un poco cansada, niña.	
VO_BOSS_KAZAKUS_Male_Troll_BC_3_Kabal_Winning_02	¡¿Qué?! ¡Niña insolente! ¡Seré tu PERDICIÓN!	test
VO_BOSS_KAZAKUS_Male_Troll_BC_3_Kabal_Wins_01	¡Jaja! ¡Otro enemigo cae ante el poder de los Kabal!	
VO_BOSS_KAZAKUS_Male_Troll_BC_3_Lotus_Winning_01	¡Mocosa presumida!	
VO_BOSS_KAZAKUS_Male_Troll_BC_3_Lotus_Wins_01	Niña tonta. Esto no ha terminadooo....	
VO_BOSS_KAZAKUS_Male_Troll_BC_3_Potion1_01	Siente la furia de las pociones de los Kabal.	
VO_BOSS_KAZAKUS_Male_Troll_Concede_01	Estas calles... son... mías...	
VO_BOSS_KAZAKUS_Male_Troll_Greetings_02	¡Hola, tontos!	test
VO_BOSS_KAZAKUS_Male_Troll_Mirror_Start_01	Parece que tienes algún talento.	
VO_BOSS_KAZAKUS_Male_Troll_Oops_01	Un error de cálculo.	
VO_BOSS_KAZAKUS_Male_Troll_START_01	El maná llama.	
VO_BOSS_KAZAKUS_Male_Troll_Thanks_01	Te lo agradezco mucho, peón.	
VO_BOSS_KAZAKUS_Male_Troll_Threaten_01	¡YO CONTROLO GADGETZAN!	
VO_BOSS_KAZAKUS_Male_Troll_Well_Played_02	Tienes mucho potencial...	
VO_BOSS_KAZAKUS_Male_Troll_Wow_01	¡Cuánto poder!	
VO_BRANN_MITHRIL_ALT_02	Fascinante. Estas runas de mitril contienen códigos de protección. ¡Deben ser de la época de los titanes!	
VO_BRANN_WIN_07_ALT_07	¡Excelente! ¡La cabeza del báculo está en el siguiente cuarto!	
VO_BRM_027h_Death_63	¡No! ¡NO! ¡NOOOOOOOOOOOO!	
VO_BRMA01_1_CARD_05	Uoo, vamos. Démosles una cálida bienvenida.	
VO_BRMA01_1_DEATH_09	¡Uoo! Jaja ¿Uh? ¿Qué...eh? ¡Oh! No me gusta nada, ¡pero igual está sucediendo!	
VO_BRMA01_1_ETC_06	¡Es hora de un poco de entretenimiento EN VIVO! ¡Denle la bienvenida a Elite Tauren Chieftain!	
VO_BRMA01_1_HERO_POWER_04	¡Jajajaja! ¡Todos al montón!	
VO_BRMA01_1_RESPONSE_03	¡Jajajaja! Oh, *hic* Perdón.	
VO_BRMA01_1_START_01	Bienvenido al Tragapenas.	
VO_BRMA01_1_SUCCUBUS_08	Nagmara. Creo que nuestro "colega" necesita un "trago".	
VO_BRMA01_1_TURN1_02	¡Oigan! Jaja. Miren todos. Tenemos una "visita".	
VO_BRMA01_1_WARGOLEM_07	¡Ojojo! Ahora sí que estás en problemas. ¡Falange! ¡Qué no se escape!	
VO_BRMA02_1_ALAKIR_34	A este Señor elemental le encanta aplastar insectos... ¡Al'Akir!	
VO_BRMA02_1_ALEXSTRAZA_32	Protectora, Reina dragón, luchadora de la Arena Hierro Negro... ¡Aaaalexstraza!	
VO_BRMA02_1_BEAST_22	Su comida favorita son los gnomos, pero hoy hará una excepción. Es... ¡La Bestia!	
VO_BRMA02_1_BOOM_28	Espero que los de la primera fila hayan traído gafas protectoras, porque el próximo oponente es, ¡el Dr. Bum!	
VO_BRMA02_1_CAIRNE_20	Él está criando a su hijo para que siga sus huellas. ¡Quiero oírlos gritar por CAIRNE PEZUÑA DE SANGRE!	
VO_BRMA02_1_CHO_07	Es hora del cuento de las buenas noches con el Pandaren más tierno: ¡el Eremita Cho!	
VO_BRMA02_1_DEATH_38	¡Hjt! ¿Eh? ¡Uoo! *Estertor de muerte*	
VO_BRMA02_1_DEATHWING_35	¡OOOOOoh! ¡Damas y enanos! El único, el inigualable... ¡ALAMUERTE!	
VO_BRMA02_1_ETC_18	Y ahora, el tauren, el mito, la leyenda... ¡Elite Tauren Chieftain!	
VO_BRMA02_1_FEUGEN_15	¡Fuerte ese aplauso! Eeees... ¡Feugen!	
VO_BRMA02_1_FOEREAPER_29	Está mecánicamente calibrado para la destrucción máxima. ¡Es el Siegaenemigos 4000!	
VO_BRMA02_1_GEDDON_13	Ooh, ¡la Arena está caliente! Denle la bienvenida al Barón Geddon.	
VO_BRMA02_1_GELBIN_21	Directamente desde Nueva Ciudad Manitas, démosle la bienvenida al líder de los gnomos: ¡Gelbin Mekkatorque!	
VO_BRMA02_1_GRUUL_31	¡No es por nada que lo llaman Asesino de Dragones! ¡Reciban con un gran aplauso a GRUUL!	
VO_BRMA02_1_HERO_POWER_05	¡El público está impaciente! ¡Jaja!	
VO_BRMA02_1_HOGGER_27	Y ahora recibamos al Gnoll nivel 11 que llegó a convertirse en una leyenda viviente: ¡Hogger!	
VO_BRMA02_1_ILLIDAN_23	¿Quién necesita ojos cuando tiene gujas de guerra dobles? Él seguro que no. ¡Es Illidan Tempestira!	
VO_BRMA02_1_LEVIATHAN_12	Recién renovado y listo para destrozar. Eeees... ¡el Leviatán de llamas!	
VO_BRMA02_1_LOATHEB_16	Tápense la nariz, cúbranse la boca y alienten a la mayor masa en descomposición: ¡Loatheb!	
VO_BRMA02_1_MAEXXNA_24	¡Es la araña gigante! ¿Cómo se pronunciaba su nombre? ¡Maexxna!	
VO_BRMA02_1_MILLHOUSE_09	¡Ay, por favor! ¿Quién dejó entrar a ese en la Arena?	
VO_BRMA02_1_MOGOR_25	Su vocabulario es limitado. Su ira: infinita. ¡Es Mogor el ogro!	
VO_BRMA02_1_MUKLA_10	Y a continuación, el barón de las bananas: con ustedes, ¡el Rey Mukla!	
VO_BRMA02_1_NOZDORMU_36	Damas y... ups. ¡Se acabó el tiempo!	
VO_BRMA02_1_ONYXIA_33	Directamente desde el Marjal Revolcafango y el castillo de Ventormenta. ¡Prepárense para Onyxia!	
VO_BRMA02_1_PAGLE_08	Y ahora, recién llegado de su viaje de pesca: ¡el maestro pescador Nat Pagle!	
VO_BRMA02_1_RESPONSE_04	¡Nadie se enfrenta a todas estas leyendas y vive para contarlo!	
VO_BRMA02_1_SNEED_30	Nuestro próximo contendiente se esconde tras los controles de una vieja trituradora. ¿Quién podrá ser?	
VO_BRMA02_1_STALAGG_14	¿Podrá Stalagg sobrevivir en la Arena? ¡Llegó la hora de averiguarlo!	
VO_BRMA02_1_START_01	¡Un nuevo rival!	
VO_BRMA02_1_SYLVANAS_19	Ella arde en odio infernal solo por ustedes. Denle la bienvenida a... ¡Sylvanas Brisaveloz!	
VO_BRMA02_1_THALNOS_06	Recibamos con un gran aplauso al esqueleto del vestido: ¡el Mago sangrientooo... Thalnos!	
VO_BRMA02_1_THAURISSAN_37	Todos al son de "Viva el rey". Es... ¡el emperador Thaurissan!	
VO_BRMA02_1_TINKMASTER_11	Un fuerte aplauso para el único, el inigualable, el gran inventor Maestro manitas Sobrechispa.	
VO_BRMA02_1_TOSHLEY_26	Es el gnomo errante que en su casa está faltante. ¡Denle una cálida bienvenida a Toshley!	
VO_BRMA02_1_TURN1_02	¡Damas y enanos! ¡Hoy tenemos un espectáculo muy especial para ustedes!	
VO_BRMA02_1_TURN1_PT2_03	¡Las más grandes leyendas de Azeroth contra un aventurero solitario!	
VO_BRMA02_1_VOLJIN_17	¡Silencio, por favor! Tenemos un invitado muy especial, ¡el mismísimo Jefe de Guerra Vol'jin!	
VO_BRMA03_1_CARD_04	¡Por el poder de Ragnaros! ¡Yo tengo el poder!	
VO_BRMA03_1_DEATH_09	¡Aaaaaaaaaah!	
VO_BRMA03_1_HERO_POWER_06	¡Muere!	
VO_BRMA03_1_MOIRA_DEATH_05	¡NO! ¡¡¡MOIRA!!! ¡¡¡ME LAS PAGARÁS!!!	
VO_BRMA03_1_RESPONSE_03	¡Cierra la boca antes de que te la cierre yo!	
VO_BRMA03_1_START_01	¡Los enanos Hierro Negro nunca caerán!	
VO_BRMA03_1_TURN1_02	¡Ey! ¡Deja a mi esposa!	
VO_BRMA03_1_VS_RAG_07	¡No! ¿Ragnaros? ¡NO DE NUEVO!	
VO_BRMA04_1_CARD_04	Jurafuegos, ¡a rodar!	
VO_BRMA04_1_DEATH_06	¡Rrrrrrrrrrrr!	
VO_BRMA04_1_HERO_POWER_05	¡Magma!	
VO_BRMA04_1_RESPONSE_03	La piedra mata a todo.	
VO_BRMA04_1_START_01	Hay una piedra en tu camino.	
VO_BRMA04_1_TURN1_02	A rodar.	
VO_BRMA05_1_CARD_05	Tic tac, mortal.	
VO_BRMA05_1_DEATH_04	Una última ofrenda...	
VO_BRMA05_1_HERO_POWER_06	¡Arde!	
VO_BRMA05_1_RESPONSE_03	¡Armagedón!	
VO_BRMA05_1_START_01	¡ARDERÁS!	
VO_BRMA05_1_TURN1_02	¡Ragnaros te consumirá!	
VO_BRMA06_1_DEATH_04	¡Me rindo! ¡Me rindo!	
VO_BRMA06_1_RESPONSE_03	¿Crees que has ganado? Quizá sea hora de otra lección... ¡de DOLOR!	
VO_BRMA06_1_START_01	¡Nadie puede vencer a la llama viva!	
VO_BRMA06_1_SUMMON_RAG_05	¡Contempla a Ragnaros! ¡Quien ya era antiguo cuando el mundo era joven!	
VO_BRMA06_1_TURN1_02_ALT	¡Que no escapen!	
VO_BRMA06_3_INTRO_01	¡DEMASIADO PRONTO! ¡ME HAS DESPERTADO DEMASIADO PRONTO, EXECUTUS!	
VO_BRMA06_3_RESPONSE_03	¡¿QUÉ SIGNIFICA ESTA INTRUSIÓN?!	
VO_BRMA06_3_TURN1_02	¡INSECTOS MORTALES! ¿SE ATREVEN A ENTRAR EN MIS DOMINIOS?	
VO_BRMA07_1_CARD_04	¡Hora de aplastar!	
VO_BRMA07_1_DEATH_06	¡Rrrnoooooo!	
VO_BRMA07_1_HERO_POWER_05	¡Yo aplastar! ¡Tú morir!	
VO_BRMA07_1_RESPONSE_03	¡Raaar! ¡Yo machacar!	
VO_BRMA07_1_START_01	Te machacaré.	
VO_BRMA07_1_TURN1_02	¿Machacar o aplastar? ¡QUÉ DECISIÓN DIFÍCIL!	
VO_BRMA08_1_CARD_05	¡Protegeré la Cumbre!	
VO_BRMA08_1_DEATH_06	Rrr. ¡Aaaaaaaaaah!	
VO_BRMA08_1_RESPONSE_04	¿¿¿POR QUÉ??? Dime por qué. Por favor, si me agradabas.	
VO_BRMA08_1_START_01	¿Qué haces tú aquí?	
VO_BRMA08_1_TURN1_03	¡Lord Nefarious! ¡Creí que este mortal se había encargado de Ragnaros por nosotros!	
VO_BRMA08_1_TURN1_ALT_02	¿Has venido a ayudarme a destruir a los mortales de este mundo?	
VO_BRMA09_1_CARD_05	¡La Cumbre es NUESTRA!	
VO_BRMA09_1_DEATH_11	¡Gaaahhhhh!	
VO_BRMA09_1_HERO_POWER1_06	¡Abran las puertas!	
VO_BRMA09_1_HERO_POWER2_07	¡Maten al de la retaguardia!	
VO_BRMA09_1_HERO_POWER3_08	¡Concéntrense en el héroe, tontos!	
VO_BRMA09_1_HERO_POWER4_09	¡Juntos somos IMPARABLES!	
VO_BRMA09_1_RESPONSE_04	Ja, ja, ja, ja.	
VO_BRMA09_1_START_01	¡Somos la VERDADERA Horda!	
VO_BRMA09_1_TURN1_03	¡Estás escalando la montaña equivocada!	
VO_BRMA09_1_TURN1_ALT_02	¡Nadie se interpondrá en nuestro camino! ¡MUERE!	
VO_BRMA10_1_DEATH_08	¡Rrrrrrrrrrr!	
VO_BRMA10_1_EGG_DEATH_1_05	¡Idiotas! ¡Estos huevos son más valiosos de lo que creen!	
VO_BRMA10_1_EGG_DEATH_2_06	¡No, otro no! ¡Rodarán sus cabezas por esta infamia!	
VO_BRMA10_1_EGG_DEATH_3_07	¡Pagarás por esto!	
VO_BRMA10_1_HERO_POWER_04	¡Aléjate de esos huevos!	
VO_BRMA10_1_RESPONSE_03	¡Te haré tortilla!	
VO_BRMA10_1_START_01	Contemplen... ¡los huevos corrompidos de nuestros nuevos vuelos!	
VO_BRMA10_1_TURN1_02	¡Estos huevos serán su perdición!	
VO_BRMA11_1_ALEXSTRAZA_07	¡AYÚDAME, PROTECTORA! ¡AYUDA!	
VO_BRMA11_1_CARD_04	¡LA FURIA DE ROCA NEGRA FLUYE POR MIS VENAS!	
VO_BRMA11_1_DEATH_ALT_08	Al fin. La agonía termina.	
VO_BRMA11_1_HERO_POWER_05	¡AAAAH! ¡DESTRUCCIÓN!	
VO_BRMA11_1_KILL_PLAYER_06	Discúlpame…he fallado.	
VO_BRMA11_1_RESPONSE_03	¡Debiste huir cuando tenías la oportunidad, mortal!	
VO_BRMA11_1_START_01	¡Huye! Antes de que pierda el control...	
VO_BRMA11_1_TURN1_02	Es demasiado tarde… ¡La corrupción de Nefarian se ha apoderado de mí!	
VO_BRMA13_1_DEATH_ALT_23	¡No! ¡NO! ¡Regresarééé!	
VO_BRMA13_1_DEATHWING_19	¿P-Papi?	
VO_BRMA13_1_HP_DRUID_14	Yo soy el amo de lo Salvaje, druida.	
VO_BRMA13_1_HP_GENERIC_18	¡Tu magia es mía!	
VO_BRMA13_1_HP_HUNTER_12	¡El cazador se convierte en presa!	
VO_BRMA13_1_HP_MAGE_11	Deberías tener más cuidado cuando juegas con magia, maga.	
VO_BRMA13_1_HP_PALADIN_07	¿La Luz te ha abandonado, paladín?	
VO_BRMA13_1_HP_PRIEST_08	Ahora la Luz me sirve a mí, sacerdote.	
VO_BRMA13_1_HP_ROGUE_15	¡Pícara! ¡Deja de esconderte y atrévete a enfrentarme!	
VO_BRMA13_1_HP_SHAMAN_13	Ahora los elementos me obedecen a MÍ, chamán.	
VO_BRMA13_1_HP_WARLOCK_10	¡Estás jugando con magia que no comprendes, brujo!	
VO_BRMA13_1_HP_WARRIOR_09	¡Tu fuerza es tu debilidad, guerrero!	
VO_BRMA13_1_RESPONSE_05	¡Yo soy el amo aquí!	
VO_BRMA13_1_START_01	Bienvenido a mi sagrario personal, héroe.	
VO_BRMA13_1_TURN1_PT1_02	¡Contempla el verdadero poder de NEFARIAN!	
VO_BRMA13_1_TURN1_PT2_03	¡Maná infinito! ¡Armadura de dragontina!	
VO_BRMA14_1_CARD_09	Redirigiendo exceso de energía.	
VO_BRMA14_1_DEATH_08	Sistemas defensivos eliminados. Apagando.	
VO_BRMA14_1_HP1_03	Unidad Electrón activada.	
VO_BRMA14_1_HP2_04	Unidad Toxitrón activada.	
VO_BRMA14_1_HP3_05	Unidad Arcanotrón activada.	
VO_BRMA14_1_HP4_06	Unidad Magmatrón activada.	
VO_BRMA14_1_HP5_07	Unidad defensiva en línea.	
VO_BRMA14_1_RESPONSE1_10	Bip. Bup. Bip.	
VO_BRMA14_1_RESPONSE2_11	Conexión en curso.	
VO_BRMA14_1_RESPONSE3_12	Conexión exitosa. Descargando actualizaciones de sistema operativo.	
VO_BRMA14_1_RESPONSE4_13	Actualización instalada. ¡Hola! ¡Hola! ¡Hola!	
VO_BRMA14_1_RESPONSE5_14	¡Hola! ¡Hola! ¡Hola!	
VO_BRMA14_1_START_01	Intrusos detectados.	
VO_BRMA14_1_TURN1_02	Iniciar matriz de defensa primaria.	
VO_BRMA15_1_CARD_05	¡Mis fallas serán tu fin!	
VO_BRMA15_1_DEATH_04	¡Aaaaaaaahhhhh!	
VO_BRMA15_1_HERO_POWER_06	Mezclar, batir... ¡Aplicar calor!	
VO_BRMA15_1_RESPONSE_03	¡Nada se desperdicia!	
VO_BRMA15_1_START_01	¡No habrá interrupciones!	
VO_BRMA15_1_TURN1_02	¡No haré esperar a mi amo! ¡No puedo fallar de nuevo!	
VO_BRMA16_1_CARD_04	¡No puedes esconderte!	
VO_BRMA16_1_DEATH_06	¡Rrrraaaaaaaa!	
VO_BRMA16_1_GONG1_10	¡AAH! ¡ESE SONIDO!	
VO_BRMA16_1_GONG2_11	¡NOO! ¡TAN CERCA!	
VO_BRMA16_1_GONG3_12	¡MIS OÍDOS!	
VO_BRMA16_1_HERO_POWER_05	¡Tus torpes pasos y tu peste te delatan!	
VO_BRMA16_1_RESPONSE_03	Sí, sigue hablando. Estoy acercándome.	
VO_BRMA16_1_START_01	Oigo como late tu corazón	
VO_BRMA16_1_TRIGGER1_07	Ah. ¡Te oigo!	
VO_BRMA16_1_TRIGGER2_08	Oigo pasos.	
VO_BRMA16_1_TRIGGER3_09	Oigo tus latidos... ¡No podrás escapar!	
VO_BRMA16_1_TURN1_02	La muerte aguarda en la oscuridad.	
VO_BRMA17_1_CARD_86	Espero que sepan nadar... ¡EN LAVA ARDIENTE!	
VO_BRMA17_1_DEATH_97	¡Aaaaaaaaaaah!	
VO_BRMA17_1_DEATH_HEROIC_98	¡NOOOOOOOOOO!	
VO_BRMA17_1_DEATHWING_88	¿PAPI?	
VO_BRMA17_1_HERO_POWER_87	¡Mi llama de las sombras reanima sus huesos!	
VO_BRMA17_1_NEF_AIR1_89	¡Mírame lanzar fuego desde las alturas! Uno de daño es solo el comienzo.	
VO_BRMA17_1_NEF_AIR2_90	¡Dos bolas de fuego! ¡Te las lanzo desde arriba!	
VO_BRMA17_1_NEF_AIR3_91	Esta vez solo te lanzaré una bola de fuego, ¡porque estoy preparándome para un turno glorioso!	
VO_BRMA17_1_NEF_AIR4_92	¡Jo Jo! ¡Tres bolas de fuego! ¡Toma! ¡Desde las alturas!	
VO_BRMA17_1_NEF_AIR5_93	¡Desde ahora solo lanzaré una bola de fuego!	
VO_BRMA17_1_NEF_AIR6_94	¡Caíste! ¡CUATRO bolas de fuego! ¡Ajajaja!	
VO_BRMA17_1_NEF_AIR7_95	Esta vez no dispararé ninguna bola de fuego... Pero prepárate.	
VO_BRMA17_1_NEF_AIR8_96	¡VEINTE BOLAS DE FUEGO! ¡AJAJAJAJAA!	
VO_BRMA17_1_RESPONSE_85	Mentes mortales... tan manipulables.	
VO_BRMA17_1_RESURRECT1_82	¡La destrucción llegará desde las alturas!	
VO_BRMA17_1_RESURRECT2_83	Ya que estoy aquí arriba, tengo una sorpresa para ti allá abajo.	
VO_BRMA17_1_RESURRECT3_84	¡Observa a mi mejor creación! ¡Levántate, hermana! ¡Levántate, Onyxia!	
VO_BRMA17_1_START_78	¡Has llegado al grandioso final!	
VO_BRMA17_1_TRANSFORM1_80	He tratado de ser un buen anfitrión, ¡pero tú NO TE QUIERES MORIR!	
VO_BRMA17_1_TRANSFORM2_81	Es hora de abandonar todas las cortesías ¡y concentrarme en MATARTE!	
VO_BRMA17_1_TURN1_79	Mi mejor creación te espera, mortal.	
VO_COOP02_00	¡Los ayudaré a librarse de la Maldición de la carne!	
VO_COOP02_02	¡Derroten al Maestro de palancas Mecazod juntos para ganar!	
VO_COOP02_ABILITY_05	¡Aumentar revoluciones!	
VO_COOP02_ABILITY_06	¡La imprenta ha muerto, Eremita Cho!	
VO_COOP03_01	¡Yo soy el amo aquí!	
VO_COOP03_02	No... ¡NO! ¡Te destruiré!	
VO_COOP03_03	Mentes mortales... tan manipulables.	
VO_COOP03_04	He tratado de ser un buen anfitrión, ¡pero tú NO TE QUIERES MORIR!	
VO_COOP03_05	Es hora de abandonar todas las cortesías, ¡y concentrarme en MATARTE!	
VO_COOP03_06	¡Ahora la Luz me sirve a MÍ, sacerdote!	
VO_COOP03_07	¡Ahora los elementos me obedecen a MÍ, chamán!	
VO_COOP03_08	Jajajaaa... ¡Contempla el verdadero poder de Nefarian!	
VO_COOP03_09	Jajaja... ¡Has llegado al grandioso final!	
VO_Crone_Female_Troll_CroneDeath_02	¡No! Me vengaré, ¡me vengaré!	
VO_Crone_Female_Troll_CroneEmoteResponse_02	¡Ah jajajajaja!	
VO_Crone_Female_Troll_CroneFlyingMonkeys_01	¡Tráiganme a esa chica!	
VO_Crone_Female_Troll_CroneHeroPower_02	¡Jejejejeje!	
VO_Crone_Female_Troll_CroneOpen_01	¡Ja jajajaja! ¡Vuelen, mis preciosuras!	
VO_Curator_Male_ArcaneGolem_CuratorArcaneGolem_01	Qué curioso. El parecido es fascinante.	
VO_Curator_Male_ArcaneGolem_CuratorBeasts_01	Este Curator es alérgico a las bestias.	
VO_Curator_Male_ArcaneGolem_CuratorDemons_01	No hay lugar para los demonios en la Sala de las Fieras.	
VO_Curator_Male_ArcaneGolem_CuratorDragons_01	Estoy cansado de los excrementos de dragón.	
VO_Curator_Male_ArcaneGolem_CuratorEmoteResponse_01	No se puede procesar su petición.	
VO_Curator_Male_ArcaneGolem_CuratorHarrison_02	¡Intruso detectado! Harrison Jones no es bienvenido.	
VO_Curator_Male_ArcaneGolem_CuratorMechs_01	Reprogramando a los asistentes.	
VO_Curator_Male_ArcaneGolem_CuratorMedivhSkin_01	Medivh impostor. Esa mirada loca lo delata.	
VO_Curator_Male_ArcaneGolem_CuratorMurlocs_01	¡Libérate, pezcaducho!	
VO_Curator_Male_ArcaneGolem_CuratorPirates_01	Los piratas deberían festejarrrr.	
VO_Curator_Male_ArcaneGolem_CuratorReno_02	¡Intruso detectado! Reno Jackson no es bienvenido.	
VO_Curator_Male_ArcaneGolem_CuratorTurn1_01	Este Curator está equipado para cuidar la Sala de las Fieras.	
VO_Curator_Male_ArcaneGolem_CuratorTurn5_01	Por favor obedezca las reglas de la galería.	
VO_Curator_Male_ArcaneGolem_CuratorTurn9_01	Los invitados deben permanecer dentro de la Sala de las Fieras.	
VO_Curator_Male_ArcaneGolem_IllhoofKilrekResponse_01	A este Curator no le importa. Las invocaciones están prohibidas.	
VO_Curator_Male_ArcaneGolem_IllhoofSenseDemons_01	Muchos demonios detectados.	
VO_Curator_Male_ArcaneGolem_IllhoofTurn1_01	Los rituales de invocación no están permitidos.	
VO_Curator_Male_ArcaneGolem_IllhoofTurn5_01	Los rituales son perjudiciales para los habitantes. El demonio no debe continuar.	
VO_Curator_Male_ArcaneGolem_IllhoofWin_01	Este Curator agradece. La Sala de las Fieras se restaurará.	
VO_Curator_Male_ArcaneGolem_NightbaneCorruption_01	¡No! ¡La Sala de las Fieras no debe corromperse!	
VO_Curator_Male_ArcaneGolem_NightbaneTour_01	El dragón Nocturno. Se lo conocía como Arcanagos hasta que la magia salvaje se apoderó de su mente.	
VO_Curator_Male_ArcaneGolem_NightbaneTour_02	A su izquierda, un busto de Aran. A su derecha, el Farol de poder.	
VO_Curator_Male_ArcaneGolem_NightbaneTurn1_01	Las criaturas que escaparon podrían lastimarse. Deben regresar a la Sala de las Fieras.	
VO_Curator_Male_ArcaneGolem_NightbaneTurn3_01	Hay que salvar a las criaturas. Luego podrá continuar.	
VO_Curator_Male_ArcaneGolem_NightbaneUnstablePortal_01	Los invitados deben ser amables. Este dragón le teme a la magia inestable.	
VO_Curator_Male_ArcaneGolem_NightbaneWin_01	Se necesita más asistencia.	
VO_Curator_Neither_ArcaneGolem_CuratorDeath_04	Apagando	
VO_Curator_Neither_ArcaneGolem_CuratorOpen_01	No toque la exposición.	
VO_ELISE_LOE16_ALT_1_FIRST_HALF_02	Mientras el báculo se carga, Rafaam es invulnerable.	
VO_ELISE_LOE16_ALT_1_SECOND_HALF_03	Cuando termina la invocación, tenemos un instante para contraatacar, ¡pero después debemos lidiar con la criatura invocada!	
VO_ELISE_WEIRD_DECK_05	Te pido mil disculpas por el mazo. Lo armamos el año pasado para un torneo y nunca tuvimos tiempo de cambiarlo.	
VO_EMOTE_HERO_TBKTRAF_KT_DRAWING_BOARD	*suspiro* A dibujar otra vez.	
VO_EMOTE_HERO_TBKTRAF_KT_GLOAT	Ruega por piedad.	
VO_EMOTE_HERO_TBKTRAF_KT_MINIONS_SERVANTS	Lacayos, servidores, soldados de la fría oscuridad...	
VO_FP1_014t_EnterPlay_01	¡Ahora tú dueles!	
VO_FP1_031_Attack_07	Corderos al matadero...	
VO_FP1_031_EnterPlay_06	¡La Plaga te consumirá!	
VO_GIL_504_Female_Orc_TUT_LootSelect2_01	¿Quién se atreve a segar las vidas de mis monstruosos hijos? 	
VO_GIL_504_Female_Orc_TUT_Victory_Generic_01	Una victoria vacía. Soy una con este bosque, y no me detendrás fácilmente.	
VO_GIL_504_Female_Orc_TUT_Victory1_01	El Bosque Embrujado no se rendirá tan fácilmente. ¿Los demás correrán la misma suerte que tú?	
VO_GIL_504_Female_Orc_TUT_Victory2_01	Dos héroes han dominado el Bosque Embrujado, pero aún no me encontraste a MÍ.	
VO_GIL_504_Female_Orc_TUT_Victory3_01	Tu camino te acerca a mí. ¿Tu último campeón podrá triunfar también?	
VO_GIL_504_Female_Orc_TUT_Victory4_01	Esto termina esta noche. ¡Encuéntrame, y contempla el horror en el corazón de este bosque!	
VO_GIL_504_Female_Orc_UI_Monster_Azlina_02	Oh, pobre Azalina extraviada. Encontrará una manera de escapar. De una u otra forma.	
VO_GIL_504_Female_Orc_UI_Monster_Baran_01	Baran era un alma tan gentil... Lamentablemente, necesitaba sus ojos.	
VO_GIL_504_Female_Orc_UI_Monster_Brushwood_Cent_01	Aunque antes era un poderoso druida, su furia fue fácil de manipular.	
VO_GIL_504_Female_Orc_UI_Monster_Chupacabran_01	El Chupacabran. ¡Oh! No sabes cuánto me costó subyugarlo. 	
VO_GIL_504_Female_Orc_UI_Monster_Cragtorr_01	Enfrenta la furia de esta tierra atormentada. ¡Levántate, Cragtorr!	
VO_GIL_504_Female_Orc_UI_Monster_Crowskin_01	Glinda, acaba con él. Tienes todo el culto a tu disposición.	
VO_GIL_504_Female_Orc_UI_Monster_DrSezavo_01	No son más que una enfermedad. Sezavo tiene la cura. 	
VO_GIL_504_Female_Orc_UI_Monster_Experiment3C_01	Mmm… Ese no es de los míos.	
VO_GIL_504_Female_Orc_UI_Monster_Face_Collector_01	Tú serías una maravillosa incorporación a su colección.	
VO_GIL_504_Female_Orc_UI_Monster_Gnarlroot_01	¡Espíritus ancestrales, escuchen mi llamado! Con hojas y raíces los llenaremos de cicatrices. 	
VO_GIL_504_Female_Orc_UI_Monster_Griselda_01	Griselda pagó por traicionarme.	
VO_GIL_504_Female_Orc_UI_Monster_Groddo_01	Mi querido Guardián de la ciénaga... Cuando me dieron por muerta, él estuvo a mi lado.	
VO_GIL_504_Female_Orc_UI_Monster_Grubb_01	Ni siquiera yo puedo controlar a Grubb. 	
VO_GIL_504_Female_Orc_UI_Monster_Grum_01	Tierra ancestral, suelo fatal, ¡asciende y azota con fuerza el hogar!	
VO_GIL_504_Female_Orc_UI_Monster_Gustave_01	Gustave, mi mascota, ¡guarda un poco para tu ama!	
VO_GIL_504_Female_Orc_UI_Monster_Hannigul_01	Hannigul libró la ciudad de las alimañas... como tú.	
VO_GIL_504_Female_Orc_UI_Monster_Havnixx_01	Hav'nixx escucha tus pensamientos. Se alimenta con tu miedo.	
VO_GIL_504_Female_Orc_UI_Monster_Infinite_Toki_01	Gnoma entrometida. Esto se termina aquí. Supongo que ya se conocen.	
VO_GIL_504_Female_Orc_UI_Monster_Ivan_01	Iván era uno de ustedes. Pero ahora me pertenece.	
VO_GIL_504_Female_Orc_UI_Monster_Lord_Godfrey_01	¡Godfrey! Teníamos un trato.\nTú te encargarías de este. 	
VO_GIL_504_Female_Orc_UI_Monster_Lovers_01	Es una historia de amor. De fantasmas. Es la historia de tu fin.	
VO_GIL_504_Female_Orc_UI_Monster_Mistwraith_01	En la quieta noche, en el oscuro bosque, los susurros susurran respuestas. 	
VO_GIL_504_Female_Orc_UI_Monster_Mute_01	Silenciosa. Mortal. 	
VO_GIL_504_Female_Orc_UI_Monster_Niira_01	Ya basta de juegos, Niira. ¡Termina con esto!	
VO_GIL_504_Female_Orc_UI_Monster_Raeth_01	No todos los Renegados abandonaron estos bosques. Algunos me sirven a mí.	
VO_GIL_504_Female_Orc_UI_Monster_Rancel_01	Los venenos de Rancel ayudaron a dar forma a este bosque corrompido.	
VO_GIL_504_Female_Orc_UI_Monster_Sazzmi_01	Quédate aquí y escucha. Para siempre.	
VO_GIL_504_Female_Orc_UI_Monster_Sephira_01	Con alas y garras, mis hermanas arpías mantienen la paz en mi bosque.	
VO_GIL_504_Female_Orc_UI_Monster_Shivers_01	¡De pie, Escalofríos! Esta es tu oportunidad de venganza. Te ofrezco a la princesa gilneana.	
VO_GIL_504_Female_Orc_UI_Monster_Shudderwock_01	¡El Shudderwocky! Una criatura terrible en libertad... Un deleite para la vista. 	
VO_GIL_504_Female_Orc_UI_Monster_Splintergraft_01	¡Aullido del bosque, temor y temblor, mi rival muera presa de un silvano pavor!	
VO_GIL_504_Female_Orc_UI_Monster_Sthara_01	El pueblo gilneano me amará... S'thara los convencerá.	
VO_GIL_504_Female_Orc_UI_Monster_Vitus_01	¡Uno de los suyos, apartado! Pero en mis bosques encuentra un hogar...	
VO_GIL_504_Female_Orc_UI_Monster_Wharrgarbl_01	Adoro los múrlocs. Son como ranas, pero... menos coordinados.	
VO_GIL_598_Female_Human_SpecialSylvanas_01	¡Bruja despreciable! ¡Mataste a mi hermano!	
VO_GIL_692_Male_Worgen_TUT_AdventureSelect_01	¡Héroes! ¿Quién de ustedes tiene el valor suficiente para aventurarse dentro del Bosque Embrujado?	
VO_GIL_692_Male_Worgen_TUT_BossReveal1_01	Monstruos terribles acechan los bosques que rodean Gilneas.\nDebes cazarlos, uno por uno.	
VO_GIL_692_Male_Worgen_TUT_BossReveal2_01	Cuanto más explores los rincones del bosque, más peligrosas serán las criaturas.	
VO_GIL_692_Male_Worgen_TUT_BossReveal3_01	Hagatha es el poder oscuro detrás del Bosque Embrujado. ¡Debes encontrarla y detenerla!	
VO_GIL_692_Male_Worgen_TUT_BossReveal3ALT_01	Estos monstruos son obra de Hagatha. ¡Derrótalos para llegar hasta ella!	
VO_GIL_692_Male_Worgen_TUT_CharacterSelect_01	He reunido un equipo de élite. Cada uno aporta habilidades únicas a la batalla. 	
VO_GIL_692_Male_Worgen_TUT_Defeat1_01	Si te derrotan en el Bosque Embrujado, perderás el mazo que armaste.	
VO_GIL_692_Male_Worgen_TUT_FightBegin1Crowley_01	¡Crowley! Dirige tu cañón para aprovechar su poder de fuego. 	
VO_GIL_692_Male_Worgen_TUT_FightBegin1Shaw_01	Empieza la cacería, Shaw. Usa tus perros para sorprender a los enemigos.	
VO_GIL_692_Male_Worgen_TUT_FightBegin1Tess_01	A partir de aquí estás sola. Busca hechizos útiles en el campo de batalla.	
VO_GIL_692_Male_Worgen_TUT_FightBegin1Tess_02	Eres mi única descendencia, Tess. Ten cuidado.	
VO_GIL_692_Male_Worgen_TUT_FightBegin1Toki_01	Toki, tu manipulación del tiempo te vuelve más afortunada que los demás. 	
VO_GIL_692_Male_Worgen_TUT_FightBegin2_01	Estas... cosas... no son naturales. ¡Algo está poniendo estos bosques en nuestra contra!	
VO_GIL_692_Male_Worgen_TUT_LootSelect1_01	Arma tu mazo para llegar lo más lejos posible en el Bosque Embrujado.	
VO_GIL_692_Male_Worgen_TUT_LootSelect2_02	¡Tú! ¿Eres la criatura detrás de estas... cosas?	
VO_GIL_692_Male_Worgen_TUT_TreasureSelect1_01	Mata monstruos para obtener botines poderosos. ¡Elige tus recompensas con sabiduría!	
VO_GIL_692_Male_Worgen_TUT_Victory_Final_01	¡Se acabó! Los bosques empiezan a calmarse y la luz regresa a nuestra ciudad.	
VO_GILA_400h_Male_Human_EVENT_HAGATHA_ALMOSTDEAD_02	No sin antes dar pelea. 	
VO_GILA_400h_Male_Human_EVENT_HAGATHA_INTRO_01	¡Mis perros la encontraron! ¡Hagatha está aquí!	
VO_GILA_400h_Male_Human_EVENT_HAGATHA_LOWHEALTH_01	Está herida. Sigan el rastro, chicos. 	
VO_GILA_400h_Male_Human_EVENT_HAGATHA_TURN4_01	Y yo tengo a mis perros. 	
VO_GILA_400h_Male_Human_EVENT_IVAN_INTRO_01	¡Eras uno de nosotros, Iván!	
VO_GILA_400h_Male_Human_EVENT_NEMESIS_INTRO_01	¡Por fin te encontré, Piel de Cuervo!	
VO_GILA_400h_Male_Human_EVENT_NEMESIS_TURN2_01	¿Por qué? ¿Por qué le juraste lealtad a Hagatha?	
VO_GILA_500h3_Female_Human_EVENT_HAGATHA_SUB_IN_01	¡Cúbranse! Yo le pondré fin a esto. 	
VO_GILA_500h3_Female_Human_EVENT_HAGATHA_TURN2_01	Gilneas ha sufrido el paso del tiempo peor que tú, Hagatha. 	
VO_GILA_500h3_Female_Human_EVENT_HAGATHA_TURN4_01	¡Abandona este lugar, bruja!	
VO_GILA_500h3_Female_Human_EVENT_HAGATHA_WOUNDED_01	Si abandonas estos bosques, te dejaré vivir.	
VO_GILA_500h3_Female_Human_EVENT_IVAN_INTRO_01	¡Iván! Tú vendrás conmigo.	
VO_GILA_500h3_Female_Human_EVENT_NEMESIS_INTRO_01	Escalofríos. Creí que habías muerto.	
VO_GILA_500h3_Female_Human_EVENT_NEMESIS_TURN2_01	Terminaré lo que mi padre comenzó.	
VO_GILA_600h_Male_Worgen_EVENT_HAGATHA_SUB_IN_01	Te tengo en la mira, Hagatha.	
VO_GILA_600h_Male_Worgen_EVENT_HAGATHA_TURN2_01	Esta tierra le pertenece a los gilneanos.	
VO_GILA_600h_Male_Worgen_EVENT_HAGATHA_TURN4_01	Al menos yo TENGO un pueblo.	
VO_GILA_600h_Male_Worgen_EVENT_HAGATHA_WOUNDED_01	Cortaré todos los árboles. Este bosque será un cráter desolado.	
VO_GILA_600h_Male_Worgen_EVENT_IVAN_INTRO_01	¡Te encontré, gusano traicionero!	
VO_GILA_600h_Male_Worgen_EVENT_NEMESIS_INTRO_01	¡Godfrey, traidor! Es hora de pagar.	
VO_GILA_600h_Male_Worgen_EVENT_NEMESIS_TURN02_01	Tú ya estabas podrido antes de morir, Godfrey.	
VO_GILA_900h_Female_Gnome_EVENT_HAGATHA_ALMOST_DEAD_01	El tiempo cura todas las heridas.	
VO_GILA_900h_Female_Gnome_EVENT_HAGATHA_SUB_IN_01	Hazte a un lado, ahora me toca a mí. 	
VO_GILA_900h_Female_Gnome_EVENT_HAGATHA_TURN2_01	Moví cielo y tierra para eliminarte.	
VO_GILA_900h_Female_Gnome_EVENT_HAGATHA_WOUNDED_01	Se te acaba el tiempo, bruja. 	
VO_GILA_900h_Female_Gnome_EVENT_IVAN_INTRO_01	Hasta aquí llegas, Iván. He visto cómo termina esto.	
VO_GILA_900h_Female_Gnome_EVENT_NEMESIS_INTRO_B_01	¿Acaso... esto ya ha pasado?	
VO_GILA_900h_Female_Gnome_EVENT_NEMESIS_TURN2_02	¡¿Pero qué creo que estoy haciendo?!	
VO_GILA_900h_Female_Gnome_EVENT_NEMESIS_TURN6_01	¿Eres del futuro? ¿Cuál de las dos gana?	
VO_GILA_BOSS_20h_MangyWolf_DefeatPlayer	¡Grrroowrooo!	
VO_GILA_BOSS_20h_MangyWolf_Emote	¡Grwruraaah!	
VO_GILA_BOSS_20h_MangyWolf_Intro	¡Rowooaoo!	
VO_GILA_BOSS_21h_Rottooth_Emote	¡ROOOooooah!	
VO_GILA_BOSS_21h_Rottooth_Intro	¡Nrgruhh... JOOOO!	
VO_GILA_BOSS_21h_Rottooth_PlayerDefeat	¡Juff, juff... rooOOooar!	
VO_GILA_BOSS_22h_Male_Undead_Death_01	<Muerte>	
VO_GILA_BOSS_22h_Male_Undead_DefeatPlayer_01	¡Qué suerte! Por fin puedo comprar una vaina para mi daga.	
VO_GILA_BOSS_22h_Male_Undead_EmoteResponse_01	Sigue hablando, mi tripulación está en camino.	
VO_GILA_BOSS_22h_Male_Undead_EmoteResponseTess_01	¡Guárdate las plegarias para el capitán Escalofríos, princesa!	
VO_GILA_BOSS_22h_Male_Undead_EventPlaysCoin_01	¡Sabía que tenías monedas!	
VO_GILA_BOSS_22h_Male_Undead_EventPlaysShiv_01	Me gusta cómo trabajas.	
VO_GILA_BOSS_22h_Male_Undead_Intro_01	¡El capitán quiere que te "desaparezca"!	
VO_GILA_BOSS_22h_Male_Undead_IntroCrowley_01	¿Quién hubiera dicho que llegarías a comandante? ¿Te pagan bien?	
VO_GILA_BOSS_22h_Male_Undead_IntroTess_01	El capitán te tiene bronca, princesa.	
VO_GILA_BOSS_23h_Male_Ettin_DefeatPlayer_01	¡Yo gano!\n(<i>¿Dónde están todos mis esbirros?</i>)	
VO_GILA_BOSS_23h_Male_Ettin_EmoteResponse_02	¡No me agradas!\n(<i>A mí solo me agradas un poco</i>).	
VO_GILA_BOSS_23h_Male_Ettin_HeroPower_01	¡Buen viaje!	
VO_GILA_BOSS_23h_Male_Ettin_HeroPower_02	¡Jop!	
VO_GILA_BOSS_23h_Male_Ettin_HeroPower_03	¡Juah!	
VO_GILA_BOSS_23h_Male_Ettin_HeroPower_04	¡VUELA!	
VO_GILA_BOSS_23h_Male_Ettin_HeroPower_05	¡A ellos!	
VO_GILA_BOSS_23h_Male_Ettin_Intro_01	Pareces fácil de lanzar.\n(<i>¡Qué fácil!</i>).	
VO_GILA_BOSS_24h_Male_Bogbeast_DefeatPlayer_01	Flotan primero, se hinchan luego... ¡Juijjjpuf!	
VO_GILA_BOSS_24h_Male_Bogbeast_EmoteResponse_01	Burbujas y putrefacción, burbujas y putrefacción…	
VO_GILA_BOSS_24h_Male_Bogbeast_EventPlaysSmallMinion_01	Mmejejejeje.	
VO_GILA_BOSS_24h_Male_Bogbeast_EventPlaysSmallMinion_02	Aaajajajajaja.	
VO_GILA_BOSS_24h_Male_Bogbeast_EventPlaysSmallMinion_03	Aaajajejajajija.	
VO_GILA_BOSS_24h_Male_Bogbeast_EventPlaysSmallMinion_04	Error.	
VO_GILA_BOSS_24h_Male_Bogbeast_HeroPower_01	Nunca estoy solo.	
VO_GILA_BOSS_24h_Male_Bogbeast_HeroPower_02	La ciénaga guarda secretos.	
VO_GILA_BOSS_24h_Male_Bogbeast_HeroPower_04	Mira lo que apareció.	
VO_GILA_BOSS_24h_Male_Bogbeast_Intro_01	¡Esta es MI ciénaga! ¡Grr! Solo los muertos viven aquí.	
VO_GILA_BOSS_25h_Male_Dwarf_DefeatPlayerALT_01	Hagatha ha puesto un precio a tu cabeza, ¿sabes?	
VO_GILA_BOSS_25h_Male_Dwarf_EmoteResponse_01	Tú sigue ladrando, yo seguiré cazando.	
VO_GILA_BOSS_25h_Male_Dwarf_EventPlayCompass_01	Linda brújula. Creo que me la quedaré.	
VO_GILA_BOSS_25h_Male_Dwarf_EventPlaysSecret_01	¡Hum! Dos pueden jugar ese juego.	
VO_GILA_BOSS_25h_Male_Dwarf_EventPlaysSecret_02	Eso ya lo he visto.	
VO_GILA_BOSS_25h_Male_Dwarf_EventPlaysSecret_03	Te crees muy misterioso, ¿eh?	
VO_GILA_BOSS_25h_Male_Dwarf_EventPlayToolsOfTheTrade_01	Algunas de esas armas eran mías, señorita.	
VO_GILA_BOSS_25h_Male_Dwarf_EventPlayTrapper_01	¡Ja! ¡Esto es un arte!	
VO_GILA_BOSS_25h_Male_Dwarf_EventTokiAbility_01	¡Dije que nada de trucos, gnoma!	
VO_GILA_BOSS_25h_Male_Dwarf_HeroPower_01	Mira dónde pisas, jajajaja.	
VO_GILA_BOSS_25h_Male_Dwarf_HeroPower_02	Pasito a pasito. Suave, suavecito.	
VO_GILA_BOSS_25h_Male_Dwarf_HeroPower_03	Siempre un paso adelante.	
VO_GILA_BOSS_25h_Male_Dwarf_HeroPower_04	¡Jaja! No hay dónde esconderse.	
VO_GILA_BOSS_25h_Male_Dwarf_Intro_01	Hay una recompensa muy grande por tu cabeza.	
VO_GILA_BOSS_25h_Male_Dwarf_IntroDarius_01	Te crees muy hombre con esa arma, Crowley.	
VO_GILA_BOSS_25h_Male_Dwarf_IntroShaw_01	No soy como tú, Shaw. Yo no sigo causas perdidas. 	
VO_GILA_BOSS_25h_Male_Dwarf_IntroTess_02	Estás en mi lista, Cringris. ¡Y tu padre es el siguiente!	
VO_GILA_BOSS_25h_Male_Dwarf_IntroToki_01	¡Ni se te ocurra usar esos trucos tuyos, gnoma!	
VO_GILA_BOSS_26h_Male_Tauren_Death_01	Mis... gnomos...	
VO_GILA_BOSS_26h_Male_Tauren_DeathToki_01	¡Qué ironía!	
VO_GILA_BOSS_26h_Male_Tauren_DefeatPlayer_01	No creo que entres en mi bolsa.	
VO_GILA_BOSS_26h_Male_Tauren_DefeatPlayerToki_01	No hay nada mejor que agregar un gnomo raro a tu colección.	
VO_GILA_BOSS_26h_Male_Tauren_EmoteResponse_01	¡No pienso compartir!	
VO_GILA_BOSS_26h_Male_Tauren_EmoteResponseToki_01	Mmm... Pero qué parlanchina...	
VO_GILA_BOSS_26h_Male_Tauren_EventBurgle_01	¿Tienes algún gnomo por ahí?	
VO_GILA_BOSS_26h_Male_Tauren_EventBurgle_03	¿Eso en tu bolsillo es un gnomo?	
VO_GILA_BOSS_26h_Male_Tauren_EventPlayClockworkAssistant_01	Eso es solo una copia barata. 	
VO_GILA_BOSS_26h_Male_Tauren_EventPlayGattlingGunner_01	¿Dónde encontraste a ese?	
VO_GILA_BOSS_26h_Male_Tauren_EventPlaysClockwork_02	Es un modelo viejo, no se ve todos los días.	
VO_GILA_BOSS_26h_Male_Tauren_EventPlaysGnome_01	¡Tengo uno de esos...! En algún lado.	
VO_GILA_BOSS_26h_Male_Tauren_EventPlaysGnome_02	¡Ese sí que es difícil de encontrar!	
VO_GILA_BOSS_26h_Male_Tauren_EventPlaysGnome_05	¡Ahhh! Tienes buen gusto. 	
VO_GILA_BOSS_26h_Male_Tauren_EventPlaysGnome_06	Agregaré ese a mi colección.	
VO_GILA_BOSS_26h_Male_Tauren_EventPlaysLeper_01	Este es un poco... desagradable.	
VO_GILA_BOSS_26h_Male_Tauren_EventPlaysMillhouse_02	Ah... ¡Este nunca deja de hablar!	
VO_GILA_BOSS_26h_Male_Tauren_EventPlaysThermaplugg_02	¡Máximo valor de gnomo!	
VO_GILA_BOSS_26h_Male_Tauren_EventSackOfGnomes_01	No recuerdo qué tengo aquí.	
VO_GILA_BOSS_26h_Male_Tauren_EventSackOfGnomes_03	Tengo demasiados para contarlos.	
VO_GILA_BOSS_26h_Male_Tauren_EventSackOfGnomes_04	¿Qué tenemos aquí?	
VO_GILA_BOSS_26h_Male_Tauren_EventSackOfGnomes_05	Estos son solo restos.	
VO_GILA_BOSS_26h_Male_Tauren_EventSilence_03	Silencio...	
VO_GILA_BOSS_26h_Male_Tauren_Intro_02	¿Viniste por mis gnomos?	
VO_GILA_BOSS_26h_Male_Tauren_IntroToki_02	Oh, uno más para mi colección...	
VO_GILA_BOSS_27h_Male_Construct_Death_02	¡Al fin... escapamos!	
VO_GILA_BOSS_27h_Male_Construct_DefeatPlayer_01	¡No eras... mi objetivo!	
VO_GILA_BOSS_27h_Male_Construct_EmoteResponse_01	¡Grrraaaaaeeii! Perdón, a veces se me escapa.	
VO_GILA_BOSS_27h_Male_Construct_EventPlayDrBoom_02	¡¿Dr. Bum?! ¡No me lleve de vuelta al laboratorio!	
VO_GILA_BOSS_27h_Male_Construct_EventPlaySparePart_01	Había tantas partes... en el laboratorio...	
VO_GILA_BOSS_27h_Male_Construct_EventPlayUnstablePortal_01	El laboratorio... de Tormenta Abisal…	
VO_GILA_BOSS_27h_Male_Construct_HeroPowerBeast_02	¡Grrrrr, grrrr! Una bestia en mi interior...	
VO_GILA_BOSS_27h_Male_Construct_HeroPowerDemon_01	Cuánta oscuridad...	
VO_GILA_BOSS_27h_Male_Construct_HeroPowerDragon_01	Qué criatura tan majestuosa...	
VO_GILA_BOSS_27h_Male_Construct_HeroPowerGeneric_01	Uno más...	
VO_GILA_BOSS_27h_Male_Construct_HeroPowerMech_02	¡Iiieee! ¡Un corazón de relojería!	
VO_GILA_BOSS_27h_Male_Construct_HeroPowerMurloc_01	¡Iaaarg! Más peces...	
VO_GILA_BOSS_27h_Male_Construct_HeroPowerPirate_01	¿Arrr?	
VO_GILA_BOSS_27h_Male_Construct_Intro_01	¡Grr! Qué gusto conocerte.	
VO_GILA_BOSS_29h_Female_Satyr_DefeatPlayer_01	Estos bosques tienen música propia.	
VO_GILA_BOSS_29h_Female_Satyr_EmoteResponse_01	Ay, pero\nqué cosas\ndices. 	
VO_GILA_BOSS_29h_Female_Satyr_EventPlaysEnchantingTune_01	¿Te agrada mi canción?	
VO_GILA_BOSS_29h_Female_Satyr_EventPlaysEnchantingTune_02	¿No podemos llevarnos bien?	
VO_GILA_BOSS_29h_Female_Satyr_EventPlaysEnchantingTune_03	¡Siéntate a mi lado! No muerdo.	
VO_GILA_BOSS_29h_Female_Satyr_EventPlaysOldMilitiaHorn_01	¿Un dúo?	
VO_GILA_BOSS_29h_Female_Satyr_EventPlaysSmallMinion_01	¿No eres de lo más adorable?	
VO_GILA_BOSS_29h_Female_Satyr_EventPlaysSmallMinion_02	¡Eres casi tan encantador como yo! Bueno...	
VO_GILA_BOSS_29h_Female_Satyr_EventPlaysSmallMinion_03	¡Podría devorarte!	
VO_GILA_BOSS_29h_Female_Satyr_HeroPower_01	Vengan conmigo, pequeñines.	
VO_GILA_BOSS_29h_Female_Satyr_HeroPower_02	¡Un, dos, tres! ¡Síganme!	
VO_GILA_BOSS_29h_Female_Satyr_HeroPower_03	¡Por aquí! Síganme.	
VO_GILA_BOSS_29h_Female_Satyr_HeroPower_04	Sigan los sonidos de mi canción.	
VO_GILA_BOSS_29h_Female_Satyr_HeroPower_05	Yo cuidaré de ustedes. ¡Confíen en mí!	
VO_GILA_BOSS_29h_Female_Satyr_Intro_01	¡Al fin! Un público.	
VO_GILA_BOSS_30h_Female_Gnome_DefeatPlayer_01	Nada es gratis en la vida…	
VO_GILA_BOSS_30h_Female_Gnome_EmoteResponse_01	Ay, ya es demasiado tarde.	
VO_GILA_BOSS_30h_Female_Gnome_EventBloodMagic_01	Tan frágil. Tan delicado.	
VO_GILA_BOSS_30h_Female_Gnome_EventBloodMagic_02	Dale una mordida.	
VO_GILA_BOSS_30h_Female_Gnome_EventBloodMagic_04	¡Au revoir!	
VO_GILA_BOSS_30h_Female_Gnome_EventBloodMagic_05	Todos son iguales frente a mi magia.	
VO_GILA_BOSS_30h_Female_Gnome_EventBloodMagic_06	Muy sabrosa, ¿no?	
VO_GILA_BOSS_30h_Female_Gnome_Intro_01	¿Te apetece una mordida?	
VO_GILA_BOSS_31h_Male_Treant_Death_01	<Muerte>	
VO_GILA_BOSS_31h_Male_Treant_DefeatPlayer_01	Todos son hormigas para los árboles.	
VO_GILA_BOSS_31h_Male_Treant_Emote Response_01	Si un árbol cae sobre ti en el bosque, ¿seguirás haciendo ruido?	
VO_GILA_BOSS_31h_Male_Treant_HeroPower_01	Sé libre.	
VO_GILA_BOSS_31h_Male_Treant_HeroPower_02	De tal palo...	
VO_GILA_BOSS_31h_Male_Treant_HeroPower_03	Adelante, pequeñín.	
VO_GILA_BOSS_31h_Male_Treant_HeroPower_05	Savia de mi savia.	
VO_GILA_BOSS_31h_Male_Treant_Intro_01	Fuera de aquí.	
VO_GILA_BOSS_32h_Female_Sprite_Death_01	¡Qué... aburrido!	
VO_GILA_BOSS_32h_Female_Sprite_DefeatPlayer_01	¡Vamos, juguemos un poco más! Oh, oh... ups.	
VO_GILA_BOSS_32h_Female_Sprite_EmoteResponse_01	Sí, sí. ¡Después jugamos a eso!	
VO_GILA_BOSS_32h_Female_Sprite_EventPlaysAoEBuff_01	¡Tú sí que sabes jugar a esto!	
VO_GILA_BOSS_32h_Female_Sprite_EventPlaysAoEBuff_02	Veo que ya has jugado a esto.	
VO_GILA_BOSS_32h_Female_Sprite_EventPlaysBigMinion_01	¡Ey! ¡Eso es trampa!	
VO_GILA_BOSS_32h_Female_Sprite_EventPlaysBigMinion_02	¡Guaaaauuu!	
VO_GILA_BOSS_32h_Female_Sprite_HeroPower_01	¡Crece, crece! ¡Más rápido!	
VO_GILA_BOSS_32h_Female_Sprite_HeroPower_02	¡Más grande! ¡Vamos!	
VO_GILA_BOSS_32h_Female_Sprite_HeroPower_03	¡Ayyy, mira cómo creces!	
VO_GILA_BOSS_32h_Female_Sprite_HeroPower_04	Jajaja. ¡Creo que estoy ganando!	
VO_GILA_BOSS_32h_Female_Sprite_Intro_01	¿Quieres jugar un juego?	
VO_GILA_BOSS_33h_Male_Mech_Attack_01	Enfrentando.	
VO_GILA_BOSS_33h_Male_Mech_Death_01	Error de segmentación...	
VO_GILA_BOSS_33h_Male_Mech_DefeatPlayer_01	Error: No quedan objetivos. Reanudar patrulla.	
VO_GILA_BOSS_33h_Male_Mech_EmoteResponse_01	Espantado de conocerte.	
VO_GILA_BOSS_33h_Male_Mech_EventPlayHarvestGolem_01	Advertencia: Objetivo no tiene alma.	
VO_GILA_BOSS_33h_Male_Mech_EventWeaponKill_01	Cosechado.	
VO_GILA_BOSS_33h_Male_Mech_EventWeaponKill_02	Mejora.	
VO_GILA_BOSS_33h_Male_Mech_EventWeaponKill_03	Eliminado.	
VO_GILA_BOSS_33h_Male_Mech_HeroPower_01	Cosecha.	
VO_GILA_BOSS_33h_Male_Mech_HeroPower_02	Sustento.	
VO_GILA_BOSS_33h_Male_Mech_HeroPower_03	Vigorizante.	
VO_GILA_BOSS_33h_Male_Mech_HeroPower_04	Reciclado.	
VO_GILA_BOSS_33h_Male_Mech_Intro_01	La cosecha está por comenzar.	
VO_GILA_BOSS_34h_Male_Demon_DefeatPlayer_01	Mm. Tu alma es... poderosa. ¡Me alimentaré durante semanas!	
VO_GILA_BOSS_34h_Male_Demon_EmoteResponse_01	Espero que tu alma no sea tan... charlatana.	
VO_GILA_BOSS_34h_Male_Demon_HeroPower_01	Mmm. Ambrosía.	
VO_GILA_BOSS_34h_Male_Demon_HeroPower_02	Exquisito.	
VO_GILA_BOSS_34h_Male_Demon_HeroPower_03	Tu rostro está un poco pálido.	
VO_GILA_BOSS_34h_Male_Demon_HeroPower_04	Permite que te quite ese peso de tus hombros.	
VO_GILA_BOSS_34h_Male_Demon_HeroPower_05	Un alma no es más que una carga.	
VO_GILA_BOSS_34h_Male_Demon_Intro_01	Pronto no serás más que una cáscara vacía.	
VO_GILA_BOSS_35h_Male_Beast_DefeatPlayer	¡Aaaghheeaaa!	
VO_GILA_BOSS_35h_Male_Beast_EmoteResponse	¡Aoor aagh harahrahhghh!	
VO_GILA_BOSS_35h_Male_Beast_Intro	¡Rrrrrghaaaghhhaooghc!	
VO_GILA_BOSS_36h_Female_Human_Death_01	¡Mi último croac!	
VO_GILA_BOSS_36h_Female_Human_DefeatPlayer_01	¡Tú no eres mi príncipe!	
VO_GILA_BOSS_36h_Female_Human_Emote Response_01	Basta de hablar. ¡Dame un besito!	
VO_GILA_BOSS_36h_Female_Human_EventHex_01	¡Oh, vaya! ¡Qué... encantador!	
VO_GILA_BOSS_36h_Female_Human_EventHex_02	Créeme, yo sé cómo se siente.	
VO_GILA_BOSS_36h_Female_Human_HeroPower_01	¡Besitos!	
VO_GILA_BOSS_36h_Female_Human_HeroPower_02	<Beso>	
VO_GILA_BOSS_36h_Female_Human_HeroPower_03	¡Mua!	
VO_GILA_BOSS_36h_Female_Human_Intro_01	Oh, no, no de nuevo.	
VO_GILA_BOSS_37h_Male_Murloc_DefeatPlayer_01	...	
VO_GILA_BOSS_37h_Male_Murloc_EmoteResponse_01	¡…!	
VO_GILA_BOSS_37h_Male_Murloc_EventPlayMurlocHolmes_02	¿…? ¡…!	
VO_GILA_BOSS_37h_Male_Murloc_EventPlayPlague_01	¡…!	
VO_GILA_BOSS_37h_Male_Murloc_EventPlayPlague_02	¡…!	
VO_GILA_BOSS_37h_Male_Murloc_EventPlayPlague_07	¡…!	
VO_GILA_BOSS_37h_Male_Murloc_HeroPower_01	…	
VO_GILA_BOSS_37h_Male_Murloc_HeroPower_02	…	
VO_GILA_BOSS_37h_Male_Murloc_HeroPower_03	¡…!	
VO_GILA_BOSS_37h_Male_Murloc_HeroPower_04	…	
VO_GILA_BOSS_37h_Male_Murloc_Intro_01	…	
VO_GILA_BOSS_38h_Male_Goblin_Death_01	¡Nunca... más!	
VO_GILA_BOSS_38h_Male_Goblin_DefeatPlayer_01	El cuervo dijo: ¡Cra!	
VO_GILA_BOSS_38h_Male_Goblin_EmoteResponse_01	¡Ese llamado para aves es espantoso!	
VO_GILA_BOSS_38h_Male_Goblin_EventBirdDead_01	Eres... ¡un monstruo!	
VO_GILA_BOSS_38h_Male_Goblin_EventBirdDead_02	¿Pero qué te han hecho?	
VO_GILA_BOSS_38h_Male_Goblin_EventBirdDead_03	¡Ah! ¡¿Por qué?! ¡Son solo aves!	
VO_GILA_BOSS_38h_Male_Goblin_EventPlayBird_01	¡Vuela, sé libre!	
VO_GILA_BOSS_38h_Male_Goblin_EventPlayBird_02	¡Vuela, vuela!	
VO_GILA_BOSS_38h_Male_Goblin_EventPlayBird_03	¿Quién es el ave más linda? 	
VO_GILA_BOSS_38h_Male_Goblin_EventPlayBird_04	A veces desearía ser un ave.	
VO_GILA_BOSS_38h_Male_Goblin_EventPlayerPlayBird_01	Ese es muy bonito.	
VO_GILA_BOSS_38h_Male_Goblin_EventPlayerPlayBird_02	¡Esta pelea es por las aves!	
VO_GILA_BOSS_38h_Male_Goblin_EventPlayNestingRoc_01	No... quise llamar a ese.	
VO_GILA_BOSS_38h_Male_Goblin_EventPlayNestingRoc_02	Ehh... bastante cerca.	
VO_GILA_BOSS_38h_Male_Goblin_HeroPower_01	¡Cra! ¡Cra!	
VO_GILA_BOSS_38h_Male_Goblin_HeroPower_02	Cra... cof, cof...	
VO_GILA_BOSS_38h_Male_Goblin_HeroPower_03	Cra. Cra. ¡CRA!	
VO_GILA_BOSS_38h_Male_Goblin_Intro_01	¿Pelear o volar? ¡Mejor las dos cosas!	
VO_GILA_BOSS_40h_Female_Treant_Death_01	Fuera abajo...	
VO_GILA_BOSS_40h_Female_Treant_DefeatPlayer_01	Esto es solo el principio. Mi cosecha comienza.	
VO_GILA_BOSS_40h_Female_Treant_EmoteResponse_01	A cortar, a cortar.	
VO_GILA_BOSS_40h_Female_Treant_EventPlaysAxe_01	Tantos han caído en la flor de la vida…	
VO_GILA_BOSS_40h_Female_Treant_EventPlaysAxe_02	¿Cuántos de los míos deben sufrir?	
VO_GILA_BOSS_40h_Female_Treant_EventPlaysWoodsmansAxe_01	Qué aberración. 	
VO_GILA_BOSS_40h_Female_Treant_HeroPower_01	El bosque los reclama. 	
VO_GILA_BOSS_40h_Female_Treant_HeroPower_02	Estos bosques están vivos.	
VO_GILA_BOSS_40h_Female_Treant_HeroPower_03	Vamos. Es nuestro momento.	
VO_GILA_BOSS_40h_Female_Treant_HeroPower_04	Conocerás nuestro odio.	
VO_GILA_BOSS_40h_Female_Treant_Intro_01	Tu pueblo pagará.	
VO_GILA_BOSS_41h_Female_HumanGhost_Death_01	Mi amor...	
VO_GILA_BOSS_41h_Female_HumanGhost_DefeatPlayer_01	Nada puede separarnos.	
VO_GILA_BOSS_41h_Female_HumanGhost_EmoteResponse_01	Déjanos en paz.	
VO_GILA_BOSS_41h_Female_HumanGhost_EventFatigue_01	¿Mi amor? ¿A dónde has ido?	
VO_GILA_BOSS_41h_Female_HumanGhost_EventFatigue_02	Ya no siento su presencia...	
VO_GILA_BOSS_41h_Female_HumanGhost_EventFatigueDeath_01	¿Somos... libres al fin? ¡Gracias!	
VO_GILA_BOSS_41h_Female_HumanGhost_EventPlayRin_01	¿Será ella la que nos libere?	
VO_GILA_BOSS_41h_Female_HumanGhost_EventShuffle_01	Tú nos comprendes... ¿verdad?	
VO_GILA_BOSS_41h_Female_HumanGhost_EventShuffle_02	Juntos... por siempre.	
VO_GILA_BOSS_41h_Female_HumanGhost_EventShuffle_03	Eres igual a nosotros.	
VO_GILA_BOSS_41h_Female_HumanGhost_HeroPower_01	Nunca te abandonaré.	
VO_GILA_BOSS_41h_Female_HumanGhost_HeroPower_02	¡Regresa a mí!	
VO_GILA_BOSS_41h_Female_HumanGhost_HeroPower_03	No te vayas...	
VO_GILA_BOSS_41h_Female_HumanGhost_HeroPower_04	Te mantendré cerca.	
VO_GILA_BOSS_41h_Female_HumanGhost_Intro_01	Pronto estaré de nuevo contigo, amor mío.	
VO_GILA_BOSS_41h_Male_NightElf_Death_01	No…	
VO_GILA_BOSS_41h_Male_NightElf_DefeatPlayer_01	No eres de utilidad para el Bosque Embrujado.	
VO_GILA_BOSS_41h_Male_NightElf_EmoteResponse_02	Tus palabras no me conmueven.	
VO_GILA_BOSS_41h_Male_NightElf_EventHack_01	¡Cuarenta hachazos!	
VO_GILA_BOSS_41h_Male_NightElf_EventHack_02	Retribución.	
VO_GILA_BOSS_41h_Male_NightElf_EventHack_03	¡Fuera... de... este... bosque!	
VO_GILA_BOSS_41h_Male_NightElf_HeroPower_01	¡La supervivencia del más fuerte!	
VO_GILA_BOSS_41h_Male_NightElf_HeroPower_02	Por raíces y tallos.	
VO_GILA_BOSS_41h_Male_NightElf_HeroPower_03	¡Demuestra tu fuerza!	
VO_GILA_BOSS_41h_Male_NightElf_HeroPower_04	Arréglatelas.	
VO_GILA_BOSS_41h_Male_NightElf_Intro_01	Da la vuelta, intruso.	
VO_GILA_BOSS_42h_Male_Ogre_DefeatPlayer_01	Nunca lo viste venir. Y yo tampoco.	
VO_GILA_BOSS_42h_Male_Ogre_EmoteResponse_01	¡Sigue hablando y yo seguiré pisoteando!	
VO_GILA_BOSS_42h_Male_Ogre_EventHeroPowerEnemy_01	¡Te di! 	
VO_GILA_BOSS_42h_Male_Ogre_EventHeroPowerEnemy_02	¡Machacar!	
VO_GILA_BOSS_42h_Male_Ogre_EventHeroPowerEnemy_03	¡Nunca fallo!	
VO_GILA_BOSS_42h_Male_Ogre_EventHeroPowerFriendly_01	Oh, eso no salió bien.	
VO_GILA_BOSS_42h_Male_Ogre_EventHeroPowerFriendly_02	Muejejeje. Algo malo acaba de crujir.	
VO_GILA_BOSS_42h_Male_Ogre_Intro_01	¿Quién anda ahí? ¡Te puedo oler!	
VO_GILA_BOSS_43h_Male_HumanGhost_DefeatPlayer_01	Mm. Hora de cavar.	
VO_GILA_BOSS_43h_Male_HumanGhost_EmoteResponse_01	Márchate de una vez.	
VO_GILA_BOSS_43h_Male_HumanGhost_EventPlaysDeathrattle_01	Los huesos no descansan.	
VO_GILA_BOSS_43h_Male_HumanGhost_EventPlaysDeathrattle_02	Los muertos tienen historias que contar.	
VO_GILA_BOSS_43h_Male_HumanGhost_EventPlaysDeathrattle_03	No somos tan diferentes.	
VO_GILA_BOSS_43h_Male_HumanGhost_EventPlaysDeathrattle_04	Acompáñanos. Descansa.	
VO_GILA_BOSS_43h_Male_HumanGhost_EventPlaysDeathrattle_05	Ese tendrá una tumba poco profunda.	
VO_GILA_BOSS_43h_Male_HumanGhost_EventPlayStrokeOfMidnight_01	Cómo extrañaba el sonido de las campanas.	
VO_GILA_BOSS_43h_Male_HumanGhost_Intro_01	No deberías estar fuera de casa tan tarde.	
VO_GILA_BOSS_44h_Male_Troll_Death_01	<Muerte>	
VO_GILA_BOSS_44h_Male_Troll_DefeatPlayer_02	¡Más vale prevenir que llorar!	
VO_GILA_BOSS_44h_Male_Troll_EmoteResponse_01	El médico siempre tiene la razón.	
VO_GILA_BOSS_44h_Male_Troll_EventHeals_01	Ahhhhh…	
VO_GILA_BOSS_44h_Male_Troll_EventHeals_02	Ajá, qué bueno...	
VO_GILA_BOSS_44h_Male_Troll_EventHeals_04	Ja, ja, ja. Mmmm...	
VO_GILA_BOSS_44h_Male_Troll_EventPlayerHeals_03	¡Ey! Estás haciendo todo mal.	
VO_GILA_BOSS_44h_Male_Troll_EventPlayerHeals_04	Deja que yo me encargue de eso.	
VO_GILA_BOSS_44h_Male_Troll_EventPlaysBandages_01	¡Esos sí que son de calidad!	
VO_GILA_BOSS_44h_Male_Troll_HeroPower_01	Puede que sientas un pinchazo.	
VO_GILA_BOSS_44h_Male_Troll_HeroPower_02	¿Les temes a las agujas?	
VO_GILA_BOSS_44h_Male_Troll_HeroPower_03	Rápido y sin dolor. Casi siempre.	
VO_GILA_BOSS_44h_Male_Troll_HeroPower_04	¿Vudú? Ey, yo tengo licencia.	
VO_GILA_BOSS_44h_Male_Troll_HeroPower_05	Se siente bien, ¿no?	
VO_GILA_BOSS_44h_Male_Troll_HeroPower_06	Esto puede doler un poco.	
VO_GILA_BOSS_44h_Male_Troll_Intro_01	¡Pasa! Siéntate. Muéstrame dónde te dolerá.	
VO_GILA_BOSS_45h_Female_Human_Death_02	<Muerte>	
VO_GILA_BOSS_45h_Female_Human_DefeatPlayer_01	Habrías sido una excelente incorporación.	
VO_GILA_BOSS_45h_Female_Human_EmoteResponse_01	¿Por qué no lo charlamos... mientras tomamos algo? 	
VO_GILA_BOSS_45h_Female_Human_EventDrawsExtraCards_01	Sí. Bebe.	
VO_GILA_BOSS_45h_Female_Human_EventDrawsExtraCards_02	¿Qué sabor tiene?	
VO_GILA_BOSS_45h_Female_Human_EventDrawsExtraCards_03	Bebe un buen trago. Adelante.	
VO_GILA_BOSS_45h_Female_Human_EventFirstDamage_01	¿O sea que no te interesa?	
VO_GILA_BOSS_45h_Female_Human_EventPlayHallowedWater_01	¿Agua bendita? ¡Puaj! Nunca me gustó el sabor.	
VO_GILA_BOSS_45h_Female_Human_EventPlaysAcolyte_01	Mmmm... Me agrada. 	
VO_GILA_BOSS_45h_Female_Human_EventPlaysHoarder_01	Puedes beber cuando él no esté.	
VO_GILA_BOSS_45h_Female_Human_EventPlaysNovice_01	Nuestra nueva iniciada ha llegado. ¡Brindemos por ella!	
VO_GILA_BOSS_45h_Female_Human_Intro_01	Suelta tus armas. Únete a nosotros. 	
VO_GILA_BOSS_46h_Male_Worgen_DefeatPlayer_01	Solo los más fuertes sobreviven.	
VO_GILA_BOSS_46h_Male_Worgen_EmoteResponse_01	¿Hueles eso? Es miedo.	
VO_GILA_BOSS_46h_Male_Worgen_EventPlayBloodMoon_01	¡AUUUUU!	
VO_GILA_BOSS_46h_Male_Worgen_EventPlaysWorgen_01	Lamentable.	
VO_GILA_BOSS_46h_Male_Worgen_EventPlaysWorgen_03	Debilucho.	
VO_GILA_BOSS_46h_Male_Worgen_EventPlaysWorgen_06	No eres nada.	
VO_GILA_BOSS_46h_Male_Worgen_EventPlayTrapper_02	¡Entrégate a tu ira!	
VO_GILA_BOSS_46h_Male_Worgen_Intro_01	¿Todavía quieres cazarme?	
VO_GILA_BOSS_47h_Male_Monster_Death_01	¡Y mi vida así culmina!	
VO_GILA_BOSS_47h_Male_Monster_DefeatPlayer_01	Los bosques se hacen fuertes con los héroes que aquí mueren.	
VO_GILA_BOSS_47h_Male_Monster_EmoteResponse_01	¿Habla? ¡Dice patrañas! No tiene agallas, a mí no me engaña.	
VO_GILA_BOSS_47h_Male_Monster_HeroPower_01	Si ya tenías problemas, con el doble será un dilema.	
VO_GILA_BOSS_47h_Male_Monster_HeroPower_02	Para almas pobres el precio es doble.	
VO_GILA_BOSS_47h_Male_Monster_HeroPower_03	Te veo y no lo creo. ¿Eres nuevo? ¡Ay, cómo tiemblo!	
VO_GILA_BOSS_47h_Male_Monster_IntroALT_01	¿Quién osa, quién pisa la roca maldita que Shudderwock habita?	
VO_GILA_BOSS_48h_Female_Gnome_Death_01	¡Esto te dolerá más que a mí!	
VO_GILA_BOSS_48h_Female_Gnome_DefeatPlayer_01	Bueno, eso fue lo último que veremos de MÍ. Un momento, ¿esto es una paradoja?	
VO_GILA_BOSS_48h_Female_Gnome_EmoteResponse_01	Sabía que yo diría eso. 	
VO_GILA_BOSS_48h_Female_Gnome_EventAlt_01	¡No! Vamos a hacerlo una vez más.	
VO_GILA_BOSS_48h_Female_Gnome_EventAlt_02	Creo que en realidad sucedió... ¡así!	
VO_GILA_BOSS_48h_Female_Gnome_EventAlt_03	¡Basta! Vuelve atrás.	
VO_GILA_BOSS_48h_Female_Gnome_EventPlayerAltTime_01	Bueno, eso es una novedad.	
VO_GILA_BOSS_48h_Female_Gnome_EventPlayerAltTime_02	Guau, SÍ que hemos alborotado la línea temporal.	
VO_GILA_BOSS_48h_Female_Gnome_EventPlayerTimeWarp_01	Ah, esto ya es confuso.	
VO_GILA_BOSS_48h_Female_Gnome_EventPlayerTimeWarp_02	Nota mental: evita esta pelea.	
VO_GILA_BOSS_48h_Female_Gnome_EventPlayerTimeWarpToki_01	Un momento, ¡todavía no deberías saber eso!	
VO_GILA_BOSS_48h_Female_Gnome_EventPlayerTimeWarpToki_02	¡Recuerdo esta parte de la última vez que lo hice!	
VO_GILA_BOSS_48h_Female_Gnome_EventTimeWarp_01	Esto lo aprenderás en un par de años.	
VO_GILA_BOSS_48h_Female_Gnome_EventTimeWarp_02	Fue difícil descifrar esto.	
VO_GILA_BOSS_48h_Female_Gnome_EventTurn2_01	¡Tengo que detenerme! ¡Antes de que sea tarde!	
VO_GILA_BOSS_48h_Female_Gnome_EventTurn4_01	¡No puedes ganar! ¡Conozco todos mis movimientos!	
VO_GILA_BOSS_48h_Female_Gnome_EventTurn6_01	Las dos lamentaremos tu próxima acción. ¡A menos que te detenga! 	
VO_GILA_BOSS_48h_Female_Gnome_HeroPower_01	¡Hora de acelerar las cosas!	
VO_GILA_BOSS_48h_Female_Gnome_HeroPower_02	¡Tic-tac, tic-tac!	
VO_GILA_BOSS_48h_Female_Gnome_HeroPower_03	Terminemos con esto.	
VO_GILA_BOSS_48h_Female_Gnome_Intro_01	¡Ah, volvemos a vernos! ¡Por primera vez!	
VO_GILA_BOSS_48h_Female_Gnome_Intro_02	¿Yo de nuevo? Esta es la segunda vez que peleamos. 	
VO_GILA_BOSS_48h_Female_Gnome_Intro_03	Esta es la tercera vez que peleamos. ¡Ríndete!	
VO_GILA_BOSS_48h_Female_Gnome_Intro_04	¡Sigues… apareciendo! ¡Ya basta!	
VO_GILA_BOSS_48h_Female_Gnome_Intro_05	¿Cuántas veces debemos pasar por esto?	
VO_GILA_BOSS_48h_Female_Gnome_PlayerHeroPower_01	¿Por qué pensé que eso sería una buena idea?	
VO_GILA_BOSS_48h_Female_Gnome_PlayerHeroPower_02	Y yo que me creía tan lista.	
VO_GILA_BOSS_48h_Female_Gnome_PlayerHeroPower_03	¡No de nuevo!	
VO_GILA_BOSS_48h_Female_Gnome_PlayerHeroPower_04	Ahora SÍ que empiezo a irritarme.	
VO_GILA_BOSS_49h_Female_Undead_Death_01	Un corazón... podrido...	
VO_GILA_BOSS_49h_Female_Undead_DefeatPlayer_01	Podrías haberte unido a nosotros. 	
VO_GILA_BOSS_49h_Female_Undead_EmoteResponse_01	Únete a nuestro culto. Organizamos picnics los viernes. 	
VO_GILA_BOSS_49h_Female_Undead_EventFaithfulDies_01	¡Lo necesitaba!	
VO_GILA_BOSS_49h_Female_Undead_EventFaithfulDies_02	Es difícil controlar mentalmente a un buen ayudante.	
VO_GILA_BOSS_49h_Female_Undead_EventFaithfulDies_03	No te olvidaré... ¡como sea que te llames!	
VO_GILA_BOSS_49h_Female_Undead_EventPact_01	Únete a nosotros...	
VO_GILA_BOSS_49h_Female_Undead_EventPact_02	¡Otro sirviente para nuestro culto!	
VO_GILA_BOSS_49h_Female_Undead_EventPact_03	Ven a mí, sí...	
VO_GILA_BOSS_49h_Female_Undead_EventPact_05	Mi culto crece.	
VO_GILA_BOSS_49h_Female_Undead_EventPlayBird_01	Aguijón de Bandarroja,\nflor de paz con hoja ruin,\nplumas de lechuza\ny piel de puercoespín.	
VO_GILA_BOSS_49h_Female_Undead_EventPlayCauldron_01	No cese, no cese el trabajo, aunque pese. Que hierva el caldero y la mezcla se espese.	
VO_GILA_BOSS_49h_Female_Undead_EventPlayDragon_01	Colmillos de lobo, fauces de dragón. Raíz de tierra para darle sazón.	
VO_GILA_BOSS_49h_Female_Undead_EventPlayFaithful_01	Vengan, hijos míos. 	
VO_GILA_BOSS_49h_Female_Undead_EventPlayFaithful_02	Da un paso al frente, mi fiel seguidor...	
VO_GILA_BOSS_49h_Female_Undead_EventPlayFaithful_03	Concédeme tu vida.	
VO_GILA_BOSS_49h_Female_Undead_EventPlayFaithful_04	¡Mis devotos seguidores!	
VO_GILA_BOSS_49h_Female_Undead_EventPlayFaithful_05	¡Sírveme una última vez!	
VO_GILA_BOSS_49h_Female_Undead_EventPlayHex_01	Ojo de buitre y de vil renacuajo. Alas de murciélago y rabioso espumajo.	
VO_GILA_BOSS_49h_Female_Undead_EventPlaySnake_01	Echemos el lomo de astuta culebra. Su unión con el caldo el infierno celebra.	
VO_GILA_BOSS_49h_Female_Undead_EventPlayTreant_01	Con un diente oscuro\nenfriará el caldo impuro.	
VO_GILA_BOSS_49h_Female_Undead_EventTurn02_01	Shaw, si conocieras su poder, te echarías al suelo como tus perros.	
VO_GILA_BOSS_49h_Female_Undead_Intro_02	¿Nos encontraste tú? ¿O nosotros te guiamos hasta donde queríamos?	
VO_GILA_BOSS_50h_Male_Spirit_DefeatPlayer_01	Es mejor consumirse que desvanecerse...	
VO_GILA_BOSS_50h_Male_Spirit_EmoteResponse_01	Respira...	
VO_GILA_BOSS_50h_Male_Spirit_EventPlaysEcho_01	Sí...	
VO_GILA_BOSS_50h_Male_Spirit_EventPlaysEcho_02	Otro...	
VO_GILA_BOSS_50h_Male_Spirit_EventPlaysEcho_03	¡Más…!	
VO_GILA_BOSS_50h_Male_Spirit_EventPlaysEcho_04	Muajajaja....	
VO_GILA_BOSS_50h_Male_Spirit_Intro_01	La niebla llama... 	
VO_GILA_BOSS_51h_Male_Undead_Death_01	<Muerte>	
VO_GILA_BOSS_51h_Male_Undead_DefeatPlayer_01	¡Oh! Parece que ya no necesitarás ese oro.	
VO_GILA_BOSS_51h_Male_Undead_EmoteResponse_01	Guarda la lengua.	
VO_GILA_BOSS_51h_Male_Undead_EventPlayCoinPouch_01	Vamos. Entrégame eso.	
VO_GILA_BOSS_51h_Male_Undead_EventPlayMinion_01	¡Oye! Hay un impuesto por hacer eso.	
VO_GILA_BOSS_51h_Male_Undead_EventPlayMinion_03	Eso te saldrá caro.	
VO_GILA_BOSS_51h_Male_Undead_EventPlayMinion_04	Pagarás por eso. Pronto.	
VO_GILA_BOSS_51h_Male_Undead_HeroPower_01	Es solo el comienzo.	
VO_GILA_BOSS_51h_Male_Undead_HeroPower_02	Paga lo que debes.	
VO_GILA_BOSS_51h_Male_Undead_HeroPower_03	Ay, no seas tacaño…	
VO_GILA_BOSS_51h_Male_Undead_HeroPower_04	Vacía. Tus. Bolsillos.	
VO_GILA_BOSS_51h_Male_Undead_Intro_01	Te pareces a alguien que me debe dinero.	
VO_GILA_BOSS_52h_Male_Human_DefeatPlayerALT_02	¡No volveré a la cárcel! ¡No esta vez!	
VO_GILA_BOSS_52h_Male_Human_EmoteResponse_02	Solo hay humo y cenizas ahí abajo, jejeje.	
VO_GILA_BOSS_52h_Male_Human_EventPlayRoyalGift_02	¡Oooh, qué brillante! No me molestaría tener un poco de eso.	
VO_GILA_BOSS_52h_Male_Human_EventPlayStealth_02	¡Cuánta hipocresía!	
VO_GILA_BOSS_52h_Male_Human_EventPlayStealth_03	Ah, pero si YO me escabullo, soy un ladrón.	
VO_GILA_BOSS_52h_Male_Human_EventTransform_01	Ahora sí que lo lograste.	
VO_GILA_BOSS_52h_Male_Human_HeroPower_01	¡Nadie me ve!	
VO_GILA_BOSS_52h_Male_Human_HeroPower_02	No estoy escabulléndome, ¡lo juro!	
VO_GILA_BOSS_52h_Male_Human_HeroPower_03	Un poco de camuflaje.	
VO_GILA_BOSS_52h_Male_Human_HeroPower_04	Solo una pizca de hollín.	
VO_GILA_BOSS_52h_Male_Human_HeroPower_05	Polvo al polvo.	
VO_GILA_BOSS_52h_Male_Human_IntroALT_02	¡¿Ladrón?! ¿Yo? No puedo creerlo...	
VO_GILA_BOSS_52h2_Male_Worgen_EmoteResponse_02	¡Ahora mira lo que me hiciste hacer!	
VO_GILA_BOSS_52h2_Male_Worgen_HeroPower_01	¡AUUUUU!	
VO_GILA_BOSS_52h2_Male_Worgen_HeroPower_02	¡A ellos!	
VO_GILA_BOSS_52h2_Male_Worgen_HeroPower_03	¡Siente la bestia interior!	
VO_GILA_BOSS_54h_Male_Golem_DefeatPlayer_01	Doblar y quebrar. Aplastar y destrozar.	
VO_GILA_BOSS_54h_Male_Golem_EmoteResponse_01	Palos y piedras.	
VO_GILA_BOSS_54h_Male_Golem_HeroPower_01	Todos se unirán.	
VO_GILA_BOSS_54h_Male_Golem_HeroPower_02	El Bosque Embrujado se extiende.	
VO_GILA_BOSS_54h_Male_Golem_HeroPower_03	Arrasen la tierra. Siembren las semillas.	
VO_GILA_BOSS_54h_Male_Golem_HeroPower_04	La influencia de Hagatha nos fortalece.	
VO_GILA_BOSS_54h_Male_Golem_HeroPower_05	Por la voluntad de Hagatha.	
VO_GILA_BOSS_54h_Male_Golem_Intro_01	Si la piedra rueda, el musgo no queda.	
VO_GILA_BOSS_55h_Female_NightElf_Death_01	¿Quién los salvará?	
VO_GILA_BOSS_55h_Female_NightElf_DefeatPlayer_01	Shh, calma. Guiaré a tu espíritu a un lugar seguro...	
VO_GILA_BOSS_55h_Female_NightElf_EmoteResponse_01	Shhhh. ¡No frente a los fuegos fatuos!	
VO_GILA_BOSS_55h_Female_NightElf_EventAssimilation_01	Lo tuyo será nuestro.	
VO_GILA_BOSS_55h_Female_NightElf_EventAssimilation_02	Sus cuerpos. ¡Atrápenlos!	
VO_GILA_BOSS_55h_Female_NightElf_EventAssimilation_03	¡Esta es nuestra oportunidad!	
VO_GILA_BOSS_55h_Female_NightElf_EventKillsWisp_02	¡No!	
VO_GILA_BOSS_55h_Female_NightElf_EventKillsWisp_03	¡Alto!	
VO_GILA_BOSS_55h_Female_NightElf_EventKillsWisp_04	¡Mis hijos!	
VO_GILA_BOSS_55h_Female_NightElf_EventPlayCartographer_01	¡Una cartógrafa! Ella debe saber cómo salir.	
VO_GILA_BOSS_55h_Female_NightElf_EventPlayCompass_01	¡Tal vez eso nos ayude a encontrar la salida!	
VO_GILA_BOSS_55h_Female_NightElf_HeroPower_01	Vengan, niños.	
VO_GILA_BOSS_55h_Female_NightElf_HeroPower_02	Ah, allí están.	
VO_GILA_BOSS_55h_Female_NightElf_HeroPower_03	Salgan de donde estén...	
VO_GILA_BOSS_55h_Female_NightElf_Intro_01	La maldición de Hagatha devora. ¡Debo salvar a mis hijos!	
VO_GILA_BOSS_56h_Male_Elemental_DefeatPlayer_01	¿Por qué tienes la cara tan triste? Ah, bueno. 	
VO_GILA_BOSS_56h_Male_Elemental_EmoteResponse_01	No lo podría haber dicho mejor.	
VO_GILA_BOSS_56h_Male_Elemental_EventTransformFace_02	Ah, la máscara perfecta.	
VO_GILA_BOSS_56h_Male_Elemental_HeroPower_01	Una máscara nueva, un rostro nuevo.	
VO_GILA_BOSS_56h_Male_Elemental_HeroPower_02	Un rostro nuevo, una persona nueva.	
VO_GILA_BOSS_56h_Male_Elemental_HeroPower_03	Una persona nueva, una vida nueva.	
VO_GILA_BOSS_56h_Male_Elemental_HeroPower_05	Siempre cambiamos, siempre mutamos.	
VO_GILA_BOSS_56h_Male_Elemental_HeroPower_07	Somos uno, somos todos.	
VO_GILA_BOSS_56h_Male_Elemental_HeroPower_09	¿Acaso recuerdas quién eras?	
VO_GILA_BOSS_56h_Male_Elemental_HeroPower_10	Solo necesitas una máscara.	
VO_GILA_BOSS_56h_Male_Elemental_IntroALT_02	Tú y yo no somos tan diferentes.	
VO_GILA_BOSS_57h_Male_Undead_DefeatPlayer_01	Ya regresarás, cuando llegue el momento. 	
VO_GILA_BOSS_57h_Male_Undead_EmoteResponse_01	Le daré tus saludos a la Dama Oscura.	
VO_GILA_BOSS_57h_Male_Undead_EventDesecrate_01	Deja que la enfermedad se apodere de ti.	
VO_GILA_BOSS_57h_Male_Undead_EventDesecrate_02	Uno más para el cementerio.	
VO_GILA_BOSS_57h_Male_Undead_EventDesecrate_03	Es contagioso.	
VO_GILA_BOSS_57h_Male_Undead_EventDesecrate_04	Pronto te unirás a ellos.	
VO_GILA_BOSS_57h_Male_Undead_EventPlayHolyBook_01	Tus textos sagrados no te salvarán.	
VO_GILA_BOSS_57h_Male_Undead_EventShallowGraves_01	¡Levántense!	
VO_GILA_BOSS_57h_Male_Undead_EventShallowGraves_02	¡Regresen!	
VO_GILA_BOSS_57h_Male_Undead_EventShallowGraves_03	¡La Dama Oscura llama!	
VO_GILA_BOSS_57h_Male_Undead_HeroPower_01	Profanación.	
VO_GILA_BOSS_57h_Male_Undead_HeroPower_02	Carroña.	
VO_GILA_BOSS_57h_Male_Undead_HeroPower_03	Inhala los vapores.	
VO_GILA_BOSS_57h_Male_Undead_HeroPower_04	La corrupción se propaga.	
VO_GILA_BOSS_57h_Male_Undead_Intro_01	¡Bienvenido! Ven a ver lo que he desenterrado.	
VO_GILA_BOSS_58h_Male_Giant_Death_01	<Muerte>	
VO_GILA_BOSS_58h_Male_Giant_DefeatPlayer_01	Este pueblo liiiindo. ¡PARA PISOTEAR!	
VO_GILA_BOSS_58h_Male_Giant_DefeatPlayer_02	Este pueblo no está a mi altura.	
VO_GILA_BOSS_58h_Male_Giant_EmoteResponse_01	¡Voy a aplastarte!	
VO_GILA_BOSS_58h_Male_Giant_EventBigWeapon_01	¡¿Tú aplastar también?!	
VO_GILA_BOSS_58h_Male_Giant_EventMinionReturn_01	¡Ahí estás!	
VO_GILA_BOSS_58h_Male_Giant_EventMinionReturn_02	¡Regresaste!	
VO_GILA_BOSS_58h_Male_Giant_EventMinionReturn_03	Hola de nuevo.	
VO_GILA_BOSS_58h_Male_Giant_HeroPower_01	¡A correeeer!	
VO_GILA_BOSS_58h_Male_Giant_HeroPower_02	Uhhhh… ¡BUU!	
VO_GILA_BOSS_58h_Male_Giant_HeroPower_03	Je, je, je. ¡¿Dónde te escondes?!	
VO_GILA_BOSS_58h_Male_Giant_HeroPower_04	Fi-fa-fo-GRUM. ¡Jajajaja!	
VO_GILA_BOSS_58h_Male_Giant_HeroPower_05	Puedes correr, pero... ¿PUEDES esconderte?	
VO_GILA_BOSS_58h_Male_Giant_Intro_01	¡Síííííí... aplastar!	
VO_GILA_BOSS_59h_Male_Undead_DefeatPlayer_01	Bah, no eres más que un perro sarnoso.	
VO_GILA_BOSS_59h_Male_Undead_DefeatPlayer_02	Adiós, viejo amigo.	
VO_GILA_BOSS_59h_Male_Undead_DefeatPlayer_03	¿Este es el asesino que enviaron para matarme? Qué buena broma.	
VO_GILA_BOSS_59h_Male_Undead_EmoteResponse_01	¿Trajiste un cañón a un duelo con pistolas?\n¿Quién es el cobarde?	
VO_GILA_BOSS_59h_Male_Undead_EventDeadlyShot_01	¡En el blanco!	
VO_GILA_BOSS_59h_Male_Undead_EventDeadlyShot_02	¿Qué? Fue una muerte piadosa.	
VO_GILA_BOSS_59h_Male_Undead_EventQuickShot_01	Tengo un par de trucos bajo la manga.	
VO_GILA_BOSS_59h_Male_Undead_EventQuickShot_02	¡Dispara! ¡Jajajajajaja!	
VO_GILA_BOSS_59h_Male_Undead_EventTurn02_01	Le dije a Cringris que te dejara pudriéndote en prisión, Crowley.	
VO_GILA_BOSS_59h_Male_Undead_HeroPowerKills_01	Ah, esto me trae recuerdos.	
VO_GILA_BOSS_59h_Male_Undead_HeroPowerKills_02	¡Había olvidado lo bien que se siente esto!	
VO_GILA_BOSS_59h_Male_Undead_HeroPowerKills_03	Jajajaja.	
VO_GILA_BOSS_59h_Male_Undead_HeroPowerKills_04	Jejejeje. Qué placer ver el mundo en llamas.	
VO_GILA_BOSS_59h_Male_Undead_HeroPowerKills_05	Ojalá pudiera hacer esto con todos los huargen.	
VO_GILA_BOSS_59h_Male_Undead_Intro_01	¡Tu destino final será la agonía!	
VO_GILA_BOSS_59h_Male_Undead_IntroCrowley_01	¿Quién eres tú para hablar de lealtad, Crowley? 	
VO_GILA_BOSS_60h_Male_HumanGhost_Death_02	Me lleva... la marea...	
VO_GILA_BOSS_60h_Male_HumanGhost_DefeatPlayer_01	Bienvenido a bordo. ¡Para siempre! Jajajaja.	
VO_GILA_BOSS_60h_Male_HumanGhost_EmoteResponseTess_01	Mejor comience a creer en cuentos de fantasmas, señorita.	
VO_GILA_BOSS_60h_Male_HumanGhost_EventBigWeapon_01	Equilibrada y filosa.	
VO_GILA_BOSS_60h_Male_HumanGhost_EventBigWeapon_02	Pero mira qué belleza.	
VO_GILA_BOSS_60h_Male_HumanGhost_EventBigWeapon_03	¿Alguna vez viste un filo más exquisito?	
VO_GILA_BOSS_60h_Male_HumanGhost_EventPlayerKingsblade_01	Un momento... ¿Hay más de una?	
VO_GILA_BOSS_60h_Male_HumanGhost_EventPlayKingsblade_01	Recorrí el mundo entero en busca de este tesoro.	
VO_GILA_BOSS_60h_Male_HumanGhost_EventPlayKingsblade_02	Ella siempre regresa a mí.	
VO_GILA_BOSS_60h_Male_HumanGhost_EventPlayKragg_02	¿Abandonaste los mares por el cielo? Qué idiota.	
VO_GILA_BOSS_60h_Male_HumanGhost_EventPlayPatches_02	¡Parches! ¡Has perdido algunos ojos, mi viejo amigo!	
VO_GILA_BOSS_60h_Male_HumanGhost_EventPlayTuskarrRaider_01	Hoy en día cualquiera es pirata.	
VO_GILA_BOSS_60h_Male_HumanGhost_EventTurn2_01	La mejor\nvenganza será\nincorporarte a\nmi tripulación.	
VO_GILA_BOSS_60h_Male_HumanGhost_HeroPower_01	Mi espada me canta, ¡y yo le devuelvo el favor!	
VO_GILA_BOSS_60h_Male_HumanGhost_HeroPower_07	¡Ahógate en la marea!	
VO_GILA_BOSS_60h_Male_HumanGhost_IntroTess_01	¡Qué sorpresa! Pero si es la hija del rey que nos condenó. 	
VO_GILA_BOSS_61h_Female_Orc_DefeatPlayer_01	Soy una con estos bosques, y nunca moriré.	
VO_GILA_BOSS_61h_Female_Orc_EmoteResponse_01	Mira tu reflejo y contempla el instrumento de tu destrucción.	
VO_GILA_BOSS_61h_Female_Orc_EmoteResponseCrowley_01	¿Estás compensando por algo, Crowley? ¿Mmm?	
VO_GILA_BOSS_61h_Female_Orc_EmoteResponseShaw_01	Ay, ya basta de ladridos. ¡Y tus perros también son irritantes!	
VO_GILA_BOSS_61h_Female_Orc_EmoteResponseTess_01	¿Acaso tus padres tuvieron algún hijo que amaran?	
VO_GILA_BOSS_61h_Female_Orc_EmoteResponseToki_01	¿Cómo escapaste del secuestragnomos?	
VO_GILA_BOSS_61h_Female_Orc_EventCannonKill_01	¡Maldito sea ese cañón!	
VO_GILA_BOSS_61h_Female_Orc_EventCannonKill_02	Mucho ruido. Poco cerebro.	
VO_GILA_BOSS_61h_Female_Orc_EventCannonKill_03	El hierro se oxida tal como la carne se pudre.	
VO_GILA_BOSS_61h_Female_Orc_EventCannonKill_04	Ladras muy fuerte, cachorro.	
VO_GILA_BOSS_61h_Female_Orc_EventCrowleyHagathaLow_01	Nunca moriré, mientras estos bosques vivan...	
VO_GILA_BOSS_61h_Female_Orc_EventCrowleyLow_01	Te enterraré junto con tu cañón, Crowley.	
VO_GILA_BOSS_61h_Female_Orc_EventCrowleyTurn2_01	¡Ustedes abandonaron esta tierra! ¡Ahora es mía!	
VO_GILA_BOSS_61h_Female_Orc_EventCrowleyTurn4_01	Eres un marginado, incluso entre tu pueblo.	
VO_GILA_BOSS_61h_Female_Orc_EventShawHoundKill_01	Perro malo.	
VO_GILA_BOSS_61h_Female_Orc_EventShawHoundKill_02	Perros sucios.	
VO_GILA_BOSS_61h_Female_Orc_EventShawLow_01	La maldición del Bosque Embrujado pide tu vida.	
VO_GILA_BOSS_61h_Female_Orc_EventShawTurn2_01	Todas las criaturas del bosque se unen a mí...	
VO_GILA_BOSS_61h_Female_Orc_EventShawTurn2_02	Cuando sienten mi toque.	
VO_GILA_BOSS_61h_Female_Orc_EventShawTurn4_01	Miles de espíritus oscuros se vuelven contra ti. 	
VO_GILA_BOSS_61h_Female_Orc_EventSummonCrowskin_01	Mi culto nunca morirá. 	
VO_GILA_BOSS_61h_Female_Orc_EventSummonGodfrey_01	Godfrey, los espíritus de este bosque te llaman una vez más…	
VO_GILA_BOSS_61h_Female_Orc_EventTessHagathaLow_01	YO SOY estos bosques. 	
VO_GILA_BOSS_61h_Female_Orc_EventTessLow_01	Tus restos alimentarán este bosque.	
VO_GILA_BOSS_61h_Female_Orc_EventTessScavenges_01	Nada te salvará.	
VO_GILA_BOSS_61h_Female_Orc_EventTessScavenges_02	¡Ah! Sigue buscando, princesa.	
VO_GILA_BOSS_61h_Female_Orc_EventTessScavenges_03	¿Estás revolviendo la basura?	
VO_GILA_BOSS_61h_Female_Orc_EventTessScavenges_04	No encontrarás consuelo en los juncos.	
VO_GILA_BOSS_61h_Female_Orc_EventTessTurn2_01	Estos bosques se apoderarán de tu ciudad. 	
VO_GILA_BOSS_61h_Female_Orc_EventTessTurn4_01	¡Esta tierra estaba MUERTA! Yo le devolví la vida. Me pertenece.	
VO_GILA_BOSS_61h_Female_Orc_EventTokiHagathaLow_01	Los espíritus de estos bosques me preservarán...	
VO_GILA_BOSS_61h_Female_Orc_EventTokiHeroPower_01	¿Pero qué pasó?	
VO_GILA_BOSS_61h_Female_Orc_EventTokiHeroPower_03	Abusas de tu suerte.	
VO_GILA_BOSS_61h_Female_Orc_EventTokiHeroPower_04	Los espíritus ven tus acciones. 	
VO_GILA_BOSS_61h_Female_Orc_EventTokiHeroPower_05	Un día tus trucos se volverán en tu contra.	
VO_GILA_BOSS_61h_Female_Orc_EventTokiLow_01	Ya no te quedan trucos, gnoma. 	
VO_GILA_BOSS_61h_Female_Orc_EventTokiTurn2_01	Eres una abominación al igual que yo, gnoma.	
VO_GILA_BOSS_61h_Female_Orc_EventTokiTurn4_01	Crees que tus\nmaquinaciones son invisibles.\nPero yo veo todo.	
VO_GILA_BOSS_61h_Female_Orc_Intro_01	Soy la sangre que fluye y recorre estos bosques.	
VO_GILA_BOSS_61h_Female_Orc_IntroCrowley_01	Disfrutaré de la paz cuando silencie esa arma.	
VO_GILA_BOSS_61h_Female_Orc_IntroShaw_01	Pondré a tus perros contra su amo.	
VO_GILA_BOSS_61h_Female_Orc_IntroTess_01	Da la vuelta, "princesa". Dile a tu padre que no hay esperanza.	
VO_GILA_BOSS_61h_Female_Orc_IntroToki_01	Puedes alterar tu destino, pero los árboles y las estrellas nunca olvidan.	
VO_GILA_BOSS_62h_GustaveTheGutRipper_Emote	OOOoozzzz	
VO_GILA_BOSS_62h_GustaveTheGutRipper_Intro	¡WhRRReeeooo!	
VO_GILA_BOSS_62h_GustaveTheGutRipper_PlayerDefeat	¡Mraghrararughhh!	
VO_GILA_BOSS_63h_Female_Harpy_Death_01	Mis... huevos... ¡ahhh!	
VO_GILA_BOSS_63h_Female_Harpy_DefeatPlayer_01	¡Hermanas! Traigan los restos... a mi nido.	
VO_GILA_BOSS_63h_Female_Harpy_EmoteResponse_01	Creo que seguir hablando en este momento solo entorpecería la dinámica de nuestra relación. 	
VO_GILA_BOSS_63h_Female_Harpy_HeroPower_01	¡Me pertenece!	
VO_GILA_BOSS_63h_Female_Harpy_HeroPower_02	Tu magia solo oscurece este bosque.	
VO_GILA_BOSS_63h_Female_Harpy_HeroPower_03	Solo me fortalezco más y más. 	
VO_GILA_BOSS_63h_Female_Harpy_Intro_01	No avanzarás más. Es la voluntad de... ¡Hagatha!	
VO_GILA_BOSS_64h_Male_Goblin_Death_01	¡E-Espera!	
VO_GILA_BOSS_64h_Male_Goblin_DefeatPlayer_01	¡Gracias, gracias! Ahora, en cuanto a mi pago…	
VO_GILA_BOSS_64h_Male_Goblin_EmoteResponse_01	Me encanta cuando participa el público.	
VO_GILA_BOSS_64h_Male_Goblin_EvenPlayCursedCurio_01	¡Eso es fantástico! ¿Dónde puedo conseguir uno?	
VO_GILA_BOSS_64h_Male_Goblin_EventMCTech_01	Ey, detente. ¡Ese es mi número!	
VO_GILA_BOSS_64h_Male_Goblin_EventMindControl_01	Así que quieres superarme, ¿eh?	
VO_GILA_BOSS_64h_Male_Goblin_HeroPowerHandBig_01	Empiezas a adormecerte.	
VO_GILA_BOSS_64h_Male_Goblin_HeroPowerHandBig_03	¡Te pesan los párpados, no puedes mantenerlos abiertos!	
VO_GILA_BOSS_64h_Male_Goblin_HeroPowerHandEmpty_01	Zzzz... Zzzz... Zzzz...	
VO_GILA_BOSS_64h_Male_Goblin_HeroPowerHandMedium_01	Mírame a los ojos.	
VO_GILA_BOSS_64h_Male_Goblin_HeroPowerHandMedium_02	Sigue mi reloj... Un momento... ¿qué venía después?	
VO_GILA_BOSS_64h_Male_Goblin_HeroPowerHandMedium_03	A un lado y al otro. ¡Sigue el movimiento!	
VO_GILA_BOSS_64h_Male_Goblin_HeroPowerHandSmall_01	¿Qué era lo que estaba haciendo?	
VO_GILA_BOSS_64h_Male_Goblin_HeroPowerHandSmall_02	Los párpados... te pesan.	
VO_GILA_BOSS_64h_Male_Goblin_Intro_01	¡Oh! ¿Un voluntario? 	
VO_GILA_BOSS_66h_Female_Undead_DefeatPlayer_01	…	
VO_GILA_BOSS_66h_Female_Undead_EmoteResponse_02	…	
VO_GILA_BOSS_66h_Female_Undead_EventPlayHorn_02	…	
VO_GILA_BOSS_66h_Female_Undead_HeroPower_01	…	
VO_GILA_BOSS_66h_Female_Undead_HeroPower_02	…	
VO_GILA_BOSS_66h_Female_Undead_HeroPower_03	…	
VO_GILA_BOSS_66h_Female_Undead_Intro_01	…	
VO_GILA_BOSS_67h_Male_Undead_DefeatPlayer_01	La vida es solo una carrera de ratas.	
VO_GILA_BOSS_67h_Male_Undead_EmoteResponse_01	¡No quiero oír ni un chillido más de tu parte!	
VO_GILA_BOSS_67h_Male_Undead_EventPlayRat_01	¿No es cierto que son buenas mascotas? Pero son mejores en un guiso.	
VO_GILA_BOSS_67h_Male_Undead_EventPlayRat_02	Qué criaturitas tan simples. Como tú.	
VO_GILA_BOSS_67h_Male_Undead_EventPlayRat_03	Cuidado, esos mordisquitos no son señales de afecto.	
VO_GILA_BOSS_67h_Male_Undead_EventPlayRatTrap_01	¿Una caja? ¿Un palo? ¡Qué poca sutileza!	
VO_GILA_BOSS_67h_Male_Undead_Intro_01	¡Te atrapé! Siempre tuve un buen olfato para atrapar ratas.	
VO_GILA_BOSS_68h_Male_Undead_DefeatPlayer_01	¡Resististe tanto! Esto tengo que estudiarlo.	
VO_GILA_BOSS_68h_Male_Undead_EmoteResponse_01	¿Sabes lo difícil que es CREAR una plaga?	
VO_GILA_BOSS_68h_Male_Undead_EventPlayPoison_01	Un paso delante de mí.	
VO_GILA_BOSS_68h_Male_Undead_EventPlayPoison_02	¡Oh, veneno!	
VO_GILA_BOSS_68h_Male_Undead_EventPlayPoison_03	Me gusta cómo piensas.	
VO_GILA_BOSS_68h_Male_Undead_EventPlayPoison_04	¿Me prestas eso? Es solo por un momento.	
VO_GILA_BOSS_68h_Male_Undead_Intro_01	¡Traigan a sus muertos! Los necesito.	
VO_HeadlessHorseman_Male_Human_HallowsEve_01	¡Estoy por aquí, cuerpo imbécil!	
VO_HeadlessHorseman_Male_Human_HallowsEve_02	Oye, cobarde. Eres tú a quien desprecio. ¡Pues siente ahora, EL FUEGO!	
VO_HeadlessHorseman_Male_Human_HallowsEve_04	El cielo está oscuro, arden las llamas. En vano luchas, ¡la suerte está echada!	
VO_HeadlessHorseman_Male_Human_HallowsEve_07	Se extinguió mi llama, nada queda de ella. ¡Te enviaré yo mismo a la oscuridad eterna!	
VO_HeadlessHorseman_Male_Human_HallowsEve_08	Desesperado estás por ver mi sangre fluir, para ello es mi cabeza que debes destruir.	
VO_HeadlessHorseman_Male_Human_HallowsEve_10	¡JAJAJAJAJA AJAJAAAAAA!	
VO_HeadlessHorseman_Male_Human_HallowsEve_11	¡AAAAAJAJAJA JAJAAJAJ!	
VO_HeadlessHorseman_Male_Human_HallowsEve_12	Prepárense, pues las campanas sonaron. ¡Oculten al débil, al niño, al anciano!	
VO_HeadlessHorseman_Male_Human_HallowsEve_13	Cada uno de ustedes saldará su deuda. ¡Imploren clemencia, la cuenta se cierra!	
VO_HeadlessHorseman_Male_Human_HallowsEve_17	JAJAJAJAajaja....	
VO_HRW_DEBUG_01	1	
VO_HRW_DEBUG_02	2	
VO_HRW_DEBUG_03	3	
VO_HRW_DEBUG_04	4	
VO_HRW_DEBUG_05	5	
VO_HRW_TEST_00	¡Los ayudaré a librarse de la Maldición de la carne!	
VO_HRW_TEST_01	¡Buen trabajo! Juntos, han derrotado al jefe.\n\n¡Los dos jugadores ganan!	
VO_HRW_TEST_02	¡Derroten al Maestro de palancas Mecazod juntos para ganar!	
VO_HRW_TEST_ABILITY_00	Dañando a un héroe.	
VO_HRW_TEST_ABILITY_01	Destruyendo al esbirro con mayor ataque.	
VO_HRW_TEST_ABILITY_02	Lanzando tres bombas.	
VO_HRW_TEST_ABILITY_03	Dañando a todos los demás personajes.	
VO_HRW_TEST_ABILITY_04	Obteniendo 2 de Ataque.	
VO_HRW_TEST_ABILITY_05	Infligiendo daño a ambos héroes.	
VO_HRW_TEST_ABILITY_06	Silenciando al Eremita Cho. Permanentemente.	
VO_HRW_TEST_ABILITY_98	Tablero objetivo completo. Vaciando tablero objetivo.	
VO_ICC_841_Female_Sanlayn_Death_02	¡Pero si nos estábamos llevando tan bien!   	
VO_ICC01_Jaina_Female_Human_DrawsRager_01	¡¿Esto es en serio?!	
VO_ICC01_Jaina_Female_Human_JainaDKIntro_05	Puedo oír los susurros… de los muertos…	
VO_ICC01_Jaina_Female_Human_PostDeath_02	Debemos… resistir…	
VO_ICC01_LichKing_Male_Human_EmoteResponse_01	Tus súplicas de piedad son en vano.	
VO_ICC01_LichKing_Male_Human_EndOfTurn2_01	Ja, ja, ja. ¡Y esto es solo el comienzo!	
VO_ICC01_LichKing_Male_Human_EndOfTurn2_02	Y eso que no estoy usando mi mazo más agresivo. 	
VO_ICC01_LichKing_Male_Human_Idle_01	Vamos. ¡Termina tu turno para que yo pueda terminar con tu existencia!	
VO_ICC01_LichKing_Male_Human_Intro_01	Elige tus cartas con cuidado. Esta será la última vez que las veas.	
VO_ICC01_LichKing_Male_Human_JainaDKIntro_01	Levántate, maga. Tu trabajo aquí aún no termina. 	
VO_ICC01_LichKing_Male_Human_JainaDKIntro_02	Únete a mí. Los vivos te temerán y los muertos te obedecerán.	
VO_ICC01_LichKing_Male_Human_JainaDKIntro_03	Tus enemigos te temerán más que a su propia muerte…	
VO_ICC01_LichKing_Male_Human_JainaDKintro_06	Ahora, quita esta basura de mi camino.	
VO_ICC01_LichKing_Male_Human_PlaysFrostmourne_01	Tu rango pagará el precio.	
VO_ICC01_LichKing_Male_Human_Turn1_01	Mis cartas son tan buenas...	
VO_ICC01_LichKing_Male_Human_Turn11_01	Mis hordas de no-muertos están a tus órdenes.	
VO_ICC01_LichKing_Male_Human_Turn13_01	Hazlos sufrir.	
VO_ICC01_LichKing_Male_Human_Turn15_01	La piedad es para los débiles.	
VO_ICC01_LichKing_Male_Human_Turn2_02	Contempla mi poder.	
VO_ICC01_LichKing_Male_Human_Turn4_01	Nadie puede salvarte.	
VO_ICC01_LichKing_Male_Human_Turn4_02	¡Mi poder no conoce límites!	
VO_ICC01_LichKing_Male_Human_Turn5_01	Es imposible resistirse a mi voluntad.	
VO_ICC01_LichKing_Male_Human_Turn5_02	Tú también te arrodillarás. 	
VO_ICC01_Tirion_Male_Human_AFKay_01	¡Presta atención! 	
VO_ICC01_Tirion_Male_Human_EmoteResponse_02	¡Ya no te reconozco!	
VO_ICC01_Tirion_Male_Human_EndOfTurn4_01	¡Aguanta un poco más, adalid!	
VO_ICC01_Tirion_Male_Human_EndOfTurn4_02	Tengo fe en que la providencia te concederá un gran poder cuando lo necesites.	
VO_ICC01_Tirion_Male_Human_EndOfTurn4_03	Ten fe en que la providencia te ayudará cuando lo necesites.	
VO_ICC01_Tirion_Male_Human_Flavor01_01	Voy a necesitar mejores aventureros...	
VO_ICC01_Tirion_Male_Human_Flavor02_01	Jaina, ¡te has convertido en un monstruo!	
VO_ICC01_Tirion_Male_Human_Flavor03_01	¡El Rey Exánime pagará por esta atrocidad! 	
VO_ICC01_Tirion_Male_Human_JainaDKintro_05	¿Qué es esto? ¡¿En qué te has convertido?!	
VO_ICC01_Tirion_Male_Human_PauseDeath_02	¡Detente!	
VO_ICC01_Tirion_Male_Human_PostDeath_01	Héroe, tu voluntad te pertenece. ¡Renuncia al llamado del Rey Exánime! 	
VO_ICC01_Tirion_Male_Human_TerribleTank_01	¿Por qué no usas Provocar?	
VO_ICC01_Tirion_Male_Human_Turn2_01	¡No temas, adalid! Vamos hacia ti.	
VO_ICC01_Tirion_Male_Human_Turn3_01	¡Ya casi llegamos! ¿Cómo va todo? ¿Bien?	
VO_ICC01_Tirion_Male_Human_Turn6_01	Adalid, ya casi estamos listos para...	
VO_ICC01_Tirion_Male_Human_Turn6_02	¡¿Qué?!	
VO_ICC01_Tirion_Male_Human_Turn8_01	¡Te enfrentas a los mejores aventureros de Azeroth!	
VO_ICC04_LichKing_Male_Human_BreathNoMinion_01	¿Qué? ¿Sindragosa no tiene ni un esbirro para congelar? Me dejas helado.	
VO_ICC04_LichKing_Male_Human_Lose_01	Tu cadáver congelado será una advertencia para los demás…	
VO_ICC04_LichKing_Male_Human_Turn5_01	Seguramente te estarás preguntando cómo deshacerte de los bloques de hielo.	
VO_ICC04_LichKing_Male_Human_Turn5_02	Te lo diré: ¡es imposible!	
VO_ICC04_LichKing_Male_Human_Win_02	¡ESTE MAZO DEBE PURGARSE POR COMPLETO! 	
VO_ICC04_Sindragosa_Female_Dragon_Bounce_01	¡Devuelve eso!	
VO_ICC04_Sindragosa_Female_Dragon_BreathNoRoomLeft_01	Ya no tienes esbirros donde esconderte.	
VO_ICC04_Sindragosa_Female_Dragon_Death_01	¡Rrraaaaaarrr!	
VO_ICC04_Sindragosa_Female_Dragon_EmoteResponse_01	¡Estoy harta de estos juegos!	
VO_ICC04_Sindragosa_Female_Dragon_Intro_01	¡Fuiste un idiota al venir aquí!	
VO_ICC04_Sindragosa_Female_Dragon_LichKing_01	¡Me han traicionado!	
VO_ICC04_Sindragosa_Female_Dragon_Malygos_01	Malygos... ¡mi viejo amor!	
VO_ICC04_Sindragosa_Female_Dragon_PlayerPlaysMinion_02	Elige a tus víctimas con cuidado. La fría mano de la muerte se los llevará a todos. 	
VO_ICC04_Sindragosa_Female_Dragon_SecondBreath_01	Siente el poder ilimitado de mi amo y tiembla.	
VO_ICC04_Sindragosa_Female_Dragon_Sindragosa_01	¡Nuestra magia patética nos traiciona!	
VO_ICC04_Sindragosa_Female_Dragon_Sindragosa_02	¡Nuestra magia patética nos traiciona!	
VO_ICC04_Sindragosa_Female_Dragon_TransformDK_01	¡Solo sirvo a un amo!	
VO_ICC04_Sindragosa_Female_Dragon_UnchainedMagic_02	¡Tu patética magia te traiciona!	
VO_ICC04_Sindragosa_Female_Dragon_UnchainedMagic_04	¡Sufre!	
VO_ICC05_Lanathel_Female_Sanlayn_BiteOoze_01	¿Le metiste los dientes a ESO? ¡Qué asco!	
VO_ICC05_Lanathel_Female_Sanlayn_BitePoisonous_01	No olvides escupir el veneno cuando termines.	
VO_ICC05_Lanathel_Female_Sanlayn_BiteReminder_01	¿No estás olvidando algo? ¡La sed insaciable arde en tus venas!	
VO_ICC05_Lanathel_Female_Sanlayn_BiteReminderAcolyte_01	No lo dudes. ¡Aliméntate de los letárgicos!	
VO_ICC05_Lanathel_Female_Sanlayn_BiteShell_01	No te vayas a partir un colmillo.	
VO_ICC05_Lanathel_Female_Sanlayn_BiteSpikes_01	Eso TIENE que haber dolido.	
VO_ICC05_Lanathel_Female_Sanlayn_BloodEssence_01	Somos demasiados aquí dentro.	
VO_ICC05_Lanathel_Female_Sanlayn_BloodEssence_02	No les ibas a dar ninguna utilidad, ¿verdad?	
VO_ICC05_Lanathel_Female_Sanlayn_BloodEssence_03	¿Qué te parece si cambiamos un poco las cosas?	
VO_ICC05_Lanathel_Female_Sanlayn_BloodPrince_01	¡Traición! ¡Entrega tus colmillos!	
VO_ICC05_Lanathel_Female_Sanlayn_BossBite_01	¡Conoce mi hambre!	
VO_ICC05_Lanathel_Female_Sanlayn_EmoteResponse_01	¿Estás… coqueteando conmigo?	
VO_ICC05_Lanathel_Female_Sanlayn_Intro_01	Has tomado una... decisión... imprudente	
VO_ICC05_Lanathel_Female_Sanlayn_LichKing_01	¡Tú...!	
VO_ICC05_Lanathel_Female_Sanlayn_PlayerBiteAcolyte_01	¡Ah, qué deliciosa ironía! 	
VO_ICC05_Lanathel_Female_Sanlayn_PlayerBloodBite_01	Demasiado tarde. ¡Ya estoy perdida!	
VO_ICC05_Lanathel_Female_Sanlayn_TransformDK_01	Siempre me caíste bien.	
VO_ICC05_Lanathel_Female_Sanlayn_Turn3_01	Podría alimentarme con uno de mis esbirros.	
VO_ICC05_Lanathel_Female_Sanlayn_Turn3_02	Se ven apacibles... deliciosos... ¡y parecen tan jugosos! 	
VO_ICC05_Lanathel_Female_Sanlayn_Wounded_01	¿En serio...? ¿Eso es todo?	
VO_ICC05_LichKing_Male_Human_BossBite_02	Ahh, la mordida de los San’layn.	
VO_ICC05_LichKing_Male_Human_BossBite_03	La maldición del hambre insaciable. Debes alimentarte en cada turno.	
VO_ICC05_LichKing_Male_Human_LichKing_02	Este jefe sí que muerde.	
VO_ICC05_LichKing_Male_Human_Lose_01	¿Te niegas a comerte a tus propios esbirros? ¡Estamos en Corona de Hielo! ¡No vi-ves de en-sa-la-da! 	
VO_ICC05_LichKing_Male_Human_Win_01	Lana'thel… Es una suerte que no puedas perder estrellas en tu rango.	
VO_ICC06_LichKing_Male_Human_LichKing_02	No es nada personal, Tuétano. 	
VO_ICC06_LichKing_Male_Human_Win_01	Debo crear una NUEVA amalgama de huesos. Tal vez la haga dorada.	
VO_ICC06_Marrowgar_Male_BoneWraith_Alexstraza_01	Me lamió... ¡Esa dragona me lamió!	
VO_ICC06_Marrowgar_Male_BoneWraith_AncientOne_01	¡No me arrepiento de NADA!	
VO_ICC06_Marrowgar_Male_BoneWraith_AuchenaiSoulpriest_01	Ja, ja, ahora tengo a tu sacerdotisa de alma. Espera. No. ¡Vete! ¡Fuera!	
VO_ICC06_Marrowgar_Male_BoneWraith_BigHeal_01	La muerte es eterna, implacable...	
VO_ICC06_Marrowgar_Male_BoneWraith_Bonespike_01	¡La única salida es la muerte!	
VO_ICC06_Marrowgar_Male_BoneWraith_Bonespike_02	No escaparás del amo.	
VO_ICC06_Marrowgar_Male_BoneWraith_Bonespike_03	La carne y los tendones huyen a mis caricias.	
VO_ICC06_Marrowgar_Male_BoneWraith_Bonespike_04	Es hora de cosechar.	
VO_ICC06_Marrowgar_Male_BoneWraith_Bonespike_05	Tan peligroso. ¡Tan encantador!	
VO_ICC06_Marrowgar_Male_BoneWraith_BonespikePlayerHit_01	¡La rabia del amo fluye dentro de mí!	
VO_ICC06_Marrowgar_Male_BoneWraith_BonespikeStolen_01	Tú... ¡robahuesos!	
VO_ICC06_Marrowgar_Male_BoneWraith_Bonestorm_01	¡Tormenta ósea!	
VO_ICC06_Marrowgar_Male_BoneWraith_Bonestorm_02	¡Tooormenta ósea!	
VO_ICC06_Marrowgar_Male_BoneWraith_Bonestorm_03	¡Tormenta óseaaaaa!	
VO_ICC06_Marrowgar_Male_BoneWraith_Bonestorm_04	¡TORMENTA ÓSEA!	
VO_ICC06_Marrowgar_Male_BoneWraith_Bonestorm_05	¡TOORMENTA ÓÓÓSEA!	
VO_ICC06_Marrowgar_Male_BoneWraith_BonestormFast_01	Tormenta ósea.	
VO_ICC06_Marrowgar_Male_BoneWraith_Death_01	Cenizas a las cenizas...	
VO_ICC06_Marrowgar_Male_BoneWraith_DKTransform_01	Sí. Acepta tu destino, ¡oye el llamado del amo!	
VO_ICC06_Marrowgar_Male_BoneWraith_EmoteResponse_01	¡Idiota, no tengo oídos!	
VO_ICC06_Marrowgar_Male_BoneWraith_Idle_01	Mmm…	
VO_ICC06_Marrowgar_Male_BoneWraith_Intro_01	¡Nadie entrará en el sagrario del amo! 	
VO_ICC06_Marrowgar_Male_BoneWraith_LichKing_01	¿Amo...?	
VO_ICC06_Marrowgar_Male_BoneWraith_Skeleton_01	¿Qué cuentas, mi huesudo amiguito?	
VO_ICC07_LichKing_Male_Human_LichKing_02	Soy un tipo muy proactivo.	
VO_ICC07_LichKing_Male_Human_Lose_01	Putricidio, tu mazo da asco. Te he subestimado.	
VO_ICC07_LichKing_Male_Human_Win_02	Patético, Putricidio. Encajarías mejor en un mazo de Cazador. Lárgate de mi ciudadela.	
VO_ICC07_Putricide_Male_Undead_Aviana_01	¡Tu ciencia es mejor que mi ciencia!	
VO_ICC07_Putricide_Male_Undead_CloakedHuntress_01	Bueno, eso parece superfluo. 	
VO_ICC07_Putricide_Male_Undead_Death_01	Malas noticias, amigos...	
VO_ICC07_Putricide_Male_Undead_EaglehornBow_01	¿Cómo consigo uno de esos?	
VO_ICC07_Putricide_Male_Undead_EaterOfSecrets_01	¡No! ¡Mis secretos! ¡El trabajo de mi vida!	
VO_ICC07_Putricide_Male_Undead_EmoteResponse_01	Eso no es nada amable.	
VO_ICC07_Putricide_Male_Undead_EquipWeapon_01	Oh, vaya.	
VO_ICC07_Putricide_Male_Undead_EquipWeapon_02	Ni siquiera sabía que TENÍA una de estas.	
VO_ICC07_Putricide_Male_Undead_EquipWeapon_03	Sí, eso servirá.	
VO_ICC07_Putricide_Male_Undead_EquipWeapon_04	¿Y eso de dónde salió?	
VO_ICC07_Putricide_Male_Undead_EquipWeapon_05	Tan peligroso. ¡Tan encantador!	
VO_ICC07_Putricide_Male_Undead_EtherealArcanist_01	Nunca confíes en un etéreo. ¡No puedes verles el rostro!	
VO_ICC07_Putricide_Male_Undead_FestergutDeath_01	Oh, Panzachancro, siempre fuiste mi favorito... después de Carapútrea.	
VO_ICC07_Putricide_Male_Undead_Intro_02	¡Buenas noticias, amigos! He arreglado las tuberías de babosas venenosas.	
VO_ICC07_Putricide_Male_Undead_LichKing_01	Oh, no esperaba verlo aquí.	
VO_ICC07_Putricide_Male_Undead_MysteriousChallenger_01	¡Nadie es más misterioso que yo!	
VO_ICC07_Putricide_Male_Undead_Ooze_01	¡Oooh, moco!	
VO_ICC07_Putricide_Male_Undead_PhaseTransition_01	¡Tentáculos! Oh, vaya. Parece que tienen mente propia, ¿no?	
VO_ICC07_Putricide_Male_Undead_PhaseTransition_03	Mmmm, interesante.	
VO_ICC07_Putricide_Male_Undead_Putricide_02	¿Qué? ¡Allí está ese tipo que soy yo!	
VO_ICC07_Putricide_Male_Undead_Putricide_03	Buenas noticias... ¡yo!	
VO_ICC07_Putricide_Male_Undead_Putricide_04	¡Esas no son buenas noticias, doble tentaculoso! 	
VO_ICC07_Putricide_Male_Undead_Rotface_01	¡Carapútrea! ¡¿Cómo pudiste?!	
VO_ICC07_Putricide_Male_Undead_RotfaceDeath_01	¡Carapútrea! ¡No! ¿Qué te ha hecho él?	
VO_ICC07_Putricide_Male_Undead_Scientist_01	¿Estuviste reclutando a mi personal?	
VO_ICC07_Putricide_Male_Undead_Slime_01	¡Buenas noticias, amigos! ¡La baba ha vuelto a fluir!	
VO_ICC07_Putricide_Male_Undead_TentaclesForArms_01	Esa sí que es un arma con estilo.	
VO_ICC07_Putricide_Male_Undead_TransformDK_01	¿Quééé? ¿Te hiciste algo en el pelo?	
VO_ICC07_Rotface_Male_Abomination_Rotface_02	Carapútrea tiene NECESIDADES.	
VO_ICC08_Anduin_Male_Human_Muted_02	¡Mmm!	
VO_ICC08_Anduin_Male_Human_Muted_03	Mmm.	
VO_ICC08_Anduin_Male_Human_Muted_06	¡¡Mmmmmmm…!!	
VO_ICC08_Anduin_Male_Human_Muted_07	¡¡Mmmmmmm!!	
VO_ICC08_Anduin_Male_Human_Muted_11	¿Mmm?	
VO_ICC08_Anduin_Male_Human_Muted_13	Mmm...	
VO_ICC08_Anduin_Male_Human_WinA_01	Siempre debe haber...	
VO_ICC08_Anduin_Male_Human_WinB_01	¡un Rey Exánime!	
VO_ICC08_Garrosh_Male_Orc_WinA_01	Siempre debe haber...	
VO_ICC08_Garrosh_Male_Orc_WinB_01	¡un Rey Exánime!	
VO_ICC08_Guldan_Male_Orc_WinA_01	Siempre debe haber...	
VO_ICC08_Guldan_Male_Orc_WinB_01	¡un Rey Exánime!	
VO_ICC08_Jaina_Female_Human_WinA_01	Siempre debe haber...	
VO_ICC08_Jaina_Female_Human_WinB_01	¡un Rey Exánime!	
VO_ICC08_LichKing_Male_Human_Archmage Antonidas_01	Ya te derroté una vez, anciano. Y lo haré una vez más.	
VO_ICC08_LichKing_Male_Human_Arfas_01	¡Perro malo!	
VO_ICC08_LichKing_Male_Human_Bolvar_01	Quebrar a este ha sido agotador.	
VO_ICC08_LichKing_Male_Human_Death_01	La oscuridad... es todo lo que veo...	
VO_ICC08_LichKing_Male_Human_DeathPunisher_01	Era obvio. No tienes honor. 	
VO_ICC08_LichKing_Male_Human_EmoteResponse_01	¡A mí nadie me da órdenes!	
VO_ICC08_LichKing_Male_Human_EndOfTurn4_01	No importa qué carta juegues. Mi triunfo es inevitable.	
VO_ICC08_LichKing_Male_Human_Frostmourne_01	Agonía de Escarcha está hambrienta…	
VO_ICC08_LichKing_Male_Human_Frostmourne_02	Agonía de Escarcha está hambrienta… ¿Tú quieres algo?	
VO_ICC08_LichKing_Male_Human_Frostmourne_07	Contempla el poder de Agonía de Escarcha.	
VO_ICC08_LichKing_Male_Human_GenericStart_03	Primero destruiré tu mazo y después... TU ALMA.	
VO_ICC08_LichKing_Male_Human_Horsemen_01	Ruega que no consiga a los cuatro juntos. ¡Ruega!	
VO_ICC08_LichKing_Male_Human_Hunter_01	El cazador solitario. No eres nada sin tus pequeñas mascotas, ¿eh?	
VO_ICC08_LichKing_Male_Human_Illidan_01	El trono helado me pertenece, demonio. Hazte a un lado.	
VO_ICC08_LichKing_Male_Human_IndestructableWeapon_01	Simplemente patético.	
VO_ICC08_LichKing_Male_Human_Intro_01	Tu sufrimiento será legendario. Tu rango, no.	
VO_ICC08_LichKing_Male_Human_Intro_02	Al final, todos se arrodillarán ante mí.	
VO_ICC08_LichKing_Male_Human_Intro_03	¿Te atreves a llamar mazo a esa pila de cartas inservibles?	
VO_ICC08_LichKing_Male_Human_Intro_04	Soy el principio y el final... SOY EL NUEVO META.	
VO_ICC08_LichKing_Male_Human_Intro_06	¿Crees que tendré piedad con los de tu clase?	
VO_ICC08_LichKing_Male_Human_Intro_07	¿Ese es tu mazo? Parece que está suplicando ayuda.	
VO_ICC08_LichKing_Male_Human_Intro_08	Tus gritos de agonía serán el testimonio de la paliza legendaria que sufrirás.	
VO_ICC08_LichKing_Male_Human_Intro_09	Me pregunto si realmente es el honor\nlo que te impulsa a actuar.	
VO_ICC08_LichKing_Male_Human_Kelthuzad_01	¡Kel’thuzad! ¡Te has confundido de aventura!	
VO_ICC08_LichKing_Male_Human_Lanathel_01	Tu traición no me sorprende, Lana’thel.	
VO_ICC08_LichKing_Male_Human_LichKing_01	Hola, guapetón.	
VO_ICC08_LichKing_Male_Human_LichKing_02	Sí que luzco fantástico.	
VO_ICC08_LichKing_Male_Human_LichKingMuted_01	Un momento, no pue...	
VO_ICC08_LichKing_Male_Human_LichKingMutedResponse_01	¡Mmm!	
VO_ICC08_LichKing_Male_Human_LichKingMutedResponse_02	¡Mppmph Mmmphm!	
VO_ICC08_LichKing_Male_Human_LichKingMutedResponse_03	¡MphMPH!	
VO_ICC08_LichKing_Male_Human_LichKingMutedResponse_04	Mpphmmm…	
VO_ICC08_LichKing_Male_Human_LilLich_01	Me... me encanta.	
VO_ICC08_LichKing_Male_Human_Lose_03	Únete a la oscuridad...	
VO_ICC08_LichKing_Male_Human_Mage_01	¡Magos ineptos! ¡Solo yo controlo la brisa gélida de la muerte! 	
VO_ICC08_LichKing_Male_Human_MageSpellReflect_01	Eso tiene que ser un error que no detectaron en QA.	
VO_ICC08_LichKing_Male_Human_MageSpellReflect_02	Pff... ¿Alguien me puede decir quién hace el control de calidad de este juego?	
VO_ICC08_LichKing_Male_Human_Mograine_01	¡Mograine! Un momento... ¿tú eras de los buenos o de los malos?	
VO_ICC08_LichKing_Male_Human_MutedResponse_01	¡Silencio!	
VO_ICC08_LichKing_Male_Human_MutedResponse_02	¡Shhh!	
VO_ICC08_LichKing_Male_Human_MutedResponse_03	¡¡Shhhhh!!	
VO_ICC08_LichKing_Male_Human_MutedResponse_04	Cierra la boca.	
VO_ICC08_LichKing_Male_Human_MutedResponse_05	Ya cállate.	
VO_ICC08_LichKing_Male_Human_MutedResponse_06	Cállateeee.	
VO_ICC08_LichKing_Male_Human_Paladin_01	La Luz no llega hasta aquí, paladín. No hay nada que pueda protegerte...	
VO_ICC08_LichKing_Male_Human_Phase03_01	Enfrenta tu trágico final.	
VO_ICC08_LichKing_Male_Human_PhaseTransition_02	¿Quién estuvo jugando con mi arma? 	
VO_ICC08_LichKing_Male_Human_PowerReplace_01	¿De verdad creíste que sería tan fácil contrarrestar mi poder?	
VO_ICC08_LichKing_Male_Human_Priest_01	¡Silencio, sacerdote! La Luz no podrá oírte cuando implores piedad a gritos.	
VO_ICC08_LichKing_Male_Human_Putricide_01	Nunca me caíste bien.	
VO_ICC08_LichKing_Male_Human_Rogue_01	Ya deja de esconderte, pícaro. ¿Qué sería de ti sin tus trucos?	
VO_ICC08_LichKing_Male_Human_Shaman_01	¡Mi poder hace temblar a tus esbirros, chamán!	
VO_ICC08_LichKing_Male_Human_Sindragosa_01	¡Esa era MI carta letal! ¡Devuélvemela!	
VO_ICC08_LichKing_Male_Human_Sylvanas_01	Con todo lo que me has hecho pasar, la última cosa que te daré será la paz de la muerte. 	
VO_ICC08_LichKing_Male_Human_Tirion_01	Te mantendré con vida para que seas testigo del final, Vadín.	
VO_ICC08_LichKing_Male_Human_TransformDK_01	Sí... Ríndete ante tu nuevo poder… Ya he ganado…	
VO_ICC08_LichKing_Male_Human_Turn6_01	Ese fue tu peor turno hasta ahora. Y eso que has tenido algunos bastante patéticos.	
VO_ICC08_LichKing_Male_Human_Turn6_03	Tu forma de jugar me recuerda a mi padre. Era un cobarde. 	
VO_ICC08_LichKing_Male_Human_Turn6_04	¿Cómo haces para mezclar tus cartas sin sentir vergüenza?	
VO_ICC08_LichKing_Male_Human_Turn6_05	Cada carta que juegas te acerca más al olvido.	
VO_ICC08_LichKing_Male_Human_Turn6_06	Tu muerte es inevitable. No hay emoción que exprese la pena que me das.	
VO_ICC08_LichKing_Male_Human_Turn6_07	¿Quién te armó ese mazo? ¿Tu mami? 	
VO_ICC08_LichKing_Male_Human_Turn6_08	Aahh, ¿creyeron que te enfrentarías a Hogger?	
VO_ICC08_LichKing_Male_Human_Warlock_01	Brujo, tu mano da pena. Los terrores que tienes a tu mando pronto me servirán a MÍ.	
VO_ICC08_LichKing_Male_Human_Warrior_01	Ah, guerrero. Serás un excelente Caballero de la muerte. Pero primero, debo asesinarte.	
VO_ICC08_LichKing_Male_Human_Wounded_01	Se disipa la esperanza…	
VO_ICC08_LichKing_Male_Human_Wounded_02	Imposible… ¡IMPOSIBLE!	
VO_ICC08_LichKing_Male_Human_YoungArthas_01	¿Qué es esto? ¿Una dramatización de mis luchas internas?	
VO_ICC08_Malfurion_Male_NightElf_WinA_01	Siempre debe haber...	
VO_ICC08_Malfurion_Male_NightElf_WinB_01	¡un Rey Exánime!	
VO_ICC08_Rexxar_Male_Orc_WinA_01	Siempre debe haber...	
VO_ICC08_Rexxar_Male_Orc_WinB_01	¡un Rey Exánime!	
VO_ICC08_Thrall_Male_Orc_WinA_01	Siempre debe haber...	
VO_ICC08_Thrall_Male_Orc_WinB_01	¡un Rey Exánime!	
VO_ICC08_Tirion_Male_Human_Win_01	¡Lo lograste, adalid!	
VO_ICC08_Tirion_Male_Human_Win_02	Sin el dominio de su amo, la Plaga se convertirá en una amenaza incluso mayor para este mundo.	
VO_ICC08_Uther_Male_Human_WinA_01	Siempre debe haber...	
VO_ICC08_Uther_Male_Human_WinB_01	¡un Rey Exánime!	
VO_ICC08_Valeera_Female_Human_WinA_01	Siempre debe haber...	
VO_ICC08_Valeera_Female_Human_WinB_01	¡un Rey Exánime!	
VO_ICC09_LichKing_Male_Human_LichKing_02	No te preocupes, no puedo atacarte.	
VO_ICC09_LichKing_Male_Human_Lose_01	Trajiste el arma incorrecta a una pelea de cuchillos.	
VO_ICC09_LichKing_Male_Human_Win_01	¡Ey, esa era mi legendaria preferida! Ahora tendré que convertirla en polvo y crear una mejor.	
VO_ICC09_Saurfang_Male_Orc_AttackedByPlayer_01	¡Muéstrame lo que tienes!	
VO_ICC09_Saurfang_Male_Orc_AttacksPlayer_01	¡Enfréntate al poder de la Plaga!	
VO_ICC09_Saurfang_Male_Orc_AttacksPlayer_02	¡Ahora soy la muerte!	
VO_ICC09_Saurfang_Male_Orc_AttacksPlayer_03	El Rey Exánime reclama a todos.	
VO_ICC09_Saurfang_Male_Orc_AttacksPlayer_04	¡Pelea! ¡Muere! Tu destino está sellado.	
VO_ICC09_Saurfang_Male_Orc_BloodBeast_01	¡Dense un festín, mis lacayos!	
VO_ICC09_Saurfang_Male_Orc_BloodBeast_02	Devórenlos...	
VO_ICC09_Saurfang_Male_Orc_BloodBeast_03	Mi poder no deja de aumentar.	
VO_ICC09_Saurfang_Male_Orc_BloodBeast_04	¡Mi ira toma forma!	
VO_ICC09_Saurfang_Male_Orc_BloodBeastStolen_01	Llévatela. Nunca te quitarás el hedor de la ropa.	
VO_ICC09_Saurfang_Male_Orc_CursedBlade_01	¿De quién fue esta idea?	
VO_ICC09_Saurfang_Male_Orc_Death_01	Soy... libre...	
VO_ICC09_Saurfang_Male_Orc_DKTransform_01	¡Al fin! ¡Un oponente digno!	
VO_ICC09_Saurfang_Male_Orc_Doomerang_01	Mmm... tengo que conseguirme uno de esos...	
VO_ICC09_Saurfang_Male_Orc_EmoteResponse_01	Cobarde sin agallas.	
VO_ICC09_Saurfang_Male_Orc_EquipWeapon_01	¡Por el poder del Rey Exánime!	
VO_ICC09_Saurfang_Male_Orc_EquipWeapon_02	Impresionante.	
VO_ICC09_Saurfang_Male_Orc_Intro_01	¡Ven y enfréntate al poder de la Plaga!	
VO_ICC09_Saurfang_Male_Orc_LichKing_01	¿Qué haces TÚ aquí?	
VO_ICC09_Saurfang_Male_Orc_WeaponDestroyed_01	¡Aaarrrggg!	
VO_ICC10_Deathwhisper_Female_Lich_DamageByValithria_01	Arg...	
VO_ICC10_Deathwhisper_Female_Lich_Death_01	¡Imposible…!	
VO_ICC10_Deathwhisper_Female_Lich_DKTransform_01	¡Ah! Tú también has probado el poder del amo…	
VO_ICC10_Deathwhisper_Female_Lich_EmoteResponse_01	Ohh, ¿me estás amenazando?	
VO_ICC10_Deathwhisper_Female_Lich_Equality_01	Esa idea no es tan buena como crees.	
VO_ICC10_Deathwhisper_Female_Lich_HeroPower_01	Los seres vivos son tan frágiles…	
VO_ICC10_Deathwhisper_Female_Lich_HeroPower_02	Tu carne es tu maldición...	
VO_ICC10_Deathwhisper_Female_Lich_HeroPower_03	¿No te das cuenta de la insignificancia de tus acciones?	
VO_ICC10_Deathwhisper_Female_Lich_HeroPower_04	La oscuridad te somete…	
VO_ICC10_Deathwhisper_Female_Lich_HeroPowerInitial_01	La muerte te espera…	
VO_ICC10_Deathwhisper_Female_Lich_Intro_01	¿Qué es este disturbio? Mi trabajo aún no ha terminado.	
VO_ICC10_Deathwhisper_Female_Lich_LichKing_01	Amo, yo... se lo ruego, ¡los estoy acabando tan rápido como puedo!	
VO_ICC10_Deathwhisper_Female_Lich_PlayerPlaysEnrage_01	¡Tus esbirros saborearán el castigo!	
VO_ICC10_Deathwhisper_Female_Lich_StoneskinGargoyle_01	¿Qué? ¡No sabía que se podía jugar cartas del modo Salvaje aquí!	
VO_ICC10_Deathwhisper_Female_Lich_ValithriaBlessedChampion_01	¡Quita tus manos de ahí, paladín!	
VO_ICC10_Deathwhisper_Female_Lich_ValithriaDivineShield_01	¡Ya quita tus manos de la dragona!	
VO_ICC10_Deathwhisper_Female_Lich_ValithriaResurrect_01	Este juego es una pesadilla.	
VO_ICC10_Deathwhisper_Female_Lich_ValithriaTaunt_01	Ah, ya no tolero a esa dragona.	
VO_ICC10_Deathwhisper_Female_Lich_ValithriaWindfury_01	Qué desagradable.	
VO_ICC10_LichKing_Male_Human_DamageByValithria_02	¡Esa dragona echará a perder todo lo que hemos logrado! ¡Susurramuerte, acaba con ese monstruo!	
VO_ICC10_LichKing_Male_Human_Lose_01	Una vez más. ¡Con sanación!	
VO_ICC10_LichKing_Male_Human_Turn2_01	¡Susurramuerte! Te dije que acabaras con esa dragona.	
VO_ICC10_LichKing_Male_Human_Turn2_02	Para ser la líder de un culto de la muerte, estás tardando demasiado.	
VO_ICC10_LichKing_Male_Human_Win_01	Tu mazo me ha fallado, Susurramuerte. Tú único consuelo es que tu derrota fue rápida.	
VO_ICC10_LichKing_Male_Human_Wounded_01	Ya deja de jugar y termina con esto de una vez, Susurramuerte.	
VO_ICC10_LichKing_Male_Human_Wounded_02	¡¿Se puede saber por qué no tienes Deflagración arcana en tu mazo?!	
VO_ICCA08_033_Male_HumanGhost_Flavor_01	Ayúdanos...	
VO_ICCA08_033_Male_HumanGhost_Flavor_02	Sálvanos...	
VO_ICCA08_033_Male_HumanGhost_Flavor_03	No hay escapatoria...	
VO_ICCA08_033_Male_HumanGhost_Flavor_04	Quizás haya una escapatoria...	
VO_ICCA08_033_Male_HumanGhost_Flavor_05	¡Shhh...!	
VO_ICCA10_001_Female_GreenDragon_Healed_01	¡Estoy... renovada! 	
VO_ICCA10_001_Female_GreenDragon_Start_01	Ayúdame, adalid... No puedo... rendirme...	
VO_Illhoof_Male_Demon_IlhoofKilrek_01	Vamos, Kil'rek. ¡Debemos terminar con la invocación!	
VO_Illhoof_Male_Demon_IllhoofDeath_02	¡No! ¡Tan cerca! Sargar...	
VO_Illhoof_Male_Demon_IllhoofEmoteResponse_01	¡Tu esencia alimenta el ritual!	
VO_Illhoof_Male_Demon_IllhoofOpen_01	¡Ah, justo a tiempo!	
VO_Illhoof_Male_Demon_IllhoofSummonImps_01	¡A mí, habitantes de la oscuridad! ¡Reúnanse a mi llamada!	
VO_Illhoof_Male_Demon_IllhoofSummoningPortal_01	¿Un portal sin un ritual? Eso parece mucho más fácil...	
VO_Illhoof_Male_Demon_IllhoofTurn1_01	¡El ritual comienza ahora!	
VO_Illhoof_Male_Demon_IllhoofWounded_01	Vengan, mascotas mías. ¡Debemos terminar el ritual!	
VO_INNKEEPER_Male_Dwarf_HSNewYearBrawl_02	El año del cuervo es un poco más... espeluznante que otros.	
VO_INNKEEPER_Male_Dwarf_HSNewYearBrawl_03	¡Mira! ¡Parece que ha llegado un heraldo del año del cuervo!	
VO_INNKEEPER_Male_Dwarf_HSNewYearBrawl_05	En el año del cuervo pueden verse algunas transformaciones oscuras.	
VO_INNKEEPER_Male_Dwarf_HSNewYearBrawl_08	Las bestias ocultas en las sombras son más audaces...	
VO_INNKEEPER_Male_Dwarf_HSNewYearBrawl_09	Las criaturas de la oscuridad salen a jugar...	
VO_INNKEEPER_Male_Dwarf_HSNewYearBrawl_10	Los monstruos del pantano se alejan de su entorno...	
VO_Jaraxxus_Male_Demon_FinalMalchezaarJaraxxus_01	Príncipe tonto. ¡Practica karaoke como Jaraxxus!	
VO_Jaraxxus_Male_Demon_FinalMalchezaarJaraxxus_02	¡Ya está aquí\nte busca a ti\nLa Liga de Expedicionarios!	
VO_Julianne_Female_Human_JulianneDeath_01	¡Rómulo! Bebo esto por ti...	
VO_Julianne_Female_Human_JulianneEmoteResponse_01	¿Os mordéis el pulgar para afrentarnos?	
VO_Julianne_Female_Human_JulianneFeignDeath_03	Y al vencerse, despertaré como de un sueño agradable...	
VO_Julianne_Female_Human_JulianneHeroPower_01	Adelante, gentil noche, ¡devuélveme a mi Rómulo!	
VO_Julianne_Female_Human_JulianneOpen_01	¿Qué demoníaca presencia es esta que veo ante mí?	
VO_KAR03_MOROES_MALE_HUMAN_CHESS_TURN_1	Ah, ya lo recuerdo. Las piezas atacarán automáticamente al final de su turno.	
VO_KAR03_MOROES_MALE_HUMAN_CHESS_TURN_3	Si una pieza está entre dos enemigos, ¡los atacará a los dos!	
VO_KAR03_MOROES_MALE_HUMAN_CHESS_TURN_5	La buena ubicación es la clave del ajedrez. ¡Aproveche los ataques dobles!	
VO_KARA_04_01_Female_Human_CroneHuffer_01	Oh, Bufar. Creo que no nos encontramos en Páramos de Poniente...	
VO_KARA_04_01_Female_Human_CroneLionTigerBear_02	¡Oh! ¡Leones, dragones y osos! ¡Qué miedo!	
VO_KARA_04_01_Female_Human_CroneTurn1_01	Oh, no, ¡no dejes que me lastime!	
VO_KARA_04_01_Female_Human_CroneTurn3_01	¡Vengan, todos de la mano! ¡Juntos somos más fuertes!	
VO_KARA_06_01_Male_Human_JulianneDeadlyPoison_02	Ah, una dosis de veneno.	
VO_KARA_06_01_Male_Human_JulianneTurn1_01	¿Me provocas? Entonces, ¡defiéndete!	
VO_KT_ANTI_CHEESE1_65	¡Esto es Naxxramas heroico! ¡No toleraré tácticas cobardes aquí!	
VO_KT_ANTI_CHEESE2_66	Orador del sino... Te crees muy inteligente.	
VO_KT_ANTI_CHEESE3_67	¿Igualdad? ¡No durante mi guardia!	
VO_KT_ANUB2_43	¡NOOO! Bah... Irrelevante. Jamás derrotarás a la Gran Viuda.	
VO_KT_BARON2_64	¡El Arrabal Militar me ha fallado! Es tan difícil conseguir buenos ayudantes en estos días.	
VO_KT_FAERLINA2_45	Faerlina no es nadie. La Reina Araña te hará desaparecer en un segundo.	
VO_KT_GLUTH2_73	Les pregunté a los zombis si querían comer tu cerebro y dijeron: "No consumo comida chatarra".	
VO_KT_GLUTH2_ALT_74	Obtienes un logro por perder contra Gluth. Estoy casi seguro.	
VO_KT_GLUTH3_75	JAJAJA. ¡NO OBTIENES NINGÚN LOGRO POR PERDER CONTRA GLUTH!	
VO_KT_GLUTH4_76	¡No! ¿Y ahora quién comerá estas sobras de zombis?	
VO_KT_GLUTH5_77	Exterminar es lo que más amo hacer en la vida. No, espera, congelarte la sangre en las venas es mi favorito.	
VO_KT_GLUTH6_78	¡Buen perro! ¡Qué buen perrito!	
VO_KT_GOTHIK2_62	¿Por qué Gothik no vuelve como un Gothik espectral? ¡Por favor!	
VO_KT_GROBBULUS2_71	A dibujar otra vez...	
VO_KT_HEIGAN2_55	Estoy ardiendo de ira. ARDIENDO.	
VO_KT_LOATHEB2_57	Sigues MATANDO A MIS ESBIRROS. ¡Detente! ¡Detente ahora mismo!	
VO_KT_MAEXXNA2_47	Su veneno hará que tu muerte sea *casi* indolora.	
VO_KT_MAEXXNA3_48	¿Gigante de mar? Maexxna, ¡esa no está en mi lista de cartas aprobadas!	
VO_KT_MAEXXNA4_49	¡Imposible! ¡Esto no ha terminado, INSIGNIFICANTE MORTAL!	
VO_KT_MAEXXNA6_51	¿Cómo se llama a un jugador que tiene a su esbirro atrapado en una telaraña? ¡MUERTO!	
VO_KT_NOTH2_53	Pobre Noth. 'Noth'e olvides de él.	
VO_KT_PATCHWERK2_69	¡Mi encarnación de la guerra! Debí usar mejores jugadores para coserlo...	
VO_KT_RAZUVIOUS2_59	¿Quién entrenará a mis Caballeros de la Muerte ahora? Yo no puedo, mi agenda está completa.	
VO_KT_SAPPHIRON2_84	Mira a ese pequeño gnomo. Antes era un intruso... COMO TÚ.	
VO_KT_SAPPHIRON3_85	¡Deja de esconderte tras ese bloque de hielo!	
VO_KT_SAPPHIRON4_ALT_87	Sapphiron, ejecuta el plan: "CONGELAR SANGRE EN LAS VENAS".	
VO_KT_SAPPHIRON5_88	¡Mi dragón! NO ME AGRADAS.	
VO_KT_THADDIUS2_81	¡Intruso! ¡Esta es la gota que rebalsó el vaso!	
VO_LichKing_Male_Human_Brawl_01	Purgaré esta taberna inmunda...	
VO_LichKing_Male_Human_Brawl_03	Imbéciles, no importa cuántos sean. Prevaleceré.	
VO_LichKing_Male_Human_Brawl_05	Te desafío a ver mis puntos de salud y no entrar en pánico.	
VO_LichKing_Male_Human_ExpansionIntro_02	¡Corona de Hielo! Ven a buscar un poder increíble. Y quédate porque estás muerto.	
VO_LichKing_Male_Human_FinaleFirstVictory_01	Imposible... Imposible... ¿Qué dices? ¿Al mejor de nueve?	
VO_LichKing_Male_Human_FinaleLock_01	¡No me derrotarás JAMÁS! Al menos, no mientras esta ala esté bloqueada.	
VO_LichKing_Male_Human_FinaleUnlock_03	¿Debería dejar la Agonía de Escarcha y someterme a tu piedad? ¿Adivina qué? NO.	
VO_LichKing_Male_Human_LowerCitadelUnlock_01	¡Ciudadela de la Corona de Hielo! Una colección de mis esbirros más abominables. No están imbuidos de magia... sino de ODIO.	
VO_LichKing_Male_Human_PrologueBossCoin_01	¡Ven, adalid! Te aniquilaré y te convertiré en polvo arcano.	
VO_LichKing_Male_Human_PrologueBossCoin_02	Construí esta horripilante amalgama de huesos con los cadáveres de mis cartas duplicadas. 	
VO_LichKing_Male_Human_PrologueBossCoin_03	Libramorte Colmillosauro fue mi primer esbirro legendario. Diseñé toda esta aventura en torno a él.	
VO_LichKing_Male_Human_PrologueBossCoin_04	Ella es Lady Susurramuerte. ¡Antes de que la despotenciaran!	
VO_LichKing_Male_Human_PrologueBossCoin_05	El Profesor Putricidio es mi fuente principal de robo de cartas, pero todo lo que roba es gas. No me agrada para nada.	
VO_LichKing_Male_Human_PrologueBossCoin_07	¡Lana’thel! ¿Por qué hay marcas de COLMILLOS en mis CARTAS? ¡Te dije que les pusieras una FUNDA! 	
VO_LichKing_Male_Human_PrologueBossCoin_08	¡Sindragosa es mi asesina letal! ¡Aléjate! ¡No te la daré!	
VO_LichKing_Male_Human_PrologueBossCoin_09	Suplicarás clemencia. Presionarás el botón "rendirse" y te lo negaré.	
VO_LichKing_Male_Human_PrologueBossCoin_11	Observa tu mano, adalid. Mira en qué te has convertido. ¿Todavía crees que somos tan diferentes? 	
VO_LichKing_Male_Human_PrologueBossCoin_12	Aquí estoy, el lobo ante los corderos... y no me temen.	
VO_LichKing_Male_Human_ResponseAnubaArak_01	¡Sírveme, Anub’arak!	
VO_LichKing_Male_Human_ResponseMalganis_01	Mal'Ganis, ¿cuántas veces tengo que derrotarte?	
VO_LichKing_Male_Human_UpperReachesLock_01	¿Intentas usar mi propio poder para derrotarme? Espera mientras busco un mazo en la red para sumergir este mundo en la oscuridad.	
VO_LichKing_Male_Human_UpperReachesUnlock_01	¿Intentas usar mi propio poder para derrotarme? ¿Sabes cuántas veces obtuve el rango Leyenda?	
VO_LOE_01_DEATH_2	¡Orsis! ¡Venga mi muerte!	
VO_LOE_01_RESPONSE	¡Siente la cólera del sol!	
VO_LOE_01_STAFF	¡Ja! ¡Es mía!	
VO_LOE_01_STAFF_2	¡Arderás! 	
VO_LOE_01_STAFF_2_RENO	Te recomiendo no soltar esa vara. Es muy valiosa.	
VO_LOE_01_START	¡Soy INVENCIBLE!	
VO_LOE_01_WIN	¡Ja, ja! ¡La vara es mía! ¡Cómo me gustaría que Harrison estuviera aquí! 	
VO_LOE_01_WIN_2	¡Toma esa vara!	
VO_LOE_01_WIN_2_ALT_2	¿Es normal que el suelo tiemble tanto?	
VO_LOE_01_WOUNDED	¡Lo tengo arrinconado! ¡Acaba con él!	
VO_LOE_02_DEATH	Noooo, ¡no quiero volver a la lámpara!	
VO_LOE_02_INTRO	¡La vara del sol es MÍA!	
VO_LOE_02_MORE_WISHES	Guau, no puedo creer que haya funcionado.	
VO_LOE_02_PHAERIX_STAFF_RECOVER	¡No puedes comprender los poderes de la vara!	
VO_LOE_02_RESPONSE	¡Poder cósmico fenomenal!	
VO_LOE_02_START	¡Libre al fin! ¡Tu recompensa será una muerte rauda!	
VO_LOE_02_START2	¡Aventurero! Soy Reno Jackson, arqueólogo, explorador y cazador de tesoros de fama mundial. 	
VO_LOE_02_START3	Con el autocontrol de una urraca.	
VO_LOE_02_TURN_10	¡Piénsalo, explorador! La vara del sol. ¡Vale millones!	
VO_LOE_02_TURN_6	¿Ya te conté sobre la vez que me infiltré de incógnito entre los ogros de La Masacre?	
VO_LOE_02_TURN_6_2	¿Y sobre esa vez que me colé en el Lyceum de Roca Negra para conseguir...?	
VO_LOE_02_WIN	¡Adelante, mi valiente! ¡La vara descansa en aquella sala!	
VO_LOE_02_WISH	Es muy amable de su parte concedernos deseos mientras intenta matarnos.	
VO_LOE_03_RESPONSE	¡Apúrate!	
VO_LOE_03_TURN_1	¡El techo colapsa y hay monstruos por todas partes! ¡Apresúrate!	
VO_LOE_03_TURN_10	¡Ya casi llegamos! ¡Veo el sol!	
VO_LOE_03_TURN_2	Vaya, vaya: una poza brillante. ¿Quieres echarle un vistazo?	
VO_LOE_03_TURN_2_2	¡No tienes tiempo para eso!	
VO_LOE_03_TURN_3	Mmm... Veamos... ¿Izquierda o derecha?  	
VO_LOE_03_TURN_3_BOULDER	¡Esa roca es enorme! ¡Muévete!	
VO_LOE_03_TURN_3_WARNING	Oh oh, el estruendo es cada vez más fuerte. ¡Apuesto a que el próximo turno colapsará todo el techo!	
VO_LOE_03_TURN_4	¡Mira, una trampa de púas!	
VO_LOE_03_TURN_4_BAD	¡Oh jo jo jo! Eso no me pareció nada divertido.	
VO_LOE_03_TURN_4_GOOD	¡Ey, bravo! Casi tan bien como yo.	
VO_LOE_03_TURN_4_NEITHER	A ver, te estás arrastrando por las púas... ¿Podrías apurarte?	
VO_LOE_03_TURN_5	Ey, qué linda estatua. Y mira cómo brilla ese rubí...	
VO_LOE_03_TURN_5_4	Oh-oh, no parece muy contento. ¡Creo que quiere su gema de vuelta!	
VO_LOE_03_TURN_6	¡Cuidado! ¡El techo se derrumba!	
VO_LOE_03_TURN_6_2	¡Uoo! ¡Estuvo cerca! Me alegra haber podido ayudarte. No me lo agradezcas.	
VO_LOE_03_TURN_7	Mmm, esto está muy oscuro, pero por aquí saldremos más rápido. ¡Vamos!	
VO_LOE_03_TURN_7_2	En mi mapa solo dice "NO PISAR ESTE LUGAR".	
VO_LOE_03_TURN_8	¡Uf! Cada vez hace más calor. ¡Tenemos que apurarnos!	
VO_LOE_03_TURN_9	Ufff... ¿por qué siempre insectos? ¡Los odio!	
VO_LOE_03_WIN	¡Uff! ¡Lo logramos! Nunca creí que estaría tan feliz de ver este desierto... ¡desierto! Necesito agua.	
VO_LOE_04_RESPONSE	¡Trogg aplasta estúpido!	
VO_LOE_04_SCARVASH_TURN_2	¡Trogg no estúpido! ¡Trogg te deja estúpido a ti!	
VO_LOE_04_START	En Uldaman, ¡SOLO troggs!	
VO_LOE_04_WIN	¡Todavía hay más! Por aquí, ¡métete en el carro minero!	
VO_LOE_07_RESPONSE	¿Te parece que tienes tiempo para eso?	
VO_LOE_07_START	Cuidado, ¡nos están persiguiendo!	
VO_LOE_07_WIN	¡Ja, ja! ¡Carros y bombas! ¿Qué más se puede pedir?	
VO_LOE_08_ANIMATE_STONE	¡Tierra y piedra, despierten!	
VO_LOE_08_LANDSLIDE	¡Te enterraré!	
VO_LOE_08_RESPONSE	Serás polvo.	
VO_LOE_08_START	¿¡Quién osa molestar a los creadores!?	
VO_LOE_08_WIN	¡La cabeza del báculo es nuestra! ¡Solo nos falta una pieza!	
VO_LOE_092_Attack_02	¡Contempla!	
VO_LOE_10_NYAH	¡Mrrrglmrrrgl! ¡Nyah!	
VO_LOE_10_RESPONSE	Mrglmrrglrmrrgl.	
VO_LOE_10_RESPONSE_ALT_read	Medialeta, ¿qué haces aquí?	
VO_LOE_10_START	Mrglmrglmrgl.	
VO_LOE_10_START_2	¿De veras? Es muy irrespetuoso de tu parte. 	
VO_LOE_10_TURN_2_GIANTFIN	¡MRRRGL! ¡MRRRGLMRGL!	
VO_LOE_10_TURN1	¡Mrrrgl! Mrrglrrglmrgl.	
VO_LOE_10_WIN	Una pena... Con una mejor crianza, podría haber sido un ejemplo de civismo.	
VO_LOE_12_NAZJAR_PEARL	Espléndido. La perla de las mareas supera todas mis expectativas.	
VO_LOE_12_NAZJAR_TURN_1	Soy la cuchilla de Azshara. ¿Quién eres tú para desafiarme?	
VO_LOE_12_NAZJAR_TURN_1_FINLEY	Soy Sir Aletardo Mrrgglton. El placer es mío.	
VO_LOE_12_NAZJAR_TURN_3_FINLEY	Elisa, ¿qué me cuentas de los demás?	
VO_LOE_12_NAZJAR_TURN_5	¡Fuerzas de lo profundo, arrasen al enemigo como una marea mortal!	
VO_LOE_12_NAZJAR_TURN_5_FINLEY	Parece un poco demasiado, ¿no?	
VO_LOE_12_NAZJAR_TURN_7_FINLEY	*Sonido de dolor* ¡Mrgggl! ¡MRRGLMRRGL!	
VO_LOE_12_NAZJAR_TURN_7_FINLEY_2	Perdona, explorador, a veces pierdo la cabeza. 	
VO_LOE_12_RESPONSE	¡Yo controlo el poder de la perla!	
VO_LOE_12_START	¡El poder de las mareas te consumirá!	
VO_LOE_12_WIN	¡Bravo! ¡La perla es nuestra! ¡Acompáñame a la Sala de los Expedicionarios para ensamblar el artefacto juntos!	
VO_LOE_13_RESPONSE	RRRROOAARRR	
VO_LOE_13_START_2	¡Grr!	
VO_LOE_13_TURN_1	¡El báculo estaba maldito! Ha invocado al etéreo a pesar de nuestras barreras. ¡Se está robando todo!	
VO_LOE_13_TURN_1_2	Todo no. Solo lo bueno.	
VO_LOE_13_TURN_5	Ohhh. ¿Será el verdadero sello de Arthas? ¡Está en perfectas condiciones!	
VO_LOE_13_TURN_5_2	Reno, Brann, ¡escondan los artefactos!	
VO_LOE_13_TURN_9	¡Está animando un ejército! Elisa, ¡detenlo!	
VO_LOE_13_TURN_9_2	¡Tel'zaxus Nalore! ¡El báculo es demasiado poderoso! Pero puedo aminorar su marcha...	
VO_LOE_13_WIN	Nosotros nos encargamos de las piezas, explorador. ¡Tú ve a buscar a Rafaam!	
VO_LOE_14_RESPONSE	PLAF	
VO_LOE_14_START	¡Oh, la armadura de Lothar! Pasé meses en Roca Negra nadando en popó de dragón para encontrarla.	
VO_LOE_14_TURN_13	Brann, ¡está animando los libros de la biblioteca! Yo me ocuparé de los martillos voladores de la exposición de Lordaeron.	
VO_LOE_14_TURN_5	Ya me encargué de las espadas animadas de la sala del este. Elisa, ¿quién solicita mi asistencia?	
VO_LOE_14_TURN_5_2	¡Ve a ayudar a Reno! Está en el almacén principal, ¡rodeado de robots bum!	
VO_LOE_14_TURN_9	Veo que están todos ocupados. Yo me encargo de este broche hermoso.	
VO_LOE_14_WIN	El museo está bajo control. ¡Ve a buscar a Rafaam y dale su merecido, explorador!	
VO_LOE_15_RESPONSE	¡Qué cartas hermosas!	
VO_LOE_15_SPARE	¡Explorador! Tenemos un mazo de más. ¡Úsalo!	
VO_LOE_16_BOOM_BOT	Nos quedaron un montón de estos. ¡Acábalo!	
VO_LOE_16_CROWN	La magia de un mago loco en forma de corona.	
VO_LOE_16_EYE	Qué gracioso. Todavía lo tenía en el bolsillo. Bueno... te lo presto.	
VO_LOE_16_FIRST_ITEM	Estamos explorando el museo en busca de algo útil. ¡Avísame si necesitas una mano!	
VO_LOE_16_GOBLET	Odio las serpientes.	
VO_LOE_16_GREAVE	Una pieza de la armadura de Lothar quedó intacta después de la pelea.	
VO_LOE_16_LOCKET	Este relicario está embrujado por los fantasmas de Karazhan.	
VO_LOE_16_PIPE	¡Toma! Pero ni una palabra a Brann; ¡le encanta esta pipa!	
VO_LOE_16_RAFAAM_DEATH2	¡NO! ¡Nadie puede derrotarme!	
VO_LOE_16_SHARD	Esto estaba dentro de una caja que decía "NO ABRIR". Así que, sí... ¡Buena suerte!	
VO_LOE_16_SPLINTER	Esto lo encontré en el Núcleo de Magma. El Mayordomo lo usaba para limpiarse los dientes.	
VO_LOE_16_START_2	El báculo se está cargando. ¡Cuidado!	
VO_LOE_16_TEAR	Este es un artefacto sagrado de mi gente. Bebe, ¡rápido!	
VO_LOE_16_TURN_2	El báculo está casi listo. ¡Prepárate!	
VO_LOE_16_TURN_2_2	¡JA, JA, JA! ¡PODER SOBRECOGEDOR!	
VO_LOE_16_TURN_2_3	¡El báculo está sobrecargado! ¡No dejes pasar esta oportunidad!	
VO_LOE_16_TURN_3	¡Soy invencible! ¡Nunca me derrotarás!	
VO_LOE_16_TURN_3_2	El báculo se está cargando de nuevo. En poco tiempo, tendremos otra oportunidad.	
VO_LOE_16_TURN_4	El báculo está casi listo. ¡Abre bien los ojos!	
VO_LOE_16_TURN_5	¡JA, JA, JA! ¡PODER SOBRECOGEDOR!	
VO_LOE_16_TURN_5_2	¡El escudo se disipa! ¡Vamos!	
VO_LOE_16_TURN_6	El escudo se ha activado de nuevo. Ten mucho cuidado.	
VO_LOE_16_VIAL	La etiqueta dice "BÉBEME", pero lo encontramos en Naxxramas, así que nadie se atrevió.	
VO_LOE_ARCHAEDAS_TURN_1_CARTOGRAPHER	Si no estuviera tan ocupado enterrándote en piedra.	
VO_LOE_GIANTFIN_TIDEHUNTER_2	¡No, Aletardo! Aun entonces eras diferente.	
VO_LOE_NAZJAR_TURN_3_CARTOGRAPHER	Reno ha vuelto con la vara del sol, y Brann está en camino.	
VO_LOE_SCARVASH_TURN_6_CARTOGRAPHER	¡Concéntrate, Brann!	
VO_LOE_ZINAAR_TURN_10_CARTOGRAPHER_2	No está a la venta.	
VO_LOE_ZINAAR_TURN_6_CARTOGRAPHER_2	Sí.	
VO_LOE_ZINAAR_TURN_6_CARTOGRAPHER_2_ALT	Sí.	
VO_LOE10_DEAD_MURLOCS	Cuántos muertos... Qué desperdicio.	
VO_LOE10_NYAH_FINLEY	¡Oh, qué ridiculez! No seas tan infantil.	
VO_LOE10_TIDEHUNTER	Cuando Elisa me encontró, yo era un cazamareas. ¿Habría terminado así si no me hubiera ido?	
VO_LOE10_TURN_2_FINLEY	¡Hermanos míos! ¿Tenemos que pelear?	
VO_LOE10_TURN_2_FINLEY_2	Supongo que no había otro desenlace posible.	
VO_LOEA04_BRANN_TURN_1	La última vez que anduve por aquí, Scarvash era un trogg pequeñito. Ahora es más grande, más estúpido y más feo.	
VO_LOEA04_BRANN_TURN_6	Fascinante. Estas runas de mitril contienen códigos de protección. ¡Deben ser de la época de los titanes!	
VO_LOEA07_MINE_ALMOST_DONE	¡Estamos cerca! Me pregunto para qué servirá este botón...	
VO_LOEA07_MINE_ARCHAEDAS	¡POR LAS BARBAS DE MAGNI! ¿ESE ES ARCHAEDAS?	
VO_LOEA07_MINE_BARREL_FORWARD	¡A todo motor!	
VO_LOEA07_MINE_BOOM	¡Bombas saltarinas! ¡Eso les enseñará una lección!	
VO_LOEA07_MINE_BOOMZOOKA	¡BUM! ¡La cargaré para el próximo disparo!	
VO_LOEA07_MINE_DETONATE	¿Quieres detonar el pozo? ¡¿HAS PERDIDO LA CABEZA?!	
VO_LOEA07_MINE_DYNAMITE	¡Ey, ten cuidado con eso! ¡Ya hiciste volar un pedazo del camino!	
VO_LOEA07_MINE_HUNKER_DOWN	¡Abajo!	
VO_LOEA07_MINE_PARROT	¡Vuela, Ginny!	
VO_LOEA07_MINE_RAMMING	¡Ja, ja! ¡Vete de aquí!	
VO_LOEA07_MINE_REPAIRS	¡Un poco de chicle de mollejas y quedará como nuevo!	
VO_LOEA07_MINE_SPIKED_DECOY	¡Eh, estúpidos troggs! ¡Aquí estoy!	
VO_LOEA08_TURN_1_BRANN	Un sirviente de los titanes ancestrales. Las historias que podría contarnos...	
VO_LOEA09_1_RESPONSE	¡La cena será copiosa!	
VO_LOEA09_1_TURN1	¿Te atreves a invadir la ciudad en ruinas?	
VO_LOEA09_FINLEY_DEATH	Me recuperaré en unos minutos. Explorador, ¡encárgate de ese naga!	
VO_LOEA09_HERO_POWER	¡Hora de cenar! ¡El menú de hoy es sopa de múrloc!	
VO_LOEA09_HERO_POWER1	Saludos, explorador. Parece que estoy en aprietos. ¿Le darías una mano a un compañero?	
VO_LOEA09_HERO_POWER2	Mmm, debo admitir que está muy oscuro aquí.	
VO_LOEA09_HERO_POWER3	Por todos los cielos. ¿Está subiendo la temperatura?	
VO_LOEA09_HERO_POWER4	Esto es un poco incómodo, debo decir.	
VO_LOEA09_HERO_POWER5	Mmm... sí, definitivamente hace calor aquí.	
VO_LOEA09_HERO_POWER6	Si alguien pudiera ayudarme, sería espléndido.	
VO_LOEA09_QUOTE1	¡Te doy las gracias! ¡Ya estaba perdiendo las esperanzas!	
VO_LOEA09_UNSTABLE	¡Vuelve al caldero!	
VO_LOEA09_WIN	Te doy las gracias, explorador. ¿Deseas que te guíe hasta la pieza final?	
VO_LOEA10_1_MIDDLEFIN	Medialeta, ¿qué haces aquí?	
VO_LOEA15_1_LOSS_11	Tu mazo es una basura. Es hora de usar el mío.	
VO_LOEA15_1_LOW_HEALTH_10	Quizá no debería haber tomado tu mazo.	
VO_LOEA15_1_MAGMA_RAGER_09	¿Furibundo de magma? ¡¿Por qué demonios usarías esta carta?!	
VO_LOEA15_1_START_07	Me gusta tu mazo. Creo que ME LO QUEDARÉ.	
VO_LOEA15_1_TURN1_08	Ohhh, sí. Esta mano es INCREÍBLE.	
VO_LOEA15_1_WIN_12	Tu mazo es ALUCINANTE. ¡Ja, ja, ja!	
VO_LOEA15_GOLDEN	¿Todas las cartas de este mazo SON DORADAS? ¡Tu colección compite con la mía!	
VO_LOEA16_1_CARD_04	¡He conseguido artefactos de MILES de mundos!	
VO_LOEA16_1_RESPONSE_03	¡Sí! ¡SÍ!	
VO_LOEA16_1_START_01	¡Contempla TODO EL PODER del báculo!	
VO_LOEA16_1_TURN1_02	¡Soy invencible! ¡El poder de los titanes es mío!	
VO_LOOT_329_Male_Elemental_Attack_01	Marchítate.	
VO_LOOT_329_Male_Elemental_Death_01	<Muerte>	
VO_LOOT_329_Male_Elemental_Play_01	La vida se pudre. La podredumbre vive.	
VO_LOOT_541_Male_Kobold_BOSS_AFKay_01	¡Atraparla! ¡Atacará al humano antes de darse cuenta!	
VO_LOOT_541_Male_Kobold_BOSS_Blackseed_01	Semillanegra escabullirse en profundidades y regresar con… ¡guácala!… cosas pegajosas.	
VO_LOOT_541_Male_Kobold_BOSS_Brimstone_01	¡Shhhhh! Estatuas tener ojos, de los que pestañean. ¡No despertarlas!	
VO_LOOT_541_Male_Kobold_BOSS_Candlebeard_01	Barbavela pensar que tesoro enterrado convierte a kóbold en pirata. 	
VO_LOOT_541_Male_Kobold_BOSS_Chronomancer_01	¡Maga del tiempo! Volvemos a vernos, ¡por primera vez!	
VO_LOOT_541_Male_Kobold_BOSS_Everrot_01	¡No tocar esporas! Dejar que esbirros toquen esporas.	
VO_LOOT_541_Male_Kobold_BOSS_Flurgl_01	Kóbolds no comprender múrlocs... ¡Su habla hablada no hablar bien!	
VO_LOOT_541_Male_Kobold_BOSS_GeorgeKarl_01	Esos dos llegar un día desde jungla. 	
VO_LOOT_541_Male_Kobold_BOSS_Gnosh_01	¡Túnel no ser túnel en realidad! ¡Boca grande! ¡Boca dientuda!	
VO_LOOT_541_Male_Kobold_BOSS_Graves_01	Sanador perdido ser muy santurrón. "Piedad, piedad". ¡Mátalo!	
VO_LOOT_541_Male_Kobold_BOSS_Gutmook_01	Troggs. BAH. Mantener boca cerrada y dejar que esbirros machaquen.	
VO_LOOT_541_Male_Kobold_BOSS_Hamm_01	Hamm ser mejor cavador de túneles. "Cavar" ser eufemismo. 	
VO_LOOT_541_Male_Kobold_BOSS_Jeeru_01	Oh, no, no, no, no... ¡No frotar lámpara! Es trampa tramposa.	
VO_LOOT_541_Male_Kobold_BOSS_Lyris_01	¡Loca elfa chisporroteante! Tener cuidado con traicionera gente de fuego.	
VO_LOOT_541_Male_Kobold_BOSS_MagmaRager_01	Kóbolds bloquear tubo de lava muchas veces pero seguirse abriendo no saber cómo.	
VO_LOOT_541_Male_Kobold_BOSS_Mothergloop_01	¡Cuidarte de Viscosidad suprema, ser viscosidad de donde viscosear todas las viscosidades!	
VO_LOOT_541_Male_Kobold_BOSS_Mushhuckster_01	Vendehongos Max venir de parte más oscura de calabozo.	
VO_LOOT_541_Male_Kobold_BOSS_Russell_01	Canciones que canta bardo hacen que todos querer pelear.	
VO_LOOT_541_Male_Kobold_BOSS_Seriona_01	¡Estúpida dragona crepuscular hacer kóbolds débiles! Eeh, ¡más débiles!	
VO_LOOT_541_Male_Kobold_BOSS_Sturmi_01	¡Sturmi crear compañeritos de cera! Ser todo un éxito en fiestas kóbold. 	
VO_LOOT_541_Male_Kobold_BOSS_TrappedRoom_01	Shhhh… No… tocar… NADA…	
VO_LOOT_541_Male_Kobold_BOSS_TreasureVault_01	¡Tesoro! Tesoro aquí. ¡Aplastar y robar!	
VO_LOOT_541_Male_Kobold_BOSS_Troll_01	Jefe trol obligatorio, parte importante de dieta balanceada de calabozo.	
VO_LOOT_541_Male_Kobold_BOSS_Whopwhisker_01	Mostachoplúm ser más furioso de kóbolds. Je, je.	
VO_LOOT_541_Male_Kobold_DefeatPlayer_01	¡Tantos tesoros! Je, je… Mío, mío, mío, mío, mío.	
VO_LOOT_541_Male_Kobold_EmoteResponse_01	Ya deja de cacarear.	
VO_LOOT_541_Male_Kobold_LOOT_Backpacks_01	¡Mochilas! Ya no solo usar en espalda.	
VO_LOOT_541_Male_Kobold_LOOT_Boombox_01	¡Cajabum! Todo lo que necesitas para pasarlo bomba.	
VO_LOOT_541_Male_Kobold_LOOT_Candle1_01	¡No llevar vela!	
VO_LOOT_541_Male_Kobold_LOOT_Candle2_01	¡Yo decirte! ¡Yo decirte que no llevar y tú llevar de todos modos!	
VO_LOOT_541_Male_Kobold_LOOT_CapturedFlag_01	Alianza y Horda enloquecen por banderas. 	
VO_LOOT_541_Male_Kobold_LOOT_Cube_01	¡Ah, loca caja cuadrada! ¡Cuando ganar ya no ser opción!	
VO_LOOT_541_Male_Kobold_LOOT_Invisibility_01	¡Capa de invisibilidad! ¡Siempre la pierdo! Es invisible.	
VO_LOOT_541_Male_Kobold_LOOT_QuelDelar_01	¡Quel'delar! La espada legendaria partida en dos. No ser mi culpa.	
VO_LOOT_541_Male_Kobold_LOOT_QuelDelarForged_01	¡Qué hermosa! ¡Qué brillante! ¡Qué… espadosa!	
VO_LOOT_541_Male_Kobold_LOOT_Wand_01	Kóbolds venerar Vara de asar como verdadera carta de prueba de habilidad. Je, je.	
VO_LOOT_541_Male_Kobold_LOOT_WaxRager_01	Furibundo de cera enemigo muy poderoso. No preguntar de dónde viene cera. De orejas.	
VO_LOOT_541_Male_Kobold_TUT_AdventureSelect_01	¿Qué es eso que huelo? ¿Cuero? ¿Acero? Antorchas… AVENTUREROS. ¡Bah! ¡Aventureros!	
VO_LOOT_541_Male_Kobold_TUT_BossHeroPower_01	Cada monstruo hacer algo diferente. Y todo feo. ¡Haz clic y mira!	
VO_LOOT_541_Male_Kobold_TUT_BountyBoard_01	¡Alto! ¡Atrás! Grandes pilas de botín para MÍ, no para TI.	
VO_LOOT_541_Male_Kobold_TUT_CharacterSelect_01	¿Quién se atreve a venir por tesoros kóbold? ¿Portaespada? ¿Lanzachispas?	
VO_LOOT_541_Male_Kobold_TUT_Final_Boss_Azari_01	¡Devorador libre! ¡Corre! 	
VO_LOOT_541_Male_Kobold_TUT_Final_Boss_Darkness_01	¡Tener cuidado en la oscuridad! Por eso kóbolds llevar velas.	
VO_LOOT_541_Male_Kobold_TUT_Final_Boss_KoboldKing_01	¡Mi turno, je-ja! ¡Todos los botines tú arrojar al basurero de botines ser míos!	
VO_LOOT_541_Male_Kobold_TUT_Final_Boss_Vustrasz_01	¿Tomarás tesoro de dragón? Ohhh, estará TAN furioso…	
VO_LOOT_541_Male_Kobold_TUT_Final_Boss_Xol_01	¡No mirar a los ojos de Xol! Tiene ojos por toda la carota. 	
VO_LOOT_541_Male_Kobold_TUT_Game1Begin1_01	Primeros monstruos que encuentras ser pequeños y débiles. ¡Como tú!	
VO_LOOT_541_Male_Kobold_TUT_Game1Begin2_01	¡Tú aplastarlos y llevarte sus cosas para ser más fuerte! 	
VO_LOOT_541_Male_Kobold_TUT_Game1Defeat_01	Está bien. Morir joven mejor que no morir nunca. 	
VO_LOOT_541_Male_Kobold_TUT_Game1Victory_01	¡Tú ganador! Ahora llevarte botín. Je-ja. Clásico aventurero.	
VO_LOOT_541_Male_Kobold_TUT_Game2Begin1_01	Cuando tú fortalecerte, monstruos fortalecerse. 	
VO_LOOT_541_Male_Kobold_TUT_Game2Begin2_01	La flexibilidad pecuniaria ser parte importante de la doctrina económica de mercados mixtos de imperio kóbold.	
VO_LOOT_541_Male_Kobold_TUT_GeneralDefeat1_01	Qué mal. Para ti. ¡Cuando aventurero muere, rey kóbold llevarse todo el botín!	
VO_LOOT_541_Male_Kobold_TUT_GeneralDefeat2_01	¡Enviar más aventureros! ¡Je-ja! Más botín para mí, más botín, más botín, más botín…	
VO_LOOT_541_Male_Kobold_TUT_MainBoss1_01	Tú encontrar muchos monstruos en imperio kóbold. ¡Cada pelea, tú más fuerte!… O muerto.	
VO_LOOT_541_Male_Kobold_TUT_MainBoss3_01	¡En un calabozo combatir contra ocho monstruos! Uno por cada dedo.	
VO_LOOT_541_Male_Kobold_TUT_TreasureSelect1_01	OHHH, ¡gran tesoro! Tú elegir uno, solo uno. Elegir bien.	
VO_LOOT_541_Male_Kobold_TUT_TreasureSelect2_01	Ahora tú elegir cartas, cartas para estar en tu mazo de calabozo.	
VO_LOOT_541_Male_Kobold_TUT_TreasureSelect3_01	Arma mazo para machacar monstruos. ¡Ser tu mazo hasta la muerte!	
VO_LOOT_541_Male_Kobold_TUT_TreasureSelect4_01	¡Ganar más batallas, llevar más botín! ¡Ser la costumbre kóbold!	
VO_LOOT_541_Male_Kobold_TUT_Victory1_01	¡¿Qué?! ¡Nadie marcharse con tesoros kóbold!	
VO_LOOT_541_Male_Kobold_TUT_Victory2_01	¡Menos en nueve ocasiones distintas!	
VO_LOOT_541_Male_Kobold_TUT_VictoryComplete_01	¡Lo lograste! ¡Tú dominar calabozo como todo un maestro de calabozos alocado! 	
VO_LOOT_541_Male_Kobold_TUT_VictoryComplete_02	¡Lo lograste! ¡Tú ser maestro de calabozos ahora! 	
VO_LOOTA_829_Male_Human_Event_01	¡Maldita sea mi súbita pero inevitable traición!	
VO_LOOTA_BOSS_04h_Female_Kobold_Death_01	<Muerte>	
VO_LOOTA_BOSS_04h_Female_Kobold_DefeatPlayer_01	¡No te muevas! Deja que la cera se enfríe… Pero qué hermoso, tan hermoso…	
VO_LOOTA_BOSS_04h_Female_Kobold_EmoteResponse_01	Yo ceramántica, no ceramateur.	
VO_LOOTA_BOSS_04h_Female_Kobold_EventWaxOff_01	Pulir…	
VO_LOOTA_BOSS_04h_Female_Kobold_EventWaxOn_01	¡Encerar!	
VO_LOOTA_BOSS_04h_Female_Kobold_EventWaxRagerPlay_01	Uuh... ¡guapo!	
VO_LOOTA_BOSS_04h_Female_Kobold_EventWaxRagerRespawn_01	Nunca dejar de volver, ¿no?	
VO_LOOTA_BOSS_04h_Female_Kobold_Intro1_01	Ah, sí, mmm, la cera tiene ojos...	
VO_LOOTA_BOSS_04h_Female_Kobold_Intro2_01	Yo hacer las bellas bellezas, bellezas de cera tan bellas.	
VO_LOOTA_BOSS_05h_Male_Kobold_Death_01	<Muerte>	
VO_LOOTA_BOSS_05h_Male_Kobold_DefeatPlayer_01	¡Hamm hace cataplám! 	
VO_LOOTA_BOSS_05h_Male_Kobold_EmoteResponse_01	No llevarte bumbum.	
VO_LOOTA_BOSS_05h_Male_Kobold_EventBoomBots_01	Bien. ¡BIEN! ¡Bien bien bien!	
VO_LOOTA_BOSS_05h_Male_Kobold_EventMadBomberDeath_01	No así...	
VO_LOOTA_BOSS_05h_Male_Kobold_HeroPower1_01	Bum, nena. ¡BUM!	
VO_LOOTA_BOSS_05h_Male_Kobold_HeroPower2_01	¡Ja ja ja!	
VO_LOOTA_BOSS_05h_Male_Kobold_HeroPower3_01	¡Jajajajajaja!	
VO_LOOTA_BOSS_05h_Male_Kobold_Intro_01	¡Hora de demolición!	
VO_LOOTA_BOSS_06h_Male_Furbolg_Death_01	Hay otro, más abajo...	
VO_LOOTA_BOSS_06h_Male_Furbolg_DefeatPlayer_01	¿Lo... lo maté? ¿Qué he hecho...?	
VO_LOOTA_BOSS_06h_Male_Furbolg_EmoteResponse_01	Solo eres otra... de esas voces...	
VO_LOOTA_BOSS_06h_Male_Furbolg_EventPlayerEvolves_01	La oscuridad te ha tocado.	
VO_LOOTA_BOSS_06h_Male_Furbolg_HeroPower1_01	Está llamando…	
VO_LOOTA_BOSS_06h_Male_Furbolg_HeroPower2_01	Estas cavernas son profundas.	
VO_LOOTA_BOSS_06h_Male_Furbolg_HeroPower3_01	Las apariencias engañan...	
VO_LOOTA_BOSS_06h_Male_Furbolg_HeroPower4_01	¿Quién es el monstruo aquí?	
VO_LOOTA_BOSS_06h_Male_Furbolg_HeroPower5_01	No ves las sombras... pero ellas te ven a ti.	
VO_LOOTA_BOSS_06h_Male_Furbolg_Intro_01	Algo siniestro se esconde aquí...	
VO_LOOTA_BOSS_09h_Female_Furbolg_Death_01	<Muerte>	
VO_LOOTA_BOSS_09h_Female_Furbolg_DefeatPlayer_01	Así hacíamos las cosas en Cuna del Invierno.	
VO_LOOTA_BOSS_09h_Female_Furbolg_EmoteResponse_01	Qué frío.	
VO_LOOTA_BOSS_09h_Female_Furbolg_EventFrostMagic1_01	¿Tú también dominas el frío?	
VO_LOOTA_BOSS_09h_Female_Furbolg_EventFrostMagic2_01	<Tiembla.>	
VO_LOOTA_BOSS_09h_Female_Furbolg_EventFrostMagic3_01	¡Escalofriante!	
VO_LOOTA_BOSS_09h_Female_Furbolg_HeroPower1_01	No te muevas de ahí.	
VO_LOOTA_BOSS_09h_Female_Furbolg_HeroPower2_01	No, no, nada de eso.	
VO_LOOTA_BOSS_09h_Female_Furbolg_HeroPower3_01	Quieto.	
VO_LOOTA_BOSS_09h_Female_Furbolg_Intro_01	Kóbolds, ¡les dije que...! Ah, ¿qué tenemos aquí?	
VO_LOOTA_BOSS_10h_Male_Human_Death_01	Así lo dispuso el destino...	
VO_LOOTA_BOSS_10h_Male_Human_DefeatPlayer_02	Ahora estos tesoros me pertene... ¡Le pertenecen a la Luz! Y a mí también.	
VO_LOOTA_BOSS_10h_Male_Human_EmoteResponse_01	Suplicar piedad no te salvará.	
VO_LOOTA_BOSS_10h_Male_Human_EventOverdraw_01	¡Estoy empezando a odiar Villanorte!	
VO_LOOTA_BOSS_10h_Male_Human_HeroPower1_01	¡Ten fe!	
VO_LOOTA_BOSS_10h_Male_Human_HeroPower2_01	¡Has sanado!	
VO_LOOTA_BOSS_10h_Male_Human_HeroPower3_01	¡Aléjate de la oscuridad!	
VO_LOOTA_BOSS_10h_Male_Human_HeroPower4_01	La Luz es piadosa.	
VO_LOOTA_BOSS_10h_Male_Human_HeroPower5_01	¡Glorioso!	
VO_LOOTA_BOSS_10h_Male_Human_Intro_01	¡Alto! ¡Ahora estos tesoros le pertenecen a la Luz!	
VO_LOOTA_BOSS_11h_Male_Trogg_Death_01	<Muerte>	
VO_LOOTA_BOSS_11h_Male_Trogg_DefeatPlayer_01	Buen líder conoce el camino, sigue el camino y muestra el látigo.	
VO_LOOTA_BOSS_11h_Male_Trogg_EmoteResponse_01	Palabras bonitas no sirven. ¡Solo hablo LÁTIGO!	
VO_LOOTA_BOSS_11h_Male_Trogg_EventEquality_01	¡Estos esbirros ya sufren látigo!	
VO_LOOTA_BOSS_11h_Male_Trogg_HeroPower1_01	¡Andando!	
VO_LOOTA_BOSS_11h_Male_Trogg_HeroPower2_01	¡Vamos!	
VO_LOOTA_BOSS_11h_Male_Trogg_HeroPower3_01	¡Más rápido! 	
VO_LOOTA_BOSS_11h_Male_Trogg_HeroPower4_01	¡Apresúrense!	
VO_LOOTA_BOSS_11h_Male_Trogg_HeroPower5_01	Un buen latigazo.	
VO_LOOTA_BOSS_11h_Male_Trogg_Intro_01	¡Hora de sufrir!	
VO_LOOTA_BOSS_12h_Male_Kobold_CandleAttack1_01	¡Tú hacer enfadar vela mucho!	
VO_LOOTA_BOSS_12h_Male_Kobold_CandleAttack2_01	¡No provocar vela!	
VO_LOOTA_BOSS_12h_Male_Kobold_CandleAttack3_01	¡Rakanishu!	
VO_LOOTA_BOSS_12h_Male_Kobold_CandleAttack4_01	¡Hora de la vela!	
VO_LOOTA_BOSS_12h_Male_Kobold_CandleAttack5_01	¡La vela no se toca!	
VO_LOOTA_BOSS_12h_Male_Kobold_Death_01	No… llevarte...	
VO_LOOTA_BOSS_12h_Male_Kobold_Death1_01	¡La tabla no!	
VO_LOOTA_BOSS_12h_Male_Kobold_Death2_01	Yo jo... no...	
VO_LOOTA_BOSS_12h_Male_Kobold_Death3_01	¡Ah, hundido!	
VO_LOOTA_BOSS_12h_Male_Kobold_DefeatPlayer_01	¡Ja, jar! ¡Te salió el tiro por la culata!	
VO_LOOTA_BOSS_12h_Male_Kobold_DefeatPlayer_02	¡Cuántos tesoros! ¡Ja ja! Ahora enseñar a Rafaam...	
VO_LOOTA_BOSS_12h_Male_Kobold_EmoteResponse_01	¡Dah! ¡Calladito, periquito!	
VO_LOOTA_BOSS_12h_Male_Kobold_EventCandleStolen_01	¡¿Qué?! ¡Política de llevado de vela ser MUY clara!	
VO_LOOTA_BOSS_12h_Male_Kobold_EventChargeBigMinion_01	¡Oh, jo, jo!	
VO_LOOTA_BOSS_12h_Male_Kobold_EventFindCandle_01	¡Ay, preciosa vela! Shhhh, tranquila... yo llevarte, yo llevarte...	
VO_LOOTA_BOSS_12h_Male_Kobold_EventPlayCandle_01	¡DIJE que NO LLEVARTE!	
VO_LOOTA_BOSS_12h_Male_Kobold_EventPlayerPlaysCrab_01	¡Aleja eso! ¡No!	
VO_LOOTA_BOSS_12h_Male_Kobold_EventPlayerPlaysPatches_01	¡No! ¡Yo estoy a cargo! ¡Yo!	
VO_LOOTA_BOSS_12h_Male_Kobold_EventPlayKoboldKing_01	¡Ah! Regicidio.	
VO_LOOTA_BOSS_12h_Male_Kobold_GetTreasure1_01	¡Yo también conseguir tesoro! Je, je.	
VO_LOOTA_BOSS_12h_Male_Kobold_GetTreasure2_01	Objetos brillantes para rey kóbold gigante…	
VO_LOOTA_BOSS_12h_Male_Kobold_GetTreasure3_01	¿Qué conseguir yo? ¡Ah, muy bueno!	
VO_LOOTA_BOSS_12h_Male_Kobold_GetTreasure4_01	Ah... ¡tesoro! 	
VO_LOOTA_BOSS_12h_Male_Kobold_GetTreasure5_01	¡Mi calabozo! ¡Mis tesoros!	
VO_LOOTA_BOSS_12h_Male_Kobold_Intro_01	¡Tú soltar tesoros, ahora! ¡Yo llevármelos! ¡Míos!	
VO_LOOTA_BOSS_12h_Male_Kobold_Intro1_01	¡Ah! ¡Buen día, sandía!	
VO_LOOTA_BOSS_12h_Male_Kobold_Intro2_01	¡Saludos peludos!	
VO_LOOTA_BOSS_12h_Male_Kobold_Intro3_01	Uh… arrr… ¡hola, hola, caracola!	
VO_LOOTA_BOSS_13h_Female_Undead_Death_01	<Muerte>	
VO_LOOTA_BOSS_13h_Female_Undead_DefeatPlayer_01	A ver, veamos qué tenías... ¿Qué? ¿De verdad elegiste estas cartas?	
VO_LOOTA_BOSS_13h_Female_Undead_EmoteResponse_01	¿Es tu primera vez en este calabozo? Aquí no conversamos mucho. 	
VO_LOOTA_BOSS_13h_Female_Undead_EventBagOfCoins_01	Ah, un aventurero con riquezas...	
VO_LOOTA_BOSS_13h_Female_Undead_EventStealQuest_01	¡Alto, rufián!	
VO_LOOTA_BOSS_13h_Female_Undead_HeroPower_01	¡Detrás de mí!	
VO_LOOTA_BOSS_13h_Female_Undead_HeroPower1_01	Retrocede.	
VO_LOOTA_BOSS_13h_Female_Undead_HeroPower2_01	Apresúrate. 	
VO_LOOTA_BOSS_13h_Female_Undead_HeroPower3_01	Dentro y fuera de las sombras...	
VO_LOOTA_BOSS_13h_Female_Undead_HeroPower4_01	Nunca les des un blanco.	
VO_LOOTA_BOSS_13h_Female_Undead_Intro_01	Si me das el tesoro, te mataré rápido.	
VO_LOOTA_BOSS_15h_Male_Human_Death_01	<Muerte>	
VO_LOOTA_BOSS_15h_Male_Human_DefeatPlayer_01	Bueno, quizás si vamos por ESTE camino logremos regresar a Un'Goro.	
VO_LOOTA_BOSS_15h_Male_Human_EmoteResponse_01	¿Acaso no nos cruzamos en Un'Goro?	
VO_LOOTA_BOSS_15h_Male_Human_Intro_01	¡Por la Luz, Karl! ¡Mirá dónde estamos! 	
VO_LOOTA_BOSS_15h_Male_Human_PartnerDeath_01	¡Oh, por la Luz, has matado a Karl!	
VO_LOOTA_BOSS_15h_Male_Human_TaggedIn1_01	A un lado, yo me encargo.	
VO_LOOTA_BOSS_15h_Male_Human_TaggedIn2_01	Esto es ridículo. Dame las cartas.	
VO_LOOTA_BOSS_15h_Male_Human_TaggedIn3_01	Quítate, ¡es MI turno!	
VO_LOOTA_BOSS_16h_Male_Troll_Death_01	¡Ahora hablaré conmigo mismo!	
VO_LOOTA_BOSS_16h_Male_Troll_DefeatPlayer_01	Ey, no te preocupes, pequeño cadáver bonito. Azún te hará compañía ahora. 	
VO_LOOTA_BOSS_16h_Male_Troll_EmoteResponse_01	Yo hablo con los muertos. Tú habla con la mano.	
VO_LOOTA_BOSS_16h_Male_Troll_EventPlayerDeathrattle1_01	Je, ey, eso sí me gusta.	
VO_LOOTA_BOSS_16h_Male_Troll_EventPlayerDeathrattle2_01	Nadie descansa en paz aquí.	
VO_LOOTA_BOSS_16h_Male_Troll_EventPlayerDeathrattle3_01	Permíteme darle una mano. 	
VO_LOOTA_BOSS_16h_Male_Troll_EventPlayerDeathrattle4_01	La muerte le sienta bien.	
VO_LOOTA_BOSS_16h_Male_Troll_EventPlayerDeathrattle5_01	Solo se muere dos veces.	
VO_LOOTA_BOSS_16h_Male_Troll_Intro_01	¡Hablo con los muertos! ¿Algún problema? No hay problema. 	
VO_LOOTA_BOSS_17h_Male_Troll_Death_01	<Muerte>	
VO_LOOTA_BOSS_17h_Male_Troll_DefeatPlayer_01	Si desafías a Jin'zo a pelear, prepárate para sufrir.	
VO_LOOTA_BOSS_17h_Male_Troll_EmoteResponse_01	No es hora de hablar. ¡Es hora de LLORAR!	
VO_LOOTA_BOSS_17h_Male_Troll_EventPlayerBattlecry1_01	Uuuh... Me gusta la actitud de ese.	
VO_LOOTA_BOSS_17h_Male_Troll_EventPlayerBattlecry2_01	¡A Jin'zo le gusta!	
VO_LOOTA_BOSS_17h_Male_Troll_EventPlayerBattlecry3_01	Sí, ¡este habla el idioma de Jin'zo!	
VO_LOOTA_BOSS_17h_Male_Troll_EventPlayerBrann_01	¿Ese enanito cree que puede gritar como Jin'zo? ¡SE EQUIVOCA!	
VO_LOOTA_BOSS_17h_Male_Troll_Intro_01	¡Jin'zo tiene GRANDES planes para ti!	
VO_LOOTA_BOSS_19h_Male_Trogg_Death_01	<Muerte>	
VO_LOOTA_BOSS_19h_Male_Trogg_DefeatPlayer_01	Tú vienes con trucos, y yo te aplasto.	
VO_LOOTA_BOSS_19h_Male_Trogg_EmoteResponse_01	¿Te gustan troggs? Tengo troggs.	
VO_LOOTA_BOSS_19h_Male_Trogg_EventHandFull_01	Silencio, estoy... ah, ¡es demasiado!	
VO_LOOTA_BOSS_19h_Male_Trogg_HeroPower1_01	¡Ven aquí, trogg!	
VO_LOOTA_BOSS_19h_Male_Trogg_HeroPower2_01	Sigue hablando. Tengo más.	
VO_LOOTA_BOSS_19h_Male_Trogg_HeroPower3_01	Huelen la magia.	
VO_LOOTA_BOSS_19h_Male_Trogg_HeroPowerHard1_01	Cuánto poder.	
VO_LOOTA_BOSS_19h_Male_Trogg_HeroPowerHard2_01	Sigue hablando.	
VO_LOOTA_BOSS_19h_Male_Trogg_HeroPowerHard3_01	Ahh… magia...	
VO_LOOTA_BOSS_19h_Male_Trogg_Intro_01	¡ARRODÍLLATE ante TROGG!	
VO_LOOTA_BOSS_20h_Male_Earthen_Death_01	Descansar...	
VO_LOOTA_BOSS_20h_Male_Earthen_DefeatPlayer_01	El santuario está seguro.	
VO_LOOTA_BOSS_20h_Male_Earthen_EmoteResponse_01	No me detendrán.	
VO_LOOTA_BOSS_20h_Male_Earthen_EventPlayerSilence_01	Ah... muchas gracias.	
VO_LOOTA_BOSS_20h_Male_Earthen_EventStatueDestroyed1_01	Prolongas lo inevitable.	
VO_LOOTA_BOSS_20h_Male_Earthen_EventStatueDestroyed2_01	Es solo cuestión de tiempo.	
VO_LOOTA_BOSS_20h_Male_Earthen_EventStatueDestroyed3_01	¡Tu presencia profana este lugar!	
VO_LOOTA_BOSS_20h_Male_Earthen_EventStatueDestroyed4_01	Debo... proteger... el santuario...	
VO_LOOTA_BOSS_20h_Male_Earthen_EventStatueDestroyed5_01	Mi voluntad es dura como la roca...	
VO_LOOTA_BOSS_20h_Male_Earthen_HeroPower_01	¡DESPIERTEN!	
VO_LOOTA_BOSS_20h_Male_Earthen_HeroPowerNoStatues_01	¡DESPIERTEN!… Ah.	
VO_LOOTA_BOSS_20h_Male_Earthen_Intro_01	Largo. Aquí no hay nada para ti.	
VO_LOOTA_BOSS_22h_Male_Murloc_Death_01	<Muerte>	
VO_LOOTA_BOSS_22h_Male_Murloc_DeathSpecial_01	¡¡...!!	
VO_LOOTA_BOSS_22h_Male_Murloc_DefeatPlayer_01	¿...¡...! ...?	
VO_LOOTA_BOSS_22h_Male_Murloc_EmoteResponse_01	¡¿...?!	
VO_LOOTA_BOSS_22h_Male_Murloc_EventFishUpChest_01	...	
VO_LOOTA_BOSS_22h_Male_Murloc_EventSummonCrab_01	¡¡...!!	
VO_LOOTA_BOSS_22h_Male_Murloc_FishLarge_02	¡...!	
VO_LOOTA_BOSS_22h_Male_Murloc_FishMedium_01	¿...?	
VO_LOOTA_BOSS_22h_Male_Murloc_FishSmall_01	...	
VO_LOOTA_BOSS_22h_Male_Murloc_Intro_01	¡...!	
VO_LOOTA_BOSS_23h_Male_Furbolg_Death_01	<Muerte>	
VO_LOOTA_BOSS_23h_Male_Furbolg_DefeatPlayer_01	Dejen los huesos, serán una advertencia para los demás.	
VO_LOOTA_BOSS_23h_Male_Furbolg_EmoteResponse_01	Sigue hablando, así mis bestias podrán encontrarte...	
VO_LOOTA_BOSS_23h_Male_Furbolg_EventPlayBigMinion1_01	La cacería... ¡termina!	
VO_LOOTA_BOSS_23h_Male_Furbolg_EventPlayBigMinion2_01	No hay escapatoria.	
VO_LOOTA_BOSS_23h_Male_Furbolg_EventPlayBigMinion3_01	¡Huelen tu miedo!	
VO_LOOTA_BOSS_23h_Male_Furbolg_HeroPower1_01	Se te acaba el tiempo...	
VO_LOOTA_BOSS_23h_Male_Furbolg_HeroPower2_01	Mi poder no deja de aumentar.	
VO_LOOTA_BOSS_23h_Male_Furbolg_HeroPower3_01	Mis bestias te encontrarán.	
VO_LOOTA_BOSS_23h_Male_Furbolg_HeroPower4_01	Yo sé todo sobre estas cavernas. Tú, nada.	
VO_LOOTA_BOSS_23h_Male_Furbolg_HeroPower5_01	Este es MI terreno de cacería.	
VO_LOOTA_BOSS_23h_Male_Furbolg_Intro_01	Aquí… ¡TÚ eres la presa!	
VO_LOOTA_BOSS_25h_Male_Dragon_Death_01	<Muerte>	
VO_LOOTA_BOSS_25h_Male_Dragon_DefeatPlayer_01	Estos tesoros, antiguos y venerables, permanecerán aquí. 	
VO_LOOTA_BOSS_25h_Male_Dragon_EmoteResponse_01	Déjame pensarlo bien.	
VO_LOOTA_BOSS_25h_Male_Dragon_EventMarinTheFox_01	¡Marin, el zorro! ¿Cómo te atreves a volver a este lugar?	
VO_LOOTA_BOSS_25h_Male_Dragon_HeroPower1_01	Arde, intruso.	
VO_LOOTA_BOSS_25h_Male_Dragon_HeroPower2_01	¡Saqueador miserable!	
VO_LOOTA_BOSS_25h_Male_Dragon_HeroPower3_01	¡Sufre!	
VO_LOOTA_BOSS_25h_Male_Dragon_HeroPower4_01	¡Fuera!	
VO_LOOTA_BOSS_25h_Male_Dragon_HeroPower5_01	Ya no puedes esconderte.	
VO_LOOTA_BOSS_25h_Male_Dragon_Intro_01	Revélate, maleante miserable. 	
VO_LOOTA_BOSS_25h_Male_Dragon_TreasureDestroy1_01	¡Eso no te pertenece!	
VO_LOOTA_BOSS_25h_Male_Dragon_TreasureDestroy2_01	¡Maleante!	
VO_LOOTA_BOSS_25h_Male_Dragon_TreasureDestroy3_01	¡Devuélveme eso!	
VO_LOOTA_BOSS_25h_Male_Dragon_TreasureDestroy4_02	¡Criatura avara!	
VO_LOOTA_BOSS_25h_Male_Dragon_TreasureDestroy5_01	Pagarás por tu codicia.	
VO_LOOTA_BOSS_26h_Female_Demon_Death_01	<Muerte>	
VO_LOOTA_BOSS_26h_Female_Demon_DefeatPlayer_01	Estúpido e insignificante intruso. Yo veo todo.	
VO_LOOTA_BOSS_26h_Female_Demon_EmoteResponse_01	Solo tengo ojos... para ti.	
VO_LOOTA_BOSS_26h_Female_Demon_EyeStalkConfuse_01	Fracaso.	
VO_LOOTA_BOSS_26h_Female_Demon_EyeStalkDeath_01	Fatalidad.	
VO_LOOTA_BOSS_26h_Female_Demon_EyeStalkDevitalize_01	Fatiga.	
VO_LOOTA_BOSS_26h_Female_Demon_EyeStalkFear_01	Fobia.	
VO_LOOTA_BOSS_26h_Female_Demon_EyeStalkFire_01	Fuego.	
VO_LOOTA_BOSS_26h_Female_Demon_EyeStalkFrost_01	Frío.	
VO_LOOTA_BOSS_26h_Female_Demon_Intro_01	Si llegaste hasta aquí, debes ser muy inteligente... déjame verte...	
VO_LOOTA_BOSS_32h_Male_Human_Death_01	<Muerte>	
VO_LOOTA_BOSS_32h_Male_Human_EmoteResponse_01	No hablo con extraños.	
VO_LOOTA_BOSS_32h_Male_Human_PartnerDeath_01	¡Oh, no! ¡George no!	
VO_LOOTA_BOSS_32h_Male_Human_TaggedIn1_01	¡Déjame probar!	
VO_LOOTA_BOSS_32h_Male_Human_TaggedIn2_01	¡Déjame ayudar, George!	
VO_LOOTA_BOSS_32h_Male_Human_TaggedIn3_01	¿Puedo ir, George? ¿Puedo, puedo?	
VO_LOOTA_BOSS_34h_Male_Demon_Death_01	<Muerte>	
VO_LOOTA_BOSS_34h_Male_Demon_DefeatPlayer_01	Necesito más... ¡MÁS!	
VO_LOOTA_BOSS_34h_Male_Demon_EmoteResponse_01	Saciaré mi sed con tu miedo y mi hambre con tu remordimiento. 	
VO_LOOTA_BOSS_34h_Male_Demon_HeroPower1_01	Me alimento.	
VO_LOOTA_BOSS_34h_Male_Demon_HeroPower2_01	Más…	
VO_LOOTA_BOSS_34h_Male_Demon_HeroPower3_01	Dame más…	
VO_LOOTA_BOSS_34h_Male_Demon_HeroPower4_01	Devoraré este mundo.	
VO_LOOTA_BOSS_34h_Male_Demon_HeroPower5_01	Este es tu fin.	
VO_LOOTA_BOSS_34h_Male_Demon_Intro_01	ESTOY HAMBRIENTO.	
VO_LOOTA_BOSS_35h_Male_Furbolg_Death_01	Huye… ¡Abajo solo encontrarás tu perdición!	
VO_LOOTA_BOSS_35h_Male_Furbolg_DefeatPlayer_01	Tu cuerpo permanece, pero tu alma finalmente es libre.	
VO_LOOTA_BOSS_35h_Male_Furbolg_EmoteResponse_01	Si quieres paz, abandona tus tesoros y lárgate.	
VO_LOOTA_BOSS_35h_Male_Furbolg_Intro_01	¡Fuera! ¡Tu magia no tiene influencia aquí!	
VO_LOOTA_BOSS_35h_Male_Furbolg_SpellCountered1_01	Tu magia solo fortalece la madriguera.	
VO_LOOTA_BOSS_35h_Male_Furbolg_SpellCountered2_01	¡Silencio! 	
VO_LOOTA_BOSS_35h_Male_Furbolg_SpellCountered3_01	Tu fuerza decae.	
VO_LOOTA_BOSS_35h_Male_Furbolg_SpellCountered4_01	Mi magia es más fuerte que la tuya...	
VO_LOOTA_BOSS_35h_Male_Furbolg_SpellCountered5_01	Las viejas tradiciones no tienen rival.	
VO_LOOTA_BOSS_37h_Female_BloodElf_Death_01	¡Me quemo!	
VO_LOOTA_BOSS_37h_Female_BloodElf_DefeatPlayer_01	Si bailas en mi calabozo, terminarás quemándote...	
VO_LOOTA_BOSS_37h_Female_BloodElf_EmoteResponse_01	Me gustan los caballos, ¡pero prefiero las llamas! Ja, ja. Las llamas...	
VO_LOOTA_BOSS_37h_Female_BloodElf_EventFireball_01	¡Fuego... FUEGO! 	
VO_LOOTA_BOSS_37h_Female_BloodElf_EventPyroblast_01	¡Quema, quema, QUEMA!	
VO_LOOTA_BOSS_37h_Female_BloodElf_EventRagnaros_01	¡ESTAS son las peleas que me gustan!	
VO_LOOTA_BOSS_37h_Female_BloodElf_EventTheCandle_01	Así que... ¿TÚ te llevaste la vela?	
VO_LOOTA_BOSS_37h_Female_BloodElf_Flamewakers_01	¿Quieres ver fuegos artificiales?	
VO_LOOTA_BOSS_37h_Female_BloodElf_HeroPower1_01	Necesito más poder...	
VO_LOOTA_BOSS_37h_Female_BloodElf_HeroPower2_01	Más... ¡más!	
VO_LOOTA_BOSS_37h_Female_BloodElf_HeroPower3_01	¡Los hechizos son tan pero tan divertidos!	
VO_LOOTA_BOSS_37h_Female_BloodElf_Intro_01	¡Las llamas te harán bailar!	
VO_LOOTA_BOSS_38h_Male_Kobold_Death_01	¡Maldiciones!	
VO_LOOTA_BOSS_38h_Male_Kobold_DefeatPlayer_01	¡Sabía que yo hacer vudú mejor que tú!	
VO_LOOTA_BOSS_38h_Male_Kobold_EmoteResponse_01	¡Yo maldigo!	
VO_LOOTA_BOSS_38h_Male_Kobold_EventBrann_01	Vudú enano es vudú raro.	
VO_LOOTA_BOSS_38h_Male_Kobold_EventPlayerBattlecries1_01	Ese gritar tanto.	
VO_LOOTA_BOSS_38h_Male_Kobold_EventPlayerBattlecries2_01	Ese gritar mucho. 	
VO_LOOTA_BOSS_38h_Male_Kobold_EventPlayerBattlecries3_01	Todos gritar tanto.	
VO_LOOTA_BOSS_38h_Male_Kobold_EventPlayerDeathrattles1_01	¡Ese sí ser ruidoso!	
VO_LOOTA_BOSS_38h_Male_Kobold_EventPlayerDeathrattles3_01	Ese hacer vudú al morir.	
VO_LOOTA_BOSS_38h_Male_Kobold_EventRivendare_01	Vudú muerto es el peor vudú.	
VO_LOOTA_BOSS_38h_Male_Kobold_Intro_01	¿Tú, vudú? ¡Yo, vudú! Jujuju.	
VO_LOOTA_BOSS_39h_Male_Golem_Death_01	Estoy... roto...	
VO_LOOTA_BOSS_39h_Male_Golem_DefeatPlayer_01	El tesoro está a salvo. 	
VO_LOOTA_BOSS_39h_Male_Golem_EmoteResponse_01	Tú no eres el maestro.	
VO_LOOTA_BOSS_39h_Male_Golem_HeroPower1_01	Aplasta.	
VO_LOOTA_BOSS_39h_Male_Golem_HeroPower2_01	Pisotea.	
VO_LOOTA_BOSS_39h_Male_Golem_HeroPower3_01	¡Nadie pasará!	
VO_LOOTA_BOSS_39h_Male_Golem_HeroPower4_01	Tan... pequeño...	
VO_LOOTA_BOSS_39h_Male_Golem_HeroPower5_01	¡Fuera!	
VO_LOOTA_BOSS_39h_Male_Golem_Intro_01	Defiende… el tesoro…	
VO_LOOTA_BOSS_40h_Female_Dragon_Death_01	<Muerte>	
VO_LOOTA_BOSS_40h_Female_Dragon_DefeatPlayer_01	¡El Vuelo Crepuscular se alzará una vez más!	
VO_LOOTA_BOSS_40h_Female_Dragon_EmoteResponse_01	Mmmmm… son distintas maneras de verlo.	
VO_LOOTA_BOSS_40h_Female_Dragon_EventPlayTwilightDrake_01	Pequeño, no nos traiciones.	
VO_LOOTA_BOSS_40h_Female_Dragon_EventPlayTwilightWhelp_01	¡Regresa con tu familia, pequeño!	
VO_LOOTA_BOSS_40h_Female_Dragon_HeroPower1_01	¡Alimentooo…!	
VO_LOOTA_BOSS_40h_Female_Dragon_HeroPower2_01	Tu fuerza me sostiene.	
VO_LOOTA_BOSS_40h_Female_Dragon_HeroPower3_01	Mi especie persistirá.	
VO_LOOTA_BOSS_40h_Female_Dragon_HeroPower4_01	Sumérgete en el crepúsculo.	
VO_LOOTA_BOSS_40h_Female_Dragon_Intro_01	Siento un gran poder. Acércate...	
VO_LOOTA_BOSS_41h_Male_Kobold_Death_01	<Muerte>	
VO_LOOTA_BOSS_41h_Male_Kobold_DefeatPlayer_01	YO llevarme vela. Tú llevarte NADA.	
VO_LOOTA_BOSS_41h_Male_Kobold_EmoteResponse_01	¡Cierra pico! ¡Pelea!	
VO_LOOTA_BOSS_41h_Male_Kobold_EventHornOfCenarius_01	¿Qué? ¿QUÉ? ¡Tú pelear sucio!	
VO_LOOTA_BOSS_41h_Male_Kobold_HeroPower1_01	Todos... ¡a pelear!	
VO_LOOTA_BOSS_41h_Male_Kobold_HeroPower2_01	¡Pelea!	
VO_LOOTA_BOSS_41h_Male_Kobold_HeroPower3_01	¡Todos juntos!	
VO_LOOTA_BOSS_41h_Male_Kobold_Intro_01	¡Devuelve vela! 	
VO_LOOTA_BOSS_42h_Female_Furbolg_Armor10_01	Les doy las gracias a mis antepasados.	
VO_LOOTA_BOSS_42h_Female_Furbolg_Armor15_01	¡Los antiguos son poderosos!	
VO_LOOTA_BOSS_42h_Female_Furbolg_Armor20_01	Entrégame tus tesoros, ¡jamás lograrás tu cometido!	
VO_LOOTA_BOSS_42h_Female_Furbolg_Armor5_01	Lucho sin miedo.	
VO_LOOTA_BOSS_42h_Female_Furbolg_Death_01	Mis ancestros... me esperan...	
VO_LOOTA_BOSS_42h_Female_Furbolg_DefeatPlayer_01	¡Alabados sean los espíritus antiguos! ¡Son mi escudo y mi liberación! 	
VO_LOOTA_BOSS_42h_Female_Furbolg_EmoteResponse_01	Los espíritus antiguos… no tienen mucho agrado por ti.	
VO_LOOTA_BOSS_42h_Female_Furbolg_Intro_01	¡Espíritus antiguos! Los invoco.	
VO_LOOTA_BOSS_43h_Female_Djinn_Death_01	<Muerte>	
VO_LOOTA_BOSS_43h_Female_Djinn_DefeatPlayer_01	¿No era eso todo lo que deseabas...?	
VO_LOOTA_BOSS_43h_Female_Djinn_EmoteResponse_01	¿Por qué gastarías un deseo en eso?	
VO_LOOTA_BOSS_43h_Female_Djinn_HeroAbility1_01	¿Qué deseo pedirás?	
VO_LOOTA_BOSS_43h_Female_Djinn_HeroAbility2_01	Uno... dos... tres...	
VO_LOOTA_BOSS_43h_Female_Djinn_HeroAbility3_01	¡Deseo concedido!	
VO_LOOTA_BOSS_43h_Female_Djinn_HeroAbilityHandFull1_01	¡Je je je!	
VO_LOOTA_BOSS_43h_Female_Djinn_HeroAbilityHandFull2_01	¿Demasiado para ti?	
VO_LOOTA_BOSS_43h_Female_Djinn_HeroAbilityHandFull3_01	Cuidado con lo que deseas.	
VO_LOOTA_BOSS_43h_Female_Djinn_Intro_01	Tus deseos son órdenes... por un precio...	
VO_LOOTA_BOSS_44h_Female_Dragon_Death_01	<Muerte>	
VO_LOOTA_BOSS_44h_Female_Dragon_DefeatPlayer_01	¡Ya no queda ninguno! ¡Adiós!	
VO_LOOTA_BOSS_44h_Female_Dragon_EmoteResponse_01	¡NO LA MAMÁ!	
VO_LOOTA_BOSS_44h_Female_Dragon_Intro_01	¡Uuuh! ¿Hora de comer?	
VO_LOOTA_BOSS_45h_Male_Gnome_Death_01	<Muerte>	
VO_LOOTA_BOSS_45h_Male_Gnome_DefeatPlayer_01	En la vida hay que trabajar por lo que uno quiere. O robarlo, como yo.	
VO_LOOTA_BOSS_45h_Male_Gnome_EmoteResponse_01	Este lugar. Parece un laberinto de pequeños pasadizos sinuosos. ¡Son todos iguales!	
VO_LOOTA_BOSS_45h_Male_Gnome_HeroPower1_01	Ah, qué brillante.	
VO_LOOTA_BOSS_45h_Male_Gnome_HeroPower2_01	Je je…	
VO_LOOTA_BOSS_45h_Male_Gnome_HeroPower3_01	¡Cara! Gané.	
VO_LOOTA_BOSS_45h_Male_Gnome_HeroPower4_01	¡Cruz! Perdiste.	
VO_LOOTA_BOSS_45h_Male_Gnome_Intro_01	¡Esos bolsillos se ven bien pesados, camarada!	
VO_LOOTA_BOSS_46h_Male_Murloc_Death_01	<Muerte>	
VO_LOOTA_BOSS_46h_Male_Murloc_DefeatPlayer_01	¡...¿... ...? ...!	
VO_LOOTA_BOSS_46h_Male_Murloc_EmoteResponse_01	<Vomita.>	
VO_LOOTA_BOSS_46h_Male_Murloc_HeroPower1_01	...	
VO_LOOTA_BOSS_46h_Male_Murloc_HeroPower2_01	¿...?	
VO_LOOTA_BOSS_46h_Male_Murloc_HeroPower3_01	...	
VO_LOOTA_BOSS_46h_Male_Murloc_Intro_01	¡¡...!!	
VO_LOOTA_BOSS_49h_Male_Elemental_Death_01	<Muerte>	
VO_LOOTA_BOSS_49h_Male_Elemental_DefeatPlayer_01	Muajajaja...	
VO_LOOTA_BOSS_49h_Male_Elemental_EmoteResponse_01	Yo tomar vela. Es lo que me gusta. Está en mi esencia.	
VO_LOOTA_BOSS_49h_Male_Elemental_HeroPower1_01	Oscuridad…	
VO_LOOTA_BOSS_49h_Male_Elemental_HeroPower2_01	Huye…	
VO_LOOTA_BOSS_49h_Male_Elemental_HeroPower3_01	Muajejeja.	
VO_LOOTA_BOSS_49h_Male_Elemental_Intro_01	Tu luz se está atenuando, aventurero…	
VO_LOOTA_BOSS_50h_Male_Kobold_Death_01	<Muerte>	
VO_LOOTA_BOSS_50h_Male_Kobold_DefeatPlayer_01	Ohh ji, ji, ji. ¡Esto sí ser fuerte!	
VO_LOOTA_BOSS_50h_Male_Kobold_EmoteResponse_01	NO. No haber devoluciones.	
VO_LOOTA_BOSS_50h_Male_Kobold_EventKazakus_01	Kazakus, volver por más, ¿eh?	
VO_LOOTA_BOSS_50h_Male_Kobold_EventMakePotion1_01	Ah, eso… Eso no estar bien.	
VO_LOOTA_BOSS_50h_Male_Kobold_EventMakePotion2_01	Sí, esto ser malo, muy malo.	
VO_LOOTA_BOSS_50h_Male_Kobold_EventMakePotion3_01	Sí, je, ¿tú querer un poco? Je. Qué lástima.	
VO_LOOTA_BOSS_50h_Male_Kobold_EventUsePotion1_01	¡Oh! Esto ser malo. ¡Huele!	
VO_LOOTA_BOSS_50h_Male_Kobold_EventUsePotion2_01	Sí, je, je, ¡sí!	
VO_LOOTA_BOSS_50h_Male_Kobold_EventUsePotion3_01	Puaj... Eso saber mal, pero mal del bueno.	
VO_LOOTA_BOSS_50h_Male_Kobold_Intro_01	Ey, ey... ¿querer comprar unos hongos?	
VO_LOOTA_BOSS_51h_Male_Dwarf_Death_01	¡Buenas noches, Azeroth!	
VO_LOOTA_BOSS_51h_Male_Dwarf_DefeatPlayer_02	¡Gracias por tus esbirros, colega!	
VO_LOOTA_BOSS_51h_Male_Dwarf_EmoteResponse_01	Quieres arruinar mi función, ¿eh?	
VO_LOOTA_BOSS_51h_Male_Dwarf_EventBoombox_01	¡Ay, pero qué estruendoso!	
VO_LOOTA_BOSS_51h_Male_Dwarf_Intro_01	¡Quédate aquí y escucha!	
VO_LOOTA_BOSS_51h_Male_Dwarf_KillingBlowReady_01	¡Kóbolds y Catacumbas!	
VO_LOOTA_BOSS_51h_Male_Dwarf_Song1A_01	Vas con los mejores, explora sin temores	
VO_LOOTA_BOSS_51h_Male_Dwarf_Song1B_01	En busca de riquezas por doquier.	
VO_LOOTA_BOSS_51h_Male_Dwarf_Song1C_01	Tesoros sin fin, peligros, por mil.	
VO_LOOTA_BOSS_51h_Male_Dwarf_Song1D_01	Y una escena que prueba tu valor.	
VO_LOOTA_BOSS_51h_Male_Dwarf_Song2A_01	Pero si su luz te llevas, huye de esta cueva.	
VO_LOOTA_BOSS_51h_Male_Dwarf_Song2B_01	Evita los obstáculos sin dudar.	
VO_LOOTA_BOSS_51h_Male_Dwarf_Song2C_01	Corre, no te detengas, los monstruos acechan.	
VO_LOOTA_BOSS_51h_Male_Dwarf_Song2D_01	Sigue el mapa y la salida encontrarás.	
VO_LOOTA_BOSS_51h_Male_Dwarf_Song3A_01	Los sientes venir, ya no hay dónde huir.	
VO_LOOTA_BOSS_51h_Male_Dwarf_Song3B_01	Y temes que este pozo sea tu tumba.	
VO_LOOTA_BOSS_51h_Male_Dwarf_Song3C_01	Buscabas riquezas.Te irás sin cabeza.	
VO_LOOTA_BOSS_51h_Male_Dwarf_Song3D_01	¡En Kóbolds y Catacumbas!	
VO_LOOTA_BOSS_51h_Male_Dwarf_Steal_01	¡Ven acá!	
VO_LOOTA_BOSS_51h_Male_Dwarf_Steal_02	¡Ven aquí!	
VO_LOOTA_BOSS_51h_Male_Dwarf_Steal_03	¡Es hora de celebrar!	
VO_LOOTA_BOSS_51h_Male_Dwarf_StealDoomsayer_01	¡El peor asistente de la historia!	
VO_LOOTA_BOSS_51h_Male_Dwarf_StealMinstrel_01	¡Ah! ¡Es hora de un dueto!	
VO_LOOTA_BOSS_53h2_Female_Undead_Death_01	¡Una paradoja!	
VO_LOOTA_BOSS_53h2_Female_Undead_DefeatPlayer_01	Sabía que ganaría. He visto mi propio futuro. 	
VO_LOOTA_BOSS_53h2_Female_Undead_EmoteResponse_01	He superado a dragones de bronce con mi astucia. No eres una amenaza.	
VO_LOOTA_BOSS_53h2_Female_Undead_EventManaDestroyed_01	¡Solo retrasas lo inevitable!	
VO_LOOTA_BOSS_53h2_Female_Undead_EventPlayerTimeWalk_01	¿Tú también has visitado la Isla Intemporal?	
VO_LOOTA_BOSS_53h2_Female_Undead_Intro_01	El tiempo puede alterarse y modificarse. Tu existencia, también.	
VO_LOOTA_BOSS_53h2_Female_Undead_RitualPrep1_01	Ya te llegará la hora...	
VO_LOOTA_BOSS_53h2_Female_Undead_RitualPrep2_01	Mi poder se acumula.	
VO_LOOTA_BOSS_53h2_Female_Undead_RitualPrep3_01	Tic, tac…	
VO_LOOTA_BOSS_53h2_Female_Undead_TimeRewindPlayCard1_01	Cada vez lo hago mejor.	
VO_LOOTA_BOSS_53h2_Female_Undead_TimeRewindPlayCard2_01	Ya hemos hecho esto antes.	
VO_LOOTA_BOSS_53h2_Female_Undead_TimeRewindPlayCard3_01	El tiempo está de mi lado.	
VO_LOOTA_BOSS_53h2_Female_Undead_TimeRewindPlayCard4_01	¡Quien controla el tiempo controla el infinito!	
VO_LOOTA_BOSS_53h2_Female_Undead_TimeRewindPlayCard5_01	¡Hora de acabar con esto!	
VO_LOOTA_BOSS_53h2_Female_Undead_TimeRewindStart1_01	¡Contempla mi descubrimiento!	
VO_LOOTA_BOSS_53h2_Female_Undead_TimeRewindStart2_01	¡Ya es hora!	
VO_LOOTA_BOSS_53h2_Female_Undead_TimeRewindStart3_01	¡De nuevo! ¡Hagámoslo de nuevo!	
VO_LOOTA_BOSS_53h2_Female_Undead_TimeRewindStart4_01	¡Este es mi momento!	
VO_LOOTA_BOSS_54h_Female_Human_Death_01	¡No estaba lista!	
VO_LOOTA_BOSS_54h_Female_Human_DefeatPlayer_01	¡Bien! Ahora sí estoy lista.	
VO_LOOTA_BOSS_54h_Female_Human_EmoteResponse_01	¡Ya vengo! ¡Avísame cuando empiece la pelea!	
VO_LOOTA_BOSS_54h_Female_Human_Intro_01	<Silba distraída>	
VO_LOOTA_BOSS_54h_Female_Human_Intro_02	<Silba contenta>	
VO_LOOTA_BOSS_54h_Female_Human_Intro_03	<Silba contenta>	
VO_LOOTA_BOSS_54h_Female_Human_Intro_04	<Silba contenta>	
VO_LOOTA_BOSS_54h_Female_Human_Intro_07	<Silba contenta>	
VO_LOOTA_BOSS_54h_Female_Human_WakeUp_01	Ah, ¿estamos peleando?	
VO_Maiden_Female_Titan_FinalMaidenEmoteResponse_01	No se tolerará tu comportamiento.	
VO_Maiden_Female_Titan_FinalMaidenEyeForAnEye_01	Se ha hecho justicia.	
VO_Maiden_Female_Titan_FinalMaidenHeroPower_01	Expulsa tus pensamientos impuros.	
VO_Maiden_Female_Titan_FinalMaidenHumility_01	¡Sí! ¡Arrodíllate y quizá te perdone la vida!	
VO_Maiden_Female_Titan_FinalMaidenOpen_01	¿Has invocado a una agente de los titanes?	
VO_Maiden_Female_Titan_FinalMaidenTurn5_01	Somos eternos. ¡Tú no estás a la altura!	
VO_Malchezaar_Male_Demon_Brawl_06	No habrás pensado que podías vencer...	
VO_Malchezaar_Male_Demon_EmoteParty_01	¡A Malchezaar también le gusta festejar!	
VO_Malchezaar_Male_Demon_FinalAltOpening_01	¡Tontos!	
VO_Malchezaar_Male_Demon_FinalMalchezaarDeath_01	¡No! ¡No! ¡Otra vez no!	
VO_Malchezaar_Male_Demon_FinalMalchezaarEmoteResponse_01	¡Seré tu fin!	
VO_Malchezaar_Male_Demon_FinalMalchezaarHeroPower_01	¡No solo te enfrentas a Malchezaar, sino a todas las legiones bajo mi mando!	
VO_Malchezaar_Male_Demon_FinalMalchezaarJaraxxus_01	¿Qué? ¡Esa es mi invitación!	
VO_Malchezaar_Male_Demon_FinalMalchezaarMedivhSkin_01	¿Viniste con un disfraz? Mmmm... Yo podría hacer eso...	
VO_Malchezaar_Male_Demon_FinalMalchezaarSacrificialPact_03	¡Jajaja! ¡Eso jamás funcionaría contra un verdadero señor Eredar!	
VO_Malchezaar_Male_Demon_FinalMalchezaarTurn1_01	El mago es poderoso, ¿pero cómo pudiste creer que podrías resistir un poder tan abrumador?	
VO_Malchezaar_Male_Demon_FinalMalchezaarTurn7_01	¡Oigo la música! ¡Los Medivas! ¡Qué fiesta! ¡Esta es mi noche!	
VO_Malchezaar_Male_Demon_FinalThirdSequence_01	¿Me han invocado de regreso a Karazhan? ¡Justo a tiempo para la fiesta!	
VO_Malchezaar_Male_Demon_FinalThirdSequence_04	¡Fuera de mi camino, idiota!	
VO_Malchezaar_Male_Demon_PrologueEmoteResponse_01	¡Tonto!	
VO_Malchezaar_Male_Demon_PrologueHeroPower_01	¡Todas las dimensiones, todas las realidades están abiertas a mí!	
VO_Malchezaar_Male_Demon_PrologueOpen_01	¿Dónde está mi invitación?	
VO_Malchezaar_Male_Demon_PrologueTurn1_04	¡¿No me invitaste?! ¡Pero si soy un príncipe de los Eredar!	
VO_Malchezaar_Male_Demon_PrologueTurn11_02	¿Invitaste a Jaraxxus? ¿Ese debilucho?	
VO_Malchezaar_Male_Demon_PrologueWin_01	¡Tú vienes conmigo!	
VO_Mediva_01_Female_Blood Elf_AranSpell_04	Oooh... ¡brrrr!	
VO_Mediva_01_Female_Blood Elf_ChessEmoteOops_06	¡Oh-oh!	
VO_Mediva_01_Female_Blood Elf_PrologueTurn5_06	¡Medivas!	
VO_Mediva_02_Female_Draenei_JulianneDeadlyPoison_02	¡Qué tragedia!	
VO_Mediva_02_Female_Draenei_PrologueTurn5_05	¿Sí?	
VO_Mediva_03_Male_Night Elf_AranHeroPower_01	¡Arde, baby, arde!	
VO_Mediva_03_Male_Night Elf_CuratorBeasts_04	¡Achís, baby!	
VO_Mediva_03_Male_Night Elf_PrologueTurn5_01	¿Me llamaste?	
VO_Medivas_Multiple_Multiple_CroneLionTigerBear_01	¡Oh, vaya!	
VO_Medivas_Multiple_Multiple_IllhoofWounded_01	Mmm... ¡tengo tanto miedo!	
VO_Medivas_Multiple_Multiple_NetherspiteTurn1_01	¡Rayos!	
VO_Medivh_Male_Human_EmoteGreetings_01	¿Qué haces tú aquí?	
VO_Medivh_Male_Human_EmoteOops_01	¿Ese era tu plan?	
VO_Medivh_Male_Human_EmoteSorry_01	Oh, eso no salió bien...	
VO_Medivh_Male_Human_EmoteThanks_01	Qué amable de tu parte.	
VO_Medivh_Male_Human_EmoteThreaten_01	¡Nunca tuviste una posibilidad!	
VO_Medivh_Male_Human_EmoteWellPlayed_01	Buen intento, demonio.	
VO_Medivh_Male_Human_EmoteWow_01	¡Jaja! ¡Eso fue genial!	
VO_Medivh_Male_Human_FinalMalchezaarTurn5_01	Excelente trabajo, Moroes, ¡ya se está armando la fiesta!	
VO_Medivh_Male_Human_FinalMalchezaarWin_01	¡Bien hecho! Vamos, ¡es hora de festejar!	
VO_Medivh_Male_Human_FinalMedivhMedivhSkin_01	¡Ey, un momento! ¡¿Eres yo?! ¿Del futuro? Dime, ¿qué te pareció esta fiesta? Fue ESPECTACULAR, ¿o no?	
VO_Medivh_Male_Human_FinalThirdSequence_01	¡Ah, un invitado! Por favor, ¿podrías encargarte del demonio? ¡Yo tengo que ocuparme de la fiesta!	
VO_Medivh_Male_Human_FinalThirdSequence_02	¿Te dejó sin cartas? Puedes usar los portales.	
VO_Medivh_Male_Human_FinalThirdSequence_03	Toma, te presto mi báculo. Sirve para controlar los portales. Pero no lo rayes.	
VO_Medivh_Male_Human_PrologueDeath_02	¿Qué? Imposible...	
VO_Medivh_Male_Human_PrologueHeroPower_01	¡Pero esta fiesta no!	
VO_Medivh_Male_Human_PrologueOpen_01	Aj, ¿otra vez tú?	
VO_Medivh_Male_Human_PrologueTurn1_02	¿Después de lo que pasó la última vez? ¡Todavía estamos arreglando el agujero en el techo!	
VO_Medivh_Male_Human_PrologueTurn11_01	¿Ya lo oíste cantar karaoke? ¡Es increíble!	
VO_Medivh_Male_Human_PrologueTurn3_02	Moroes, vigila el tablero de ajedrez. Los verdaderos invitados llegarán pronto.	
VO_Medivh_Male_Human_PrologueTurn9_01	¡Globos! ¡Moroes, olvidamos los globos!	
VO_Medivh_Male_Human_PrologueWin_01	¡Vuelve a tu casa, demonio!	
VO_Medivh_Male_Human_Wing0Intro_01	Hemos animado la vajilla, ensayado la ópera y preparado la Sala de las Fieras. ¡Será una noche inolvidable!	
VO_Medivh_Male_Human_Wing4Win_01	¡Pasa, aventurero! ¡Disfruta la fiesta!	
VO_Mirror_Male_Mirror_MirrorDeath_01	¡Ey! ¡Hiciste trampa! ¡Quiero la revancha!	
VO_Mirror_Male_Mirror_MirrorEmoteResponse_01	¡No, tú!	
VO_Mirror_Male_Mirror_MirrorFirstCard_01	¿Tienes eso en tu mazo?	
VO_Mirror_Male_Mirror_MirrorMedivhSkin_01	¡Oh! ¡Medivh, señor! Se ha puesto muy elegante para... ¿Qué...? ¡Ey! ¡Un momento! ¡Usted no es Medivh!	
VO_Mirror_Male_Mirror_MirrorMirrorImage_01	¡Ey, esa es mi carta favorita! ¿Cuál es la tuya? ¿Furibundo de magma?	
VO_Mirror_Male_Mirror_MirrorOpen_02	¡QUÉ ONDAAAAAA!	
VO_Mirror_Male_Mirror_MirrorTurn1_01	¡Uy, qué feos!	
VO_Mirror_Male_Mirror_MirrorTurn3_01	Espejito, espejito, ¿quién es de todos el más bonito?	
VO_Mirror_Male_Mirror_MirrorTurn3_03	¡Tú no, abuelito!	
VO_Mirror_Male_Mirror_MirrorTurn5_02	¿Nefarius? Más bien Ne-flácido, ¿no?	
VO_Mirror_Male_Mirror_MirrorWellPlayedResponse_01	¡Desearía poder decir lo mismo! ¡BAZINGA!	
VO_Moroes_Male_Human_AranTurn1_01	*Suspiro* Le presento a Aran, el fantasma gruñón.	
VO_Moroes_Male_Human_AranTurn9_04	Los dragones han arrasado con el bufé. ¡Y ahora miran a los múrlocs con cariño!	
VO_Moroes_Male_Human_AranWin_01	¡El portal está en la próxima habitación! ¡Llegamos justo a tiempo!	
VO_Moroes_Male_Human_ChessForfeit_02	Se ha quedado sin piezas. Ha perdido la partida.	
VO_Moroes_Male_Human_ChessTurn1_03	Mire, las piezas atacarán automáticamente al final de su turno.	
VO_Moroes_Male_Human_ChessTurn3_01	Si una pieza está entre dos enemigos, ¡los atacará a los dos!	
VO_Moroes_Male_Human_ChessTurn5_01	La buena ubicación es la clave de la victoria. ¡Aproveche los ataques dobles!	
VO_Moroes_Male_Human_ChessTurn7_01	¡Los demás invitados esperan afuera! Ya casi estamos en la ópera, ¡pero debemos apresurarnos!	
VO_Moroes_Male_Human_ChessTurn7_02	No le quedan muchas piezas. Si las pierde todas, también perderá la partida.	
VO_Moroes_Male_Human_ChessTurn7_03	Señor, no le quedan muchas piezas. Si pierde todas, también perderá la partida.	
VO_Moroes_Male_Human_ChessWin_01	¡Excelente! Ahora, ¡a la ópera!	
VO_Moroes_Male_Human_CroneTurn5_02	El Mayordomo Executus está abajo. ¿Quiere que le diga que llegó demasiado temprano?	
VO_Moroes_Male_Human_CroneWin_01	¡Al fin! ¡Vamos a liberar al mago!	
VO_Moroes_Male_Human_CuratorTurn3_01	¡El Curator está confundido! ¡Tendrá que detenerlo antes de que los libere a todos!	
VO_Moroes_Male_Human_CuratorWin_01	Muy bien... un ajuste por aquí y... ¡como nuevo!	
VO_Moroes_Male_Human_EndWing1_01	¡Excelente! ¡La casa de la ópera está subiendo estas escaleras! ¡Seguro que Barnes nos dejará pasar rápido!	
VO_Moroes_Male_Human_FinalAltTurn5_01	Cuántos portales... Me pregunto qué habrá en este...	
VO_Moroes_Male_Human_FinalMaidenTurn1_01	Lo siento, encárguese de esto. Estoy seguro de que encontraré los controles indicados.	
VO_Moroes_Male_Human_FinalMaidenTurn7_03	Oh, ese es el mundo de los tentáculos. Le aseguro que no es lo que buscamos.	
VO_Moroes_Male_Human_FinalNazraTurn7_02	¡Haga retroceder a la orco para que podamos abrir otro portal!	
VO_Moroes_Male_Human_FinalSecondSequence_01	¡Excelente! Ahora veamos si este funciona...	
VO_Moroes_Male_Human_FInalStartSequence_01	Mmmm... Veamos. ¿Será este?	
VO_Moroes_Male_Human_FinalThirdSequence_01	¡Lo logré!	
VO_Moroes_Male_Human_FinalTurn1_02	¡Uy! Portal equivocado. Pelee contra la orco para que yo pueda intentarlo de nuevo.	
VO_Moroes_Male_Human_IllhoofKilrekResponse_01	¿Qué están tratando de invocar?	
VO_Moroes_Male_Human_JulianneTurn5_01	¡Déjanos pasar, Barnes! ¡Tenemos que encontrar a Medivh antes de que se arruine la fiesta!	
VO_Moroes_Male_Human_JulianneTurn9_02	¡Ha llegado Illidan! ¡No estamos preparados!	
VO_Moroes_Male_Human_MedivhSkinResponse_01	¿Un disfraz de Medivh? ¡Vaya, el parecido es fascinante!	
VO_Moroes_Male_Human_MirrorTurn3_01	Mmmmm...	
VO_Moroes_Male_Human_MirrorTurn5_01	Lord Nefarius llegará pronto. Tiemblo con solo pensar en su reacción.	
VO_Moroes_Male_Human_MirrorWin_02	¡Excelente! Las escaleras a la ópera están un poco más adelante.	
VO_Moroes_Male_Human_NetherspiteTurn1_01	Esos rayos fortalecen al dragón. ¡Use esbirros para bloquearlos!	
VO_Moroes_Male_Human_NetherspiteTurn5_01	¡Solo dinos dónde está Medivh!	
VO_Moroes_Male_Human_NetherspiteTurn7_01	¡Necesitamos esos portales! ¡Los invitados están lanzando libros a la reserva de maná!	
VO_Moroes_Male_Human_NetherspiteWin_01	¡Bien hecho! Ahora... si tan solo pudiera recordar cómo funciona esto...	
VO_Moroes_Male_Human_NightbaneTurn3_01	Curator, ¡tenemos que rescatar a Medivh!	
VO_Moroes_Male_Human_NightbaneTurn7_01	Ha llegado la Liga de Expedicionarios. RENO, ¡NO TOQUES LA VAJILLA!	
VO_Moroes_Male_Human_PrologueTurn11_01	*Ejem* Y no incendió la biblioteca...	
VO_Moroes_Male_Human_PrologueTurn5_03	Señor, los Medivas están listos. Barnes está ensayando con ellos.	
VO_Moroes_Male_Human_PrologueTurn7_01	¿Ya vio lo que está pasando afuera, señor? Los jefes de las bandas están armando un escándalo para conseguir una invitación.	
VO_Moroes_Male_Human_PrologueTurn9_02	Señor, los múrlocs les tienen pánico a los globos. ¿Ya olvidó lo que pasó la semana pasada?	
VO_Moroes_Male_Human_PrologueWin_02	Mmm, esto no está bien. Esto no está nada bien.	
VO_Moroes_Male_Human_SilverwareResponse_01	Ooh. Eso era una antigüedad.	
VO_Moroes_Male_Human_SilverwareTurn3_02	¡La vajilla está trabajando en equipo! ¡Estamos rodeados!	
VO_Moroes_Male_Human_SilverwareWin_01	Ah, ¡qué desastre!	
VO_Moroes_Male_Human_Wing1Intro_02	Soy Moroes, administrador de Karazhan, y necesito su ayuda. ¡Medivh ha desaparecido! ¡Necesitaremos los portales de la cima de la torre para salvarlo y para salvar la fiesta!	
VO_Moroes_Male_Human_Wing1Win_01	¡Buen trabajo! A este paso, llegaremos a la cima de la torre a tiempo para salvar la fiesta.	
VO_Moroes_Male_Human_Wing2Win_01	¡Adelante! Al final de esas escaleras, el Curator protege la Sala de las Fieras. Espero que no haya sufrido ningún desperfecto...	
VO_Moroes_Male_Human_Wing3Open_02	El Curator protege la Sala de las Fieras, hogar de las criaturas más exóticas de Azeroth. Más adelante se encuentran los aposentos del maestro, ¡y el portal para salvar a Medivh!	
VO_Moroes_Male_Human_Wing3Win_02	¡Ya casi llegamos a la cima! ¡Tenemos que salvar a Medivh antes de que la fiesta se convierta en una gresca!	
VO_Moroes_Male_Human_Wing4Intro_01	¡Al fin! ¡La cima de la torre! ¡Encuentre el portal correcto y traiga a Medivh de regreso!	
VO_Moroes_Male_Human_Wing4Win_01	Lo logró. No puedo creer que la fiesta haya empezado a tiempo. ¿Podría regresar la próxima semana? Es el cumpleaños de Medivh y... eh, necesito refuerzos.	
VO_Moroes_Male_Human_WolfClaws_03	No creo que eso sea cierto...	
VO_NAX1_01_CARD_02	¡Solo un pequeño bocado!	
VO_NAX1_01_DEATH_05	¿Por qué...? ¡¿Por qué?!	
VO_NAX1_01_EMOTE_04	¡Oh! ¡Habla!	
VO_NAX1_01_HP_03	¡Acérquense, mis bocadillos!	
VO_NAX1_01_START_01	Ah, qué bueno verte por aquí...	
VO_NAX10_01_DEATH_LINE_03	¿Qué le ha sucedido a... Remen...? Aaaahrr...	
VO_NAX10_01_EMOTE1_04	¿Hora de juegar?	
VO_NAX10_01_EMOTE2_05	¡Sí! ¡A juegar! ¡Juegar!	
VO_NAX10_01_HP_02	¿No juegamos más?	
VO_NAX10_01_START_01	¡Remendejo quiere juegar!	
VO_NAX11_01_CARD_03	Lodo.	
VO_NAX11_01_DEATH_05	*ugh uh ahoh gowr grrrlrrlrrlaaahhh*	
VO_NAX11_01_EMOTE_04	No palabras.	
VO_NAX11_01_HP_02	Peste.	
VO_NAX11_01_START_01	Carne.	
VO_NAX12_01_CARD_01	*Rugido*	
VO_NAX12_01_DEATH_01	*Gimotea*	
VO_NAX12_01_EMOTE_01	*Gruñido*	
VO_NAX12_01_EMOTE_02	*Grrr*	
VO_NAX12_01_EMOTE_03	*Grrroooooo*	
VO_NAX12_01_HP_01	*Groooar GULP*	
VO_NAX12_01_START_01	*Refunfuño*	
VO_NAX13_01_DEATH_LINE_03	Gracias...	
VO_NAX13_01_EMOTE_04	¡A matar!	
VO_NAX13_01_HP_02	¡Muere ahora!	
VO_NAX13_01_START_01	¡Debo obedecer!	
VO_NAX14_01_CARD_01	*rrrrrAAAHH*	
VO_NAX14_01_DEATH_01	*Groooarrr...*	
VO_NAX14_01_EMOTE_01	*rrrr ¡Rrahhh!*	
VO_NAX14_01_EMOTE_02	*grraaaaah*	
VO_NAX14_01_EMOTE_03	*grooooaaar*	
VO_NAX14_01_HP_01	*groooarrr*	
VO_NAX14_01_START_01	*GROOOARRR*	
VO_NAX15_01_BIGGLES_32	¡No! ¡Maldito seas, intruso!	
VO_NAX15_01_DEATH_LINE_08	¡Este no es el fin! ¡Aún está el modo heroico!	
VO_NAX15_01_DEATH_LINE2_09	¡NooooOooOOOooo!	
VO_NAX15_01_EMOTE_HELLO_26	¿Siempre saludas a los que quieren matarte?	
VO_NAX15_01_EMOTE_OOPS_29	Sin dudas.	
VO_NAX15_01_EMOTE_SORRY_28	No te preocupes, intruso, todos nos equivocamos.	
VO_NAX15_01_EMOTE_THANKS_27	Ehh... ¿de nada?	
VO_NAX15_01_EMOTE_THREATEN_30	¡Oh, qué miedo!	
VO_NAX15_01_EMOTE_WP_25	Pfff, qué novedad... ¡Soy el maldito Kel'Thuzad!	
VO_NAX15_01_HP_07	¡Te congelaré la sangre de las venas!	
VO_NAX15_01_HP2_05	Ahora tu alma está ligada a mí.	
VO_NAX15_01_HP3_06	No habrá escapatoria.	
VO_NAX15_01_HURRY_31	Mi paciencia se agota.	
VO_NAX15_01_PHASE2_10	¡Insensato! ¡Ya casi has gastado tus poderes!	
VO_NAX15_01_PHASE2_ALT_11	¡No! Tu turno ya ha terminado. Ahora me toca a MÍ.	
VO_NAX15_01_RESPOND_ANDUIN_24	¡Qué ingenuo! ¿No recuerdas lo que le pasó a Uther?	
VO_NAX15_01_RESPOND_GARROSH_15	¿Lo dices en serio? Pues, muerte.	
VO_NAX15_01_RESPOND_GARROSH_ALT_16	¿Puedo elegir? ¡Pues parece que te espera la muerte!	
VO_NAX15_01_RESPOND_GULDAN_22	Alguien aquí se quedará con un alma, y no serás tú...	
VO_NAX15_01_RESPOND_JAINA_23	Por supuesto que no. ¡Tú irrumpiste en MI necrópolis flotante!	
VO_NAX15_01_RESPOND_MALFURION_ALT_21	¿Lo salvaje? Y entonces, ¿qué estás haciendo en Naxxramas?	
VO_NAX15_01_RESPOND_REXXAR_19	Como tú digas.	
VO_NAX15_01_RESPOND_THRALL_17	¿Peleas por un martillo? Bien por ti.	
VO_NAX15_01_RESPOND_UTHER_14	... y yo con esbirros enormes y hechizos devastadores. ¡Buena suerte!	
VO_NAX15_01_RESPOND_VALEERA_18	Sí, cómo no...	
VO_NAX15_01_START_13	Al fin nos conocemos.	
VO_NAX15_01_SUMMON_ADDS_12	¡Sean libres, mis esbirros!	
VO_NAX2_01_CARD_02	¡Mátalos en el nombre del amo!	
VO_NAX2_01_CUSTOM_03	¡Has fracasado!	
VO_NAX2_01_DEATH_LINE_05	¡El amo vengará mi muerte!	
VO_NAX2_01_EMOTE_06	¡Jajajajajaja!	
VO_NAX2_01_HP_04	¡Arrodíllate ante mí, sabandija!	
VO_NAX2_01_START_01	¡Mis acólitos me sirven! ¡No me cuestionan!	
VO_NAX3_01_CARD_01	*grghhghgh*	
VO_NAX3_01_DEATH_01	*siseo*	
VO_NAX3_01_EMOTE_01	*siseo*	
VO_NAX3_01_EMOTE_02	*siseo*	
VO_NAX3_01_EMOTE_03	*siseo*	
VO_NAX3_01_EMOTE_04	*siseo*	
VO_NAX3_01_EMOTE_05	*siseo*	
VO_NAX3_01_HP_01	*siseo*	
VO_NAX3_01_START_01	*escabulléndose*	
VO_NAX4_01_CARD_03	Aprovecha tu último aliento.	
VO_NAX4_01_DEATH_LINE_04	Serviré a mi amo en la muerte.	
VO_NAX4_01_EMOTE_06	¡Muere, intruso!	
VO_NAX4_01_HP_02	¡Levántense, mis soldados! ¡Levántense y luchen una vez más!	
VO_NAX4_01_START_01	Otra alma para la... "colección".	
VO_NAX5_01_CARD_03	¡Te dejaré deMENTE!	
VO_NAX5_01_DEATH_LINE_04	Ni la muerte limpiará las impurezas de mi alma.	
VO_NAX5_01_EMOTE_05	No tengo tiempo para estas tonterías.	
VO_NAX5_01_HP_02	¡Bailen, tontos!	
VO_NAX5_01_START_01	¿Y tú crees que estás a salvo aquí?	
VO_NAX6_01_CARD_03	El fin se acerca.	
VO_NAX6_01_DEATH_LINE_04	*rruuuhhhh*	
VO_NAX6_01_EMOTE_05	Desperdicias tu aliento.	
VO_NAX6_01_HP_02	Ahora me perteneces.	
VO_NAX6_01_START_01	Te veo.	
VO_NAX7_01_CARD_03	¡Deberías haberte quedado en casa!	
VO_NAX7_01_DEATH_LINE_04	Ugh... una muerte honorable.	
VO_NAX7_01_EMOTE_05	¡Ja! ¡Solo estoy entrando en calor!	
VO_NAX7_01_HP_02	¡Yieea!	
VO_NAX7_01_START_01	¡No! ¡No! ¡Mis estudiantes! ¡Devuélvemelos!	
VO_NAX8_01_CARD_02	Mata a mis esbirros si quieres... Sus almas te harán una visita.	
VO_NAX8_01_CUSTOM_03	¡Jajaja! ¡Idiota! ¡Soy el Cosechador de almas!	
VO_NAX8_01_CUSTOM2_04	¡Los muertos regresan!	
VO_NAX8_01_DEATH_LINE_05	¡Es mi fin!	
VO_NAX8_01_EMOTE1_06	Tu estupidez te ha llevado hasta la muerte.	
VO_NAX8_01_EMOTE2_07	¡Qué imprudente! Nunca subestimes los poderes que no conoces.	
VO_NAX8_01_EMOTE3_08	Has intentado invadir el reino del Cosechador con todas tus fuerzas.	
VO_NAX8_01_EMOTE4_09	Ahora solo te queda una salida...	
VO_NAX8_01_EMOTE5_10	... ir al menú de opciones y seleccionar RENDIRSE.	
VO_NAX8_01_START_01	Mis esbirros nunca mueren realmente.	
VO_NAX9_01_CUSTOM_02	Ya basta de parloteo. Que vengan.	
VO_NAX9_01_DEATH_LINE_03	¡No! ¡Necesito más tiempo!	
VO_NAX9_01_EMOTE_04	¿Andas en busca de la muerte?	
VO_NAX9_01_START_01	Pulverizaremos tus huesos.	
VO_NAX9_02_CUSTOM_01	¡Invasor! ¡Huye mientras puedas!	
VO_NAX9_03_CUSTOM_01	Ven, Zeliek, vamos a divertirnos.	
VO_NAX9_04_CUSTOM_01	¡Veamos qué tienes, tonto llorón!	
VO_Nazra_Female_Orc_FinalNazraChogall_02	¿El clan del Martillo Crepuscular? ¿Aquí?	
VO_Nazra_Female_Orc_FinalNazraDeath_01	Por la Horda...	
VO_Nazra_Female_Orc_FinalNazraEmoteResponse_01	¡Nazra te aplastará!	
VO_Nazra_Female_Orc_FinalNazraGrom_01	¡¿Grommash?! ¡Tanto tiempo!	
VO_Nazra_Female_Orc_FinalNazraHeroPower_01	¡Nazra reinará en este mundo patético!	
VO_Nazra_Female_Orc_FinalStartSequence_01	¡Tiembla ante la Horda!	
VO_NEFARIAN_ATRAMEDES_DEATH_76	Has matado a un dragón ciego. Qué vergüenza.	
VO_NEFARIAN_BARON_GEDDON_DEAD_40	Ya estamos cerca. Sí. ¡Sí!	
VO_NEFARIAN_CHROMAGGUS_DEAD_63	En realidad, Chromaggus era mi esbirro más débil. ¿Creíste que eso era todo?	
VO_NEFARIAN_CHROMAGGUS1_59	Le di dos cabezas porque pensé "¡Ey, el doble de mordeduras!"	
VO_NEFARIAN_CHROMAGGUS2_60	¡Le he concedido los poderes de todos los vuelos! ¡Es perfecto!	
VO_NEFARIAN_CHROMAGGUS3_61	Buen trabajo, Chromaggus. Buen chico.	
VO_NEFARIAN_CHROMAGGUS4_62	Oh, no, ¿se te está cansando la mano? ¡Muajaja! Buen perrito.	
VO_NEFARIAN_COREN_DEAD_28	El Tragapenas. Qué entretenido.	
VO_NEFARIAN_DRAKKISATH_DEAD_50	Estoy empezando a impacientarme.	
VO_NEFARIAN_DRAKKISATH_RESPOND_48	Sí, Drakkisath. Aventurero, aún estás del lado equivocado de la montaña.	
VO_NEFARIAN_DRAKKISATH1_49	Mira, mejor ve a jugar al modo clasificado. Esta aventura no es para ti.	
VO_NEFARIAN_GARR_DEAD1_38	Deberías tomar un trozo de Garr y arrojarlo contra la superficie del charco de lava de Ragnaros, a ver cuántas veces rebota. Eso le gustará.	
VO_NEFARIAN_GARR2_35	Oye, cuidado con las piedritas.	
VO_NEFARIAN_GARR3_36	Trata de no explotar. Aún te queda un Señor elemental por derrotar.	
VO_NEFARIAN_GARR4_37	¿Sabes algo? Me gusta verte en acción.	
VO_NEFARIAN_GRIMSTONE_DEAD1_30	¡Sigue así y pronto expulsaremos a Ragnaros de esta montaña!	
VO_NEFARIAN_HEROIC_BLOCK_77	No en el modo heroico.	
VO_NEFARIAN_MALORIAK_DEATH_PT1_72	¡Felicitaciones! ¡Qué logro tan sorprendente!	
VO_NEFARIAN_MALORIAK_DEATH_PT2_73	Creo que te concederé un nuevo título para conmemorar este momento.	
VO_NEFARIAN_MALORIAK_DEATH_PT3_74	Asesino de esbirros estúpidos, incompetentes y decepcionantes. Sí, te queda perfecto.	
VO_NEFARIAN_MALORIAK_TURN2_71	Maloriak, trata de no perder ante este mortal.	
VO_NEFARIAN_NEF_MISSION_66	¡Esto es trampa! ¡No voy a tolerarlo!	
VO_NEFARIAN_NEF2_65	¡No! ¡No! ¡Te destruiré!	
VO_NEFARIAN_OMNOTRON_DEAD_69	Me has ahorrado unas reparaciones muy costosas. Gracias.	
VO_NEFARIAN_OMOKK_DEAD_46	¡Esto no tiene ningún sentido!	
VO_NEFARIAN_OMOKK1_44	¿Qué haces aquí? Ragnaros ha muerto. Deberías estar celebrando con tus amigos.	
VO_NEFARIAN_OMOKK2_45	Estoy confundido. Aquí no hay ningún Ragnaros. Tu misión ha terminado. VETE A CASA.	
VO_NEFARIAN_RAZORGORE_DEAD_55	¡Esos huevos iban a usarse en experimentos gloriosos!	
VO_NEFARIAN_REND_DEAD_53	Mira, mortal. Estás metiéndote con el dragón equivocado.	
VO_NEFARIAN_REND1_52	Hasta este orco se da cuenta de que estás haciendo algo mal.	
VO_NEFARIAN_THAURISSAN_DEAD_32	¡Debiste haber asesinado a esa otra enana! ¡No dejes sobrevivientes!	
VO_NEFARIAN_THAURISSAN_DEAD2_33	Lograste matar a los dos enanos. Impresionante, aventurero.	
VO_NEFARIAN_VAEL_DEAD_57	¡Ja! ¡Has matado a uno de los buenos! ¿Estás triste?	
VO_Netherspite_Male_Dragon_NetherspiteAngryChicken_01	¿Tú otra vez? ¿Por qué estás siempre dentro de mis portales?	
VO_Netherspite_Male_Dragon_NetherspiteDeath_01	Mi obra...	
VO_Netherspite_Male_Dragon_NetherspiteEmoteResponse_01	¿Desafías a un dragón en su laboratorio?	
VO_Netherspite_Male_Dragon_NetherspiteEmpowerment_01	¡Tantos mundos! ¡Tanto que aprender!	
VO_Netherspite_Male_Dragon_NetherspiteOpen_01	¿Quién interrumpe mi investigación?	
VO_Netherspite_Male_Dragon_NetherspiteShadowBreath_01	¡Largo de aquí!	
VO_Netherspite_Male_Dragon_NetherspiteTurn12_01	If 12 murlocs leave the red portal at 4 o’clock, and C’Thun arrives at 5 o’clock...	
VO_Netherspite_Male_Dragon_NetherspiteTurn3_02	¡Mis experimentos! ¡No los toques!	
VO_Netherspite_Male_Dragon_NetherspiteTurn5_01	¡Deja de tocar los portales! ¡Las modulaciones de flujo están calibradas a la perfección!	
VO_Netherspite_Male_Dragon_NetherspiteTurn7_01	Esa fiesta parece divertida. ¿Por qué no vas ahí y dejas mis portales en paz?	
VO_Netherspite_Male_Dragon_NetherspiteUnstablePortal_01	Qué interesante. Mmmm... Desequilibrios fundamentales.	
VO_Netherspite_Male_Dragon_NetherspiteUnstablePortal_02	Qué interesante... Desequilibrios fundamentales...	
VO_Nightbane_Roar	*RUGIDO*	
VO_PrinceKeleseth_Male_Vampire_ResponseLanaThel_01	¡Mi reina!	
VO_PrinceTaldaram_Male_Vampire_ResponseLanaThel_01	Mi reina... tengo sed.	
VO_PrinceValanar_Male_Vampire_ResponseLanaThel_01	Reina Lana'thel.	
VO_RAGNAROS_GRIMSTONE_DEAD2_66	¡YO TE EXPULSARÉ A TI, CRÍA ESCAMOSA!	
VO_RAGNAROS_NEF1_71	¡AVENTURERO! ¡PARECE QUE NECESITAS AYUDA!	
VO_RAGNAROS_NEF3_72	¡LA VENGANZA SERÁ MÍA! ¡EL FUEGO TE PURGARÁ!	
VO_RAGNAROS_NEF4_73	¡ENVIARÉ A MIS ESBIRROS PARA DESTRUIRTE, ALANEGRA!	
VO_RAGNAROS_NEF5_74	¡CONVIERTAN A ESTE DRAGÓN ENGREÍDO EN CENIZAS!	
VO_RAGNAROS_NEF6_75	¡UN REGALO DE LAS TIERRAS DE FUEGO!	
VO_RAGNAROS_NEF7_76	¡NO PUEDES EXTINGUIR LAS LLAMAS DEL SEÑOR DEL FUEGO!	
VO_RAGNAROS_NEF8_77	¡ME VENGARÉ, DRAGÓN!	
VO_Rakanishu_Male_Elemental_CastSpell1_01	Tú no llevarte... ¡A MÍ!	
VO_Rakanishu_Male_Elemental_CastSpell2_01	¡Que el fuego te purifique! 	
VO_Rakanishu_Male_Elemental_CastSpell3_01	¡Muere, aventurero!	
VO_Rakanishu_Male_Elemental_CastSpell4_01	¡Por Rafaam!	
VO_Rakanishu_Male_Elemental_CastSpell5_01	¡Todo arderá!	
VO_Rakanishu_Male_Elemental_EventRagnaros_02	¡Mi héroe!	
VO_Rakanishu_Male_Elemental_Intro_01	¡Destruye! ¡Obtén el tesoro!	
VO_SilverwareGolem_Male_SilverwareGolem_SilverwareDeath_02	A guardar, a guardar; cada plato en su lugar...	
VO_SilverwareGolem_Male_SilverwareGolem_SilverwareEmoteResponse_01	¿Qué tal una pulida?	
VO_SilverwareGolem_Male_SilverwareGolem_SilverwareForkedLightning_01	¿Te gustan los tenedores? ¡Yo tengo tenedores!	
VO_SilverwareGolem_Male_SilverwareGolem_SilverwareHeroPower_01	¡Preparen la mesa! ¡Preparen el piso!	
VO_SilverwareGolem_Male_SilverwareGolem_SilverwareKnifeJuggler_01	¡Oooh, lanzamiento de cuchillos!	
VO_SilverwareGolem_Male_SilverwareGolem_SilverwareOpen_01	¡Me gusta bailar!	
VO_SilverwareGolem_Male_SilverwareGolem_SilverwarePlateTossing_01	¡Un plato para ti! ¡Un plato para ti! ¡Platos para todos!	
VO_TB_MEDIVA1_001	Arde...	
VO_TB_MEDIVA1_002	¡Cuidado!	
VO_TB_MEDIVA1_003	¡Oh, Tito!	
VO_TB_MEDIVA1_004	¡Salud!	
VO_TB_MEDIVA1_005	¡Bestial!	
VO_TB_MEDIVA1_006	Qué peluditos.	
VO_TB_MEDIVA1_007	¡No! Veneno no.	
VO_TB_MEDIVA1_008	¡Qué brillante!	
VO_TB_MEDIVA1_009	¿Necesitabas algo?	
VO_TB_MEDIVA2_001	¡Qué calor!	
VO_TB_MEDIVA2_002	¡Espeluznante!	
VO_TB_MEDIVA2_003	¡Ooh, qué frío!	
VO_TB_MEDIVA2_004	¡Oh, no! ¡Una trampa!	
VO_TB_MEDIVA2_005	Oh, no, no puedo mirar.	
VO_TB_MEDIVA2_006	Ter...nurita.	
VO_TB_MEDIVA2_007	Me encantan los diablillos.	
VO_TB_MEDIVA2_008	¡Qué brillante!	
VO_TB_MEDIVA2_009	¡Achú! ¡AJ!	
VO_TB_MEDIVA2_010	¿Tú me llamaste?	
VO_TB_MEDIVA3_001	¡Qué calor!	
VO_TB_MEDIVA3_002	¡Congélate, muñeco de nieve!	
VO_TB_MEDIVA3_003	¡Tenebrosa oscuridad!	
VO_TB_MEDIVA3_004	¡Una trampa!	
VO_TB_MEDIVA3_005	¡Eso es lo que yo llamo bestias!	
VO_TB_MEDIVA3_006	¡Este tipo tiene mascotas!	
VO_TB_MEDIVA3_007	Ay, no, qué mala onda.	
VO_TB_MEDIVA3_008	Eso es lo que yo llamo veneno...	
VO_TB_MEDIVA3_009	Y ahora... ¡los Medivas!	
VO_TB_MEDIVA3_010	¡Sííí!	
VO_Terenas_Male_Human_ICCDruidVictory_01	En una época, era un protector de la vida y cuidaba de la naturaleza de Azeroth. Ahora, Malfurion el Pestilente cuida un jardín de muerte y se encarga de mantener el equilibrio de la naturaleza.	
VO_Terenas_Male_Human_ICCHunterVictory_01	Rexxar liberó las almas que habían sido presas del Rey Exánime. Sacó una flecha negra de su carcaj. "¡Vamos, Misha!", dijo. "La cacería comienza..."	
VO_Terenas_Male_Human_ICCMageVictory_01	La recientemente coronada Exánime gélida contempló sus dominios. Legiones de no-muertos acudieron y le otorgaron su poder. Ni siquiera se dio cuenta cuando su sangre se congeló.	
VO_Terenas_Male_Human_ICCPaladinVictory_01	El alguna vez noble Paladín aceptó su nuevo destino. Los que habían llevado una vida digna no tenían nada que temer. Pero al morir, los perversos se enfrentarían a su juicio... 	
VO_Terenas_Male_Human_ICCPriestVictory_01	El cuerpo del joven príncipe se convirtió en sombras. "Ahora entiendo", dijo mientras las llamas azules ardían en sus ojos. "He sido tan ingenuo..."	
VO_Terenas_Male_Human_ICCRogueVictory_01	Valeera la Impasible desapareció en la noche. Sus sombras y penumbras lo ven todo, y nadie está a salvo de su filo gélido...	
VO_Terenas_Male_Human_ICCShamanVictory_01	La mente del chamán se vio abrumada de voces, una cacofonía de los muertos. El Muertevidente cerró los ojos y pronunció una sola palabra: "Duerme..."	
VO_Terenas_Male_Human_ICCWarlockVictory_01	Finalmente, Gul'dan se sentó en el Trono Helado. El Portal Oscuro se abrió una vez más, y una infinidad de mundos temblaron ante él.	
VO_Terenas_Male_Human_ICCWarriorVictory_01	El otrora Jefe de guerra de la Horda aceptó su nuevo poder. Los cadáveres congelados de las víctimas de su ejército se alzarían para servir, hasta que él fuera el único amo de todo lo que su vista alcanzaba.	
VO_TIRION_INTRO_03	¿Quién de todos ustedes, nobles caballeros, se alzará con el título de Campeón?
VO_WhiteKing_Male_ChessPiece_ChessDeath_01	Jaque mate...	
VO_WhiteKing_Male_ChessPiece_ChessEmoteGreetings_01	¿Qué tal una partida?	
VO_WhiteKing_Male_ChessPiece_ChessEmoteOops_01	Oh, un error.	
VO_WhiteKing_Male_ChessPiece_ChessEmoteSorry_01	Un giro desafortunado.	
VO_WhiteKing_Male_ChessPiece_ChessEmoteThanks_01	Pero qué amable.	
VO_WhiteKing_Male_ChessPiece_ChessEmoteThinking_01	Torre a A3...	
VO_WhiteKing_Male_ChessPiece_ChessEmoteThinking_02	Caballo a F6...	
VO_WhiteKing_Male_ChessPiece_ChessEmoteThinking_03	Reina a E5... No, no…	
VO_WhiteKing_Male_ChessPiece_ChessEmoteThreaten_01	Jaque mate en 4.	
VO_WhiteKing_Male_ChessPiece_ChessEmoteWellPlayed_01	Jaque mate.	
VO_WhiteKing_Male_ChessPiece_ChessEmoteWow_01	¡Ah, excepcional!	
VO_WhiteKing_Male_ChessPiece_ChessOpen_02	¡En garde!	
VOX_Nightbane_Start_01	¡Rrrraaarr!	
