TAG	TEXT	COMMENT
GAMEPLAY_EMOTE_EX1_323h_CONCEDE	เจ้าชนะ... แต่โลกก็ถึงกาลอวสานอยู่ดี!	
GAMEPLAY_EMOTE_EX1_323h_ERROR_FULL_MINIONS	มินเนี่ยนมากเกินไป	
GAMEPLAY_EMOTE_EX1_323h_ERROR_GENERIC	ทำแบบนั้นไม่ได้	
GAMEPLAY_EMOTE_EX1_323h_ERROR_HAND_FULL	การ์ดมากเกินไป!	
GAMEPLAY_EMOTE_EX1_323h_ERROR_I_ATTACKED	ข้าโจมตีแล้ว	
GAMEPLAY_EMOTE_EX1_323h_ERROR_JUST_PLAYED	มันเพิ่งมา!	
GAMEPLAY_EMOTE_EX1_323h_ERROR_MINION_ATTACKED	มันโจมตีไปแล้ว	
GAMEPLAY_EMOTE_EX1_323h_ERROR_NEED_MANA	มานาไม่พอ!	
GAMEPLAY_EMOTE_EX1_323h_ERROR_NEED_WEAPON	อาวุธข้าหายไปไหน?	
GAMEPLAY_EMOTE_EX1_323h_ERROR_PLAY	เล่นใบนั้นไม่ได้	
GAMEPLAY_EMOTE_EX1_323h_ERROR_STEALTH	มันซ่อนตัวอยู่	
GAMEPLAY_EMOTE_EX1_323h_ERROR_TARGET	ไม่ได้	
GAMEPLAY_EMOTE_EX1_323h_ERROR_TAUNT	มินเนี่ยนที่ยั่วยุขวางทางอยู่!	
GAMEPLAY_EMOTE_EX1_323h_FIRE_FESTIVAL	จุดไฟซะ!	
GAMEPLAY_EMOTE_EX1_323h_GOOD_GAME	เป็นเกมที่ดี!	
GAMEPLAY_EMOTE_EX1_323h_GREETINGS	เจ้าเผชิญหน้ากับ จาแร็กซ์ซัส ลอร์ดเอเรดาร์ แห่งจักรวรรดิเปลวเพลิง!	
GAMEPLAY_EMOTE_EX1_323h_HALLOWS_END	เทศกาลฮอลโลว์สจบลง พร้อมชีวิตเจ้า!	
GAMEPLAY_EMOTE_EX1_323h_LOW_CARDS	เด็คข้า! การ์ดใกล้จะหมดแล้ว!	
GAMEPLAY_EMOTE_EX1_323h_LUNAR_NEW_YEAR	เจ้าเผชิญหน้ากับ จาแร็กซ์ซัส ลอร์ดเอเรดาร์ แห่งจักรวรรดิเปลวเพลิง!	
GAMEPLAY_EMOTE_EX1_323h_NO_CARDS	ไม่จริง! การ์ดข้าหมดแล้ว!	
GAMEPLAY_EMOTE_EX1_323h_NOBLEGARDEN	สุขสันต์เทศกาล[b]โนเบิ้ลการ์เด้น!	
GAMEPLAY_EMOTE_EX1_323h_OOPS	พลาด!	
GAMEPLAY_EMOTE_EX1_323h_PIRATE_DAY	ข้าคือจาาาาาาแร็กซ์ซัส!	
GAMEPLAY_EMOTE_EX1_323h_SORRY	จาแร็กซ์ซัส เสีย ใจ	
GAMEPLAY_EMOTE_EX1_323h_THANKS	ขอบใจ	
GAMEPLAY_EMOTE_EX1_323h_THINK1	อืมมม...	
GAMEPLAY_EMOTE_EX1_323h_THINK2	ขอคิดก่อน...	
GAMEPLAY_EMOTE_EX1_323h_THINK3	ข้าจะบดขยี้เจ้ายังไงดี...	
GAMEPLAY_EMOTE_EX1_323h_THREATEN	นรกรอเจ้าอยู่!!!	
GAMEPLAY_EMOTE_EX1_323h_TIMER	เวลาจะหมดแล้ว!	
GAMEPLAY_EMOTE_EX1_323h_WELL_PLAYED	เล่นดีนี่!	
GAMEPLAY_EMOTE_EX1_323h_WINTERVEIL_GREETINGS	ข้าจะฉลองวินเทอร์เวลด้วยการกินวิญญาณเจ้า!	
GAMEPLAY_EMOTE_EX1_323h_WOW_04	เป็นไปไม่ได้!	
GAMEPLAY_EMOTE_HERO_01_CONCEDE	ข้ายอมตาย!	
GAMEPLAY_EMOTE_HERO_01_ERROR_FULL_MINIONS	ข้ามีมินเนี่ยนมากเกินไป	
GAMEPLAY_EMOTE_HERO_01_ERROR_GENERIC	ข้าทำแบบนั้นไม่ได้	
GAMEPLAY_EMOTE_HERO_01_ERROR_HAND_FULL	การ์ดเต็มมือข้าแล้ว!	
GAMEPLAY_EMOTE_HERO_01_ERROR_I_ATTACKED	ข้าโจมตีแล้ว	
GAMEPLAY_EMOTE_HERO_01_ERROR_JUST_PLAYED	ให้มินเนี่ยนเตรียมพร้อม ซักเทิร์นสิ	
GAMEPLAY_EMOTE_HERO_01_ERROR_MINION_ATTACKED	มินเนี่ยนตัวนั้นโจมตีไปแล้ว	
GAMEPLAY_EMOTE_HERO_01_ERROR_NEED_MANA	มานาข้าไม่พอ	
GAMEPLAY_EMOTE_HERO_01_ERROR_NEED_WEAPON	ข้าต้องมีอาวุธ	
GAMEPLAY_EMOTE_HERO_01_ERROR_PLAY	ข้าเล่นใบนั้นไม่ได้	
GAMEPLAY_EMOTE_HERO_01_ERROR_STEALTH	เลือกมินเนี่ยนที่ซ่อนตัว เป็นเป้าหมายไม่ได้	
GAMEPLAY_EMOTE_HERO_01_ERROR_TARGET	ไม่ใช่เป้าหมายที่ถูกต้อง	
GAMEPLAY_EMOTE_HERO_01_ERROR_TAUNT	มินเนี่ยนที่ยั่วยุขวางทางอยู่	
GAMEPLAY_EMOTE_HERO_01_EVENT_FIRE_FESTIVAL	จุดไฟเลย!	
GAMEPLAY_EMOTE_HERO_01_EVENT_LUNAR_NEW_YEAR	เฮะ สวัสดี	
GAMEPLAY_EMOTE_HERO_01_GOOD_GAME	เป็นเกมที่ดี!	
GAMEPLAY_EMOTE_HERO_01_GREETINGS	เฮะ สวัสดี	
GAMEPLAY_EMOTE_HERO_01_HALLOWS_END	สุขสันต์เทศกาล[b]ฮอลโลว์สเอนด์	
GAMEPLAY_EMOTE_HERO_01_LOW_CARDS	การ์ดข้าใกล้จะหมดแล้ว!	
GAMEPLAY_EMOTE_HERO_01_MIRROR_START	ฮ่าฮ่าฮ่า! เข้ามาเลย!	
GAMEPLAY_EMOTE_HERO_01_NO_CARDS	ข้าไม่มีการ์ดเหลือแล้ว!	
GAMEPLAY_EMOTE_HERO_01_NOBLEGARDEN	สุขสันต์เทศกาล[b]โนเบิ้ลการ์เด้น!	
GAMEPLAY_EMOTE_HERO_01_OOPS	พลาดจนได้	
GAMEPLAY_EMOTE_HERO_01_PIRATE_DAY	ยาร์-ดี-ฮาร์ดี ฮาร์ ยี้ ฮ่าร์!	
GAMEPLAY_EMOTE_HERO_01_SORRY	เสียใจด้วย	
GAMEPLAY_EMOTE_HERO_01_START	ชัยชนะหรือความตาย!	
GAMEPLAY_EMOTE_HERO_01_THANKS	ขอบใจ	
GAMEPLAY_EMOTE_HERO_01_THINK1	อืมมม...	
GAMEPLAY_EMOTE_HERO_01_THINK2	อืมมม... ข้าว่า...	
GAMEPLAY_EMOTE_HERO_01_THINK3	เอาไงดีล่ะ....	
GAMEPLAY_EMOTE_HERO_01_THREATEN	ข้าจะบดขยี้เจ้า!	
GAMEPLAY_EMOTE_HERO_01_TIMER	ต้องเลือกแล้ว!	
GAMEPLAY_EMOTE_HERO_01_WELL_PLAYED	ไม่ธรรมดา	
GAMEPLAY_EMOTE_HERO_01_WINTERVEIL_GREETINGS	สุขสันต์งานฉลองวินเทอร์เวล!	
GAMEPLAY_EMOTE_HERO_01_WOW	น่าทึ่งมาก!	
GAMEPLAY_EMOTE_HERO_01A_CELEBRATE	ฮิป ฮิป ฮูเร่!	
GAMEPLAY_EMOTE_HERO_01A_CONCEDE	เจ้าชนะแล้ว	
GAMEPLAY_EMOTE_HERO_01A_ERROR_FULL_MINIONS	ข้ามีมินเนี่ยนมากเกินไปแล้ว	
GAMEPLAY_EMOTE_HERO_01A_ERROR_GENERIC	ทำแบบนั้นไม่ได้	
GAMEPLAY_EMOTE_HERO_01A_ERROR_HAND_FULL	การ์ดเต็มมือแล้ว!	
GAMEPLAY_EMOTE_HERO_01A_ERROR_I_ATTACKED	ข้าโจมตีไปแล้ว	
GAMEPLAY_EMOTE_HERO_01A_ERROR_JUST_PLAYED	ให้มินเนี่ยนเตรียมพร้อม ซักเทิร์นสิ	
GAMEPLAY_EMOTE_HERO_01A_ERROR_MINION_ATTACKED	มินเนี่ยนตัวนั้นโจมตีไปแล้ว	
GAMEPLAY_EMOTE_HERO_01A_ERROR_NEED_MANA	มานาไม่พอแล้ว	
GAMEPLAY_EMOTE_HERO_01A_ERROR_NEED_WEAPON	ข้าต้องมีอาวุธ	
GAMEPLAY_EMOTE_HERO_01A_ERROR_PLAY	เล่นใบนั้นไม่ได้	
GAMEPLAY_EMOTE_HERO_01A_ERROR_STEALTH	เลือกมินเนี่ยนที่ ซ่อนตัวอยู่ไม่ได้	
GAMEPLAY_EMOTE_HERO_01A_ERROR_TARGET	นั่นไม่ใช่เป้าหมายที่ถูกต้อง	
GAMEPLAY_EMOTE_HERO_01A_ERROR_TAUNT	ข้าต้องโจมตีมินเนี่ยนที่ยั่วยุนั่น	
GAMEPLAY_EMOTE_HERO_01A_EVENT_LUNAR_NEW_YEAR	เฮ้ สวัสดี!	
GAMEPLAY_EMOTE_HERO_01A_FIRE_FESTIVAL	สุขสันต์เทศกาลไฟ[b]มิดซัมเมอร์!	
GAMEPLAY_EMOTE_HERO_01A_GOOD_GAME	เป็นเกมที่ดี	
GAMEPLAY_EMOTE_HERO_01A_GREETINGS	เฮ้ สวัสดี!	
GAMEPLAY_EMOTE_HERO_01A_HALLOWS_END	สุขสันต์เทศกาล[b]ฮอลโลว์สเอนด์นะสหาย	
GAMEPLAY_EMOTE_HERO_01A_LOW_CARDS	การ์ดข้าจะหมดแล้วนะ	
GAMEPLAY_EMOTE_HERO_01A_MIRROR_START	ใช่! คาซโมดาน!	
GAMEPLAY_EMOTE_HERO_01A_NO_CARDS	การ์ดหมดแล้ว!	
GAMEPLAY_EMOTE_HERO_01A_NOBLEGARDEN	สุขสันต์เทศกาล[b]โนเบิ้ลการ์เด้น!	
GAMEPLAY_EMOTE_HERO_01A_OOPS	พลาดไปแล้ว	
GAMEPLAY_EMOTE_HERO_01A_PIRATE_DAY	ยาร์! ข้าคือราชาแห่งท้องทะเล!	
GAMEPLAY_EMOTE_HERO_01A_SORRY	โทษทีนะสหาย	
GAMEPLAY_EMOTE_HERO_01A_START	เพื่อคาซโมดาน!	
GAMEPLAY_EMOTE_HERO_01A_THANKS	ขอบใจ!	
GAMEPLAY_EMOTE_HERO_01A_THINK1	อืมม...	
GAMEPLAY_EMOTE_HERO_01A_THINK2	เอางี้ดีมั้ย... ไม่ ไม่ ไม่ ไม่...	
GAMEPLAY_EMOTE_HERO_01A_THINK3	เลือกยากซะจริง...	
GAMEPLAY_EMOTE_HERO_01A_THREATEN	เจ้าจะได้เห็นโทสะแห่งขุนเขา!	
GAMEPLAY_EMOTE_HERO_01A_TIMER	ต้องรีบลงมือแล้ว!	
GAMEPLAY_EMOTE_HERO_01A_WELL_PLAYED	เจ๋งนี่หว่า	
GAMEPLAY_EMOTE_HERO_01A_WINTERVEIL_GREETINGS	สุขสันต์งานฉลองวินเทอร์เวล!	
GAMEPLAY_EMOTE_HERO_01A_WOW	ให้ตายสิ!	
GAMEPLAY_EMOTE_HERO_02_CONCEDE	เจ้าชนะแล้ว สหาย	
GAMEPLAY_EMOTE_HERO_02_ERROR_FULL_MINIONS	ข้ามีมินเนี่ยนมากเกินไปแล้ว	
GAMEPLAY_EMOTE_HERO_02_ERROR_GENERIC	ข้าทำแบบนั้นไม่ได้	
GAMEPLAY_EMOTE_HERO_02_ERROR_HAND_FULL	การ์ดเต็มมือแล้ว!	
GAMEPLAY_EMOTE_HERO_02_ERROR_I_ATTACKED	ข้าโจมตีไปแล้ว	
GAMEPLAY_EMOTE_HERO_02_ERROR_JUST_PLAYED	ให้มินเนี่ยนตัวนั้น เตรียมพร้อมสักเทิร์นเถอะ	
GAMEPLAY_EMOTE_HERO_02_ERROR_MINION_ATTACKED	มินเนี่ยนตัวนั้นโจมตีไปแล้ว	
GAMEPLAY_EMOTE_HERO_02_ERROR_NEED_MANA	ข้ามีมานาไม่พอ	
GAMEPLAY_EMOTE_HERO_02_ERROR_NEED_WEAPON	ข้าต้องมีอาวุธ	
GAMEPLAY_EMOTE_HERO_02_ERROR_PLAY	ข้าเล่นแบบนั้นไม่ได้	
GAMEPLAY_EMOTE_HERO_02_ERROR_STEALTH	เลือกมินเนี่ยนที่ซ่อนตัว เป็นเป้าหมายไม่ได้	
GAMEPLAY_EMOTE_HERO_02_ERROR_TARGET	ไม่ใช่เป้าหมายที่ถูกต้อง	
GAMEPLAY_EMOTE_HERO_02_ERROR_TAUNT	มินเนี่ยนที่ยั่วยุขวางทางอยู่	
GAMEPLAY_EMOTE_HERO_02_EVENT_FIRE_FESTIVAL	เทศกาลแห่งพลังธาตุ!	
GAMEPLAY_EMOTE_HERO_02_EVENT_LUNAR_NEW_YEAR	สวัสดี สหาย	
GAMEPLAY_EMOTE_HERO_02_GOOD_GAME	เป็นเกมที่ดี	
GAMEPLAY_EMOTE_HERO_02_GREETINGS	สวัสดี สหาย	
GAMEPLAY_EMOTE_HERO_02_HALLOWS_END	สุขสันต์เทศกาล[b]ฮอลโลว์สเอนด์	
GAMEPLAY_EMOTE_HERO_02_LOW_CARDS	การ์ดของข้าใกล้หมดแล้ว!	
GAMEPLAY_EMOTE_HERO_02_MIRROR_START	เพื่อฟรอสต์วูล์ฟ!	
GAMEPLAY_EMOTE_HERO_02_NO_CARDS	การ์ดหมดแล้ว!	
GAMEPLAY_EMOTE_HERO_02_NOBLEGARDEN	สุขสันต์เทศกาล[b]โนเบิ้ลการ์เด้น[b]นะสหาย	
GAMEPLAY_EMOTE_HERO_02_OOPS	ข้าทำพลาด	
GAMEPLAY_EMOTE_HERO_02_PIRATE_DAY	วันแห่งโจรสลัด ยาร์ ออกทะเลได้!	
GAMEPLAY_EMOTE_HERO_02_SORRY	เสียใจด้วยจริงๆ	
GAMEPLAY_EMOTE_HERO_02_START	เพื่อดูมแฮมเมอร์!	
GAMEPLAY_EMOTE_HERO_02_THANKS	ข้าขอขอบใจ	
GAMEPLAY_EMOTE_HERO_02_THINK1	อืมมม...	
GAMEPLAY_EMOTE_HERO_02_THINK2	ข้าว่า...	
GAMEPLAY_EMOTE_HERO_02_THINK3	อืมม... เอายังไงดี...	
GAMEPLAY_EMOTE_HERO_02_THREATEN	พลังแห่งธาตุจะทำลายเจ้า!	
GAMEPLAY_EMOTE_HERO_02_TIMER	เหลือเวลาไม่มากแล้ว!	
GAMEPLAY_EMOTE_HERO_02_WELL_PLAYED	เล่นได้เยี่ยม	
GAMEPLAY_EMOTE_HERO_02_WINTERVEIL_GREETINGS	สุขสันต์งานฉลองวินเทอร์เวล!	
GAMEPLAY_EMOTE_HERO_02_WOW	นั่นมันยอดมาก!	
GAMEPLAY_EMOTE_HERO_02A_CELEBRATE	<ฉลอง!>	
GAMEPLAY_EMOTE_HERO_02A_CONCEDE	<ข้าพ่ายแพ้หมดรูป>	
GAMEPLAY_EMOTE_HERO_02A_ERROR_FULL_MINIONS	<ข้ามีมินเนี่ยน\nมากเกินไปแล้ว>	
GAMEPLAY_EMOTE_HERO_02A_ERROR_GENERIC	<ทำแบบนั้น\nไม่ได้>	
GAMEPLAY_EMOTE_HERO_02A_ERROR_HAND_FULL	<การ์ดเต็ม\nมือแล้ว>	
GAMEPLAY_EMOTE_HERO_02A_ERROR_I_ATTACKED	<ข้าโจมตี\nไปแล้ว>	VO_HERO_15_ERROR04_43.wav
GAMEPLAY_EMOTE_HERO_02A_ERROR_JUST_PLAYED	<ขอเวลาให้\nมินเนี่ยนตัวนั้นก่อน>	
GAMEPLAY_EMOTE_HERO_02A_ERROR_MINION_ATTACKED	<มินเนี่ยนตัวนั้น\nโจมตีไปแล้ว>	
GAMEPLAY_EMOTE_HERO_02A_ERROR_NEED_MANA	<ข้าต้องมีมานามากกว่านี้>	
GAMEPLAY_EMOTE_HERO_02A_ERROR_NEED_WEAPON	<ข้าต้องมีอาวุธ>	
GAMEPLAY_EMOTE_HERO_02A_ERROR_PLAY	<ข้าเล่นแบบนั้นไม่ได้>	
GAMEPLAY_EMOTE_HERO_02A_ERROR_STEALTH	<เลือกมินเนี่ยน\nที่ซ่อนตัวอยู่ไม่ได้!>	
GAMEPLAY_EMOTE_HERO_02A_ERROR_TARGET	<เป้าหมาย\nไม่ถูกต้อง>	
GAMEPLAY_EMOTE_HERO_02A_ERROR_TAUNT	<ข้าผ่านมินเนี่ยน\nที่ยั่วยุไปไม่ได้>	
GAMEPLAY_EMOTE_HERO_02A_EVENT_LUNAR_NEW_YEAR	<ปีใหม่นี้ ขอให้เจ้า\nรุ่งเรือง!>	
GAMEPLAY_EMOTE_HERO_02A_FIRE_FESTIVAL	<บ้านเกิดข้าไม่มี\nเทศกาลไฟหรอก>	
GAMEPLAY_EMOTE_HERO_02A_GREETINGS	<สวัสดีสหาย>	
GAMEPLAY_EMOTE_HERO_02A_HALLOWS_END	<ขอให้ขนลุกกับฮอลโลว์ส\nเอนด์ ลูกอ๊อดทั้งหลาย>	
GAMEPLAY_EMOTE_HERO_02A_LOW_CARDS	<การ์ดข้า\nใกล้จะหมดแล้ว!>	
GAMEPLAY_EMOTE_HERO_02A_MIRROR_START	<เด็กน้อย!? เจ้ายังต้อง\nเรียนรู้อีกเยอะ>	
GAMEPLAY_EMOTE_HERO_02A_NO_CARDS	<ข้าไม่มีการ์ดเหลือแล้ว!>	
GAMEPLAY_EMOTE_HERO_02A_NOBLEGARDEN	<สุขสันต์เทศกาล\nโนเบิ้ลการ์เด้น!>	
GAMEPLAY_EMOTE_HERO_02A_OOPS	<คำสาป!>	
GAMEPLAY_EMOTE_HERO_02A_PIRATE_DAY	<โจรสลัดเหรอ!? \nเรามาที่นี่ก่อนนะ!>	
GAMEPLAY_EMOTE_HERO_02A_SORRY	<ขอโทษด้วย\nเด็กน้อย>	
GAMEPLAY_EMOTE_HERO_02A_START	<ถึงเวลาเรียนรู้แล้ว\nเด็กน้อย!>	
GAMEPLAY_EMOTE_HERO_02A_THANKS	<ข้าซาบซึ้ง\nอย่างยิ่ง>	
GAMEPLAY_EMOTE_HERO_02A_THINK1	<ข้าขอ....>	VO_HERO_15_Thinking1_13.wav
GAMEPLAY_EMOTE_HERO_02A_THINK2	<เป็นความคิด\nที่ดี....>	
GAMEPLAY_EMOTE_HERO_02A_THINK3	<ความเป็นไปได้....>	
GAMEPLAY_EMOTE_HERO_02A_THREATEN	<ท้องทะเลจะ\nสั่งสอนเจ้า!>	
GAMEPLAY_EMOTE_HERO_02A_TIMER	<รีบหน่อย \nเร็วเข้า!>	
GAMEPLAY_EMOTE_HERO_02A_WELL_PLAYED	<ทำได้ดี>	
GAMEPLAY_EMOTE_HERO_02A_WINTERVEIL_GREETINGS	<ขอให้เจ้ามีความสุขกับ\nวินเทอร์เวล>	
GAMEPLAY_EMOTE_HERO_02A_WOW	<เหลือเชื่อ!>	
GAMEPLAY_EMOTE_HERO_03_CONCEDE	ข้ายอมแพ้	
GAMEPLAY_EMOTE_HERO_03_ERROR_FULL_MINIONS	มีมินเนี่ยนมากเกินไปแล้ว	
GAMEPLAY_EMOTE_HERO_03_ERROR_GENERIC	ทำไม่ได้	
GAMEPLAY_EMOTE_HERO_03_ERROR_HAND_FULL	การ์ดเต็มมือแล้ว!	
GAMEPLAY_EMOTE_HERO_03_ERROR_I_ATTACKED	ข้าโจมตีไปแล้ว	
GAMEPLAY_EMOTE_HERO_03_ERROR_JUST_PLAYED	ให้มินเนี่ยนตัวนั้น เตรียมพร้อมสักเทิร์นเถอะ	
GAMEPLAY_EMOTE_HERO_03_ERROR_MINION_ATTACKED	มินเนี่ยนตัวนั้นโจมตีไปแล้ว	
GAMEPLAY_EMOTE_HERO_03_ERROR_NEED_MANA	มานาไม่พอ	
GAMEPLAY_EMOTE_HERO_03_ERROR_NEED_WEAPON	ข้าต้องมีอาวุธ	
GAMEPLAY_EMOTE_HERO_03_ERROR_PLAY	ข้าเล่นแบบนั้นไม่ได้	
GAMEPLAY_EMOTE_HERO_03_ERROR_STEALTH	เลือกมินเนี่ยนที่ซ่อนตัว เป็นเป้าหมายไม่ได้	
GAMEPLAY_EMOTE_HERO_03_ERROR_TARGET	เลือกเจ้านั่นเป็นเป้าหมายไม่ได้	
GAMEPLAY_EMOTE_HERO_03_ERROR_TAUNT	มินเนี่ยนที่ยั่วยุขวางทางอยู่	
GAMEPLAY_EMOTE_HERO_03_EVENT_LUNAR_NEW_YEAR	ดีใจที่ได้เจอ	
GAMEPLAY_EMOTE_HERO_03_FIRE_FESTIVAL	สุขสันต์มิดซัมเมอร์	
GAMEPLAY_EMOTE_HERO_03_GOOD_GAME	เป็นเกมที่ดี	
GAMEPLAY_EMOTE_HERO_03_GREETINGS	ดีใจที่ได้เจอ	
GAMEPLAY_EMOTE_HERO_03_HALLOWS_END	สุขสันต์เทศกาล[b]ฮอลโลว์สเอนด์	
GAMEPLAY_EMOTE_HERO_03_LOW_CARDS	การ์ดข้าใกล้หมดแล้ว!	
GAMEPLAY_EMOTE_HERO_03_MIRROR_START	ไม่ต้องห่วง	
GAMEPLAY_EMOTE_HERO_03_NO_CARDS	การ์ดหมดแล้ว!	
GAMEPLAY_EMOTE_HERO_03_NOBLEGARDEN	สุขสันต์เทศกาล[b]โนเบิ้ลการ์เด้น	
GAMEPLAY_EMOTE_HERO_03_OOPS	พลาดซะแล้ว	
GAMEPLAY_EMOTE_HERO_03_PIRATE_DAY	ย้าาา!	
GAMEPLAY_EMOTE_HERO_03_SORRY	ขอโทษที	
GAMEPLAY_EMOTE_HERO_03_START	ระวังตัวให้ดี	
GAMEPLAY_EMOTE_HERO_03_THANKS	ขอบใจ	
GAMEPLAY_EMOTE_HERO_03_THINK1	อืมมม...	
GAMEPLAY_EMOTE_HERO_03_THINK2	ยังไงดี...	
GAMEPLAY_EMOTE_HERO_03_THINK3	เลือกยากจริงๆ...	
GAMEPLAY_EMOTE_HERO_03_THREATEN	เตรียมตัวตายได้เลย!	
GAMEPLAY_EMOTE_HERO_03_TIMER	ข้าต้องรีบเลือกแล้ว!	
GAMEPLAY_EMOTE_HERO_03_WELL_PLAYED	ร้ายกาจมาก	
GAMEPLAY_EMOTE_HERO_03_WINTERVEIL_GREETINGS	สุขสันต์งานฉลองวินเทอร์เวล	
GAMEPLAY_EMOTE_HERO_03_WOW	เหลือเชื่อจริงๆ!	
GAMEPLAY_EMOTE_HERO_04_CONCEDE	ชัยชนะเป็นของเจ้าแล้ว	
GAMEPLAY_EMOTE_HERO_04_ERROR_FULL_MINIONS	ข้ามีมินเนี่ยนมากเกินไปแล้ว	
GAMEPLAY_EMOTE_HERO_04_ERROR_GENERIC	ข้าทำแบบนั้นไม่ได้	
GAMEPLAY_EMOTE_HERO_04_ERROR_HAND_FULL	ข้ามีการ์ดเต็มมือแล้ว!	
GAMEPLAY_EMOTE_HERO_04_ERROR_I_ATTACKED	ข้าโจมตีไปแล้ว	
GAMEPLAY_EMOTE_HERO_04_ERROR_JUST_PLAYED	ให้มินเนี่ยนตัวนั้น เตรียมพร้อมสักเทิร์นเถอะ	
GAMEPLAY_EMOTE_HERO_04_ERROR_MINION_ATTACKED	มินเนี่ยนตัวนั้นโจมตีไปแล้ว	
GAMEPLAY_EMOTE_HERO_04_ERROR_NEED_MANA	ข้ามีมานาไม่พอ	
GAMEPLAY_EMOTE_HERO_04_ERROR_NEED_WEAPON	ข้าต้องมีอาวุธ	
GAMEPLAY_EMOTE_HERO_04_ERROR_PLAY	ข้าเล่นใบนั้นไม่ได้	
GAMEPLAY_EMOTE_HERO_04_ERROR_STEALTH	เลือกมินเนี่ยนที่ซ่อนตัว เป็นเป้าหมายไม่ได้	
GAMEPLAY_EMOTE_HERO_04_ERROR_TARGET	ไม่ใช่เป้าหมายที่ถูกต้อง	
GAMEPLAY_EMOTE_HERO_04_ERROR_TAUNT	มินเนี่ยนที่ยั่วยุขวางทางอยู่	
GAMEPLAY_EMOTE_HERO_04_EVENT_LUNAR_NEW_YEAR	ยินดีที่ได้พบ!	
GAMEPLAY_EMOTE_HERO_04_FIRE_FESTIVAL	สุขสันต์เทศกาลไฟมิดซัมเมอร์!	
GAMEPLAY_EMOTE_HERO_04_GOOD_GAME	เป็นเกมที่ดี	
GAMEPLAY_EMOTE_HERO_04_GREETINGS	ยินดีที่ได้พบ!	
GAMEPLAY_EMOTE_HERO_04_HALLOWS_END	สุขสันต์เทศกาล[b]ฮอลโลว์สเอนด์!	VO_HERO_04_HAPPY_HALLOWEEN_13.wav
GAMEPLAY_EMOTE_HERO_04_LOW_CARDS	การ์ดข้าใกล้จะหมดแล้ว!	
GAMEPLAY_EMOTE_HERO_04_MIRROR_START	ข้าจะบัญชาแสงสว่าง	
GAMEPLAY_EMOTE_HERO_04_NO_CARDS	ข้าไม่มีการ์ดเหลือแล้ว!	
GAMEPLAY_EMOTE_HERO_04_NOBLEGARDEN	สุขสันต์เทศกาล[b]โนเบิ้ลการ์เด้น[b]นะ แชมเปี้ยน!	VO_HERO_04_HAPPY_NOBLEGARDEN_17.wav
GAMEPLAY_EMOTE_HERO_04_OOPS	ข้าทำพลาดไปแล้ว	
GAMEPLAY_EMOTE_HERO_04_PIRATE_DAY	หวัดดี โจรสลัดทั้งหลาย!	VO_HERO_04_PIRATE_DAY_33.wav
GAMEPLAY_EMOTE_HERO_04_SORRY	ข้าขออภัย	
GAMEPLAY_EMOTE_HERO_04_START	ข้าจะสู้อย่างมีเกียรติ!	
GAMEPLAY_EMOTE_HERO_04_THANKS	ขอบใจ	
GAMEPLAY_EMOTE_HERO_04_THINK1	อืมมม...	
GAMEPLAY_EMOTE_HERO_04_THINK2	ข้าว่า...	
GAMEPLAY_EMOTE_HERO_04_THINK3	ขอข้าคิดก่อน...	
GAMEPLAY_EMOTE_HERO_04_THREATEN	คำพิพากษามาพร้อมการลงทัณฑ์!	
GAMEPLAY_EMOTE_HERO_04_TIMER	ข้าต้องรีบแล้ว!	
GAMEPLAY_EMOTE_HERO_04_WELL_PLAYED	เล่นได้ดี	
GAMEPLAY_EMOTE_HERO_04_WINTERVEIL_GREETINGS	สุขสันต์งานฉลองวินเทอร์เวลนะ แชมเปี้ยน!	
GAMEPLAY_EMOTE_HERO_04_WOW	พระเจ้าช่วย!	
GAMEPLAY_EMOTE_HERO_04A_CELEBRATE	วันนี้สว่างสดใสดีจริงๆ!	
GAMEPLAY_EMOTE_HERO_04A_CONCEDE	เจ้าชนะแล้ว สหาย ข้ายอมแพ้	
GAMEPLAY_EMOTE_HERO_04A_ERROR_FULL_MINIONS	ข้ามีมินเนี่ยนมากเกินไป	
GAMEPLAY_EMOTE_HERO_04A_ERROR_GENERIC	ทำเช่นนั้นไม่ได้	
GAMEPLAY_EMOTE_HERO_04A_ERROR_HAND_FULL	การ์ดเต็มมือข้าแล้ว!	
GAMEPLAY_EMOTE_HERO_04A_ERROR_I_ATTACKED	ข้าโจมตีแล้ว	
GAMEPLAY_EMOTE_HERO_04A_ERROR_JUST_PLAYED	ให้มินเนี่ยนเตรียมพร้อม ซักเทิร์นสิ	
GAMEPLAY_EMOTE_HERO_04A_ERROR_MINION_ATTACKED	มินเนี่ยนตัวนั้นโจมตีไปแล้ว	
GAMEPLAY_EMOTE_HERO_04A_ERROR_NEED_MANA	มานาไม่พอแล้ว	
GAMEPLAY_EMOTE_HERO_04A_ERROR_NEED_WEAPON	ข้าต้องมีอาวุธ	
GAMEPLAY_EMOTE_HERO_04A_ERROR_PLAY	เล่นใบนั้นไม่ได้	
GAMEPLAY_EMOTE_HERO_04A_ERROR_STEALTH	เลือกมินเนี่ยนที่ ซ่อนตัวอยู่ไม่ได้	
GAMEPLAY_EMOTE_HERO_04A_ERROR_TARGET	นั่นไม่ใช่เป้าหมายที่ถูกต้อง	
GAMEPLAY_EMOTE_HERO_04A_ERROR_TAUNT	ข้าต้องโจมตีมินเนี่ยนที่ยั่วยุ	
GAMEPLAY_EMOTE_HERO_04A_FIRE_FESTIVAL	สุขสันต์เทศกาลไฟ	
GAMEPLAY_EMOTE_HERO_04A_GOOD_GAME	เป็นเกมที่ดี	
GAMEPLAY_EMOTE_HERO_04A_GREETINGS	สวัสดี ผู้ท้าชิง	
GAMEPLAY_EMOTE_HERO_04A_HALLOWS_END	สุขสันต์เทศกาล[b]ฮอลโลว์สเอนด์	
GAMEPLAY_EMOTE_HERO_04A_LOW_CARDS	การ์ดข้าใกล้หมดแล้ว!	
GAMEPLAY_EMOTE_HERO_04A_LUNAR_NEW_YEAR	สวัสดี ผู้ท้าชิง	
GAMEPLAY_EMOTE_HERO_04A_MIRROR_START	เพลิงศักดิ์สิทธิ์เหรอ ข้าก็มี	
GAMEPLAY_EMOTE_HERO_04A_NO_CARDS	การ์ดหมดแล้ว!	
GAMEPLAY_EMOTE_HERO_04A_NOBLEGARDEN	สุขสันต์เทศกาล[b]โนเบิ้ลการ์เด้น	
GAMEPLAY_EMOTE_HERO_04A_OOPS	ข้าทำพลาดสินะ	
GAMEPLAY_EMOTE_HERO_04A_PIRATE_DAY	ยาาาาร์ ข้าจะปล้นสมบัติของเจ้า	
GAMEPLAY_EMOTE_HERO_04A_SORRY	ขออภัย	
GAMEPLAY_EMOTE_HERO_04A_START	ดาบของข้าลุกไหม้[b]ด้วยเพลิงศักดิ์สิทธิ์!	
GAMEPLAY_EMOTE_HERO_04A_THANKS	ขอบคุณอย่างสุดซึ้ง	
GAMEPLAY_EMOTE_HERO_04A_THINK1	อืมม...	
GAMEPLAY_EMOTE_HERO_04A_THINK2	เอายังไงดี...	
GAMEPLAY_EMOTE_HERO_04A_THINK3	แบบนี้ดีมั้ย อืมม...	
GAMEPLAY_EMOTE_HERO_04A_THREATEN	เจ้าจะต้องชดใช้!	
GAMEPLAY_EMOTE_HERO_04A_TIMER	เร็วเข้า!	
GAMEPLAY_EMOTE_HERO_04A_WELL_PLAYED	เล่นได้ดีมาก	
GAMEPLAY_EMOTE_HERO_04A_WINTERVEIL_GREETINGS	สุขสันต์งานฉลองวินเทอร์เวล!	
GAMEPLAY_EMOTE_HERO_04A_WOW	นั่นมันยอดไปเลย!	
GAMEPLAY_EMOTE_HERO_05_CONCEDE	สู้ได้ดี ข้ายอมแพ้	
GAMEPLAY_EMOTE_HERO_05_ERROR_FULL_MINIONS	ข้ามีมินเนี่ยนมากเกินไป	
GAMEPLAY_EMOTE_HERO_05_ERROR_GENERIC	ข้าทำแบบนั้นไม่ได้	
GAMEPLAY_EMOTE_HERO_05_ERROR_HAND_FULL	การ์ดเต็มมือแล้ว!	
GAMEPLAY_EMOTE_HERO_05_ERROR_I_ATTACKED	ข้าโจมตีแล้ว	
GAMEPLAY_EMOTE_HERO_05_ERROR_JUST_PLAYED	ให้มินเนี่ยนเตรียมพร้อม ซักเทิร์นสิ	
GAMEPLAY_EMOTE_HERO_05_ERROR_MINION_ATTACKED	มินเนี่ยนตัวนั้นโจมตีไปแล้ว	
GAMEPLAY_EMOTE_HERO_05_ERROR_NEED_MANA	มานาไม่พอ	
GAMEPLAY_EMOTE_HERO_05_ERROR_NEED_WEAPON	ข้าต้องมีอาวุธ	
GAMEPLAY_EMOTE_HERO_05_ERROR_PLAY	ข้าเล่นใบนั้นไม่ได้	
GAMEPLAY_EMOTE_HERO_05_ERROR_STEALTH	เลือกมินเนี่ยนที่ซ่อนตัว เป็นเป้าหมายไม่ได้	
GAMEPLAY_EMOTE_HERO_05_ERROR_TARGET	ไม่ใช่เป้าหมายที่ถูกต้อง	
GAMEPLAY_EMOTE_HERO_05_ERROR_TAUNT	มินเนี่ยนที่ยั่วยุขวางทางอยู่	
GAMEPLAY_EMOTE_HERO_05_EVENT_LUNAR_NEW_YEAR	สวัสดี นักเดินทาง	
GAMEPLAY_EMOTE_HERO_05_FIRE_FESTIVAL	สุขสันต์มิดซัมเมอร์	
GAMEPLAY_EMOTE_HERO_05_GOOD_GAME	เป็นเกมที่ดี	
GAMEPLAY_EMOTE_HERO_05_GREETINGS	สวัสดี นักเดินทาง	
GAMEPLAY_EMOTE_HERO_05_HALLOWS_END	สุขสันต์เทศกาล[b]ฮอลโลว์สเอนด์	
GAMEPLAY_EMOTE_HERO_05_LOW_CARDS	การ์ดข้าใกล้จะหมดแล้ว!	
GAMEPLAY_EMOTE_HERO_05_MIRROR_START	เริ่มกันเลย!	
GAMEPLAY_EMOTE_HERO_05_NO_CARDS	การ์ดหมดแล้ว!	
GAMEPLAY_EMOTE_HERO_05_NOBLEGARDEN	สุขสันต์เทศกาล[b]โนเบิ้ลการ์เด้น!	
GAMEPLAY_EMOTE_HERO_05_OOPS	ดูเหมือนข้าจะพลาดไป	
GAMEPLAY_EMOTE_HERO_05_PIRATE_DAY	ฉลามบุก!	
GAMEPLAY_EMOTE_HERO_05_SORRY	ขอโทษด้วย	
GAMEPLAY_EMOTE_HERO_05_START	ออกล่ากันเถอะ!	
GAMEPLAY_EMOTE_HERO_05_THANKS	ขอบคุณ	
GAMEPLAY_EMOTE_HERO_05_THINK1	อืมมม...	
GAMEPLAY_EMOTE_HERO_05_THINK2	ข้าว่า...	
GAMEPLAY_EMOTE_HERO_05_THINK3	อืมมมมมม...	
GAMEPLAY_EMOTE_HERO_05_THREATEN	ข้าจะตามล่าเจ้า!	
GAMEPLAY_EMOTE_HERO_05_TIMER	เวลาช่างรวดเร็ว!	
GAMEPLAY_EMOTE_HERO_05_WELL_PLAYED	เล่นได้ดี	
GAMEPLAY_EMOTE_HERO_05_WINTERVEIL_GREETINGS	สุขสันต์งานฉลองวินเทอร์เวล!	
GAMEPLAY_EMOTE_HERO_05_WOW	ยอดเยี่ยม!	
GAMEPLAY_EMOTE_HERO_05A_CELEBRATE	ฮ่าฮ่า นี่แหละ!	
GAMEPLAY_EMOTE_HERO_05A_CONCEDE	ยอดเยี่ยมมาก ข้าขอยอมแพ้	
GAMEPLAY_EMOTE_HERO_05A_ERROR_FULL_MINIONS	ข้ามีมินเนี่ยนมากเกินไปแล้ว	
GAMEPLAY_EMOTE_HERO_05A_ERROR_GENERIC	ทำแบบนั้นไม่ได้	
GAMEPLAY_EMOTE_HERO_05A_ERROR_HAND_FULL	การ์ดเต็มมือแล้ว!	
GAMEPLAY_EMOTE_HERO_05A_ERROR_I_ATTACKED	ข้าโจมตีไปแล้ว	
GAMEPLAY_EMOTE_HERO_05A_ERROR_JUST_PLAYED	ให้มินเนี่ยนเตรียมพร้อม ซักเทิร์นสิ	
GAMEPLAY_EMOTE_HERO_05A_ERROR_MINION_ATTACKED	มินเนี่ยนตัวนั้นโจมตีไปแล้ว	
GAMEPLAY_EMOTE_HERO_05A_ERROR_NEED_MANA	ข้ามีมานาไม่พอ	
GAMEPLAY_EMOTE_HERO_05A_ERROR_NEED_WEAPON	ข้าต้องมีอาวุธ	
GAMEPLAY_EMOTE_HERO_05A_ERROR_PLAY	ข้าเล่นใบนั้นไม่ได้	
GAMEPLAY_EMOTE_HERO_05A_ERROR_STEALTH	เลือกมินเนี่ยนที่ซ่อนตัว เป็นเป้าหมายไม่ได้	
GAMEPLAY_EMOTE_HERO_05A_ERROR_TARGET	นั่นไม่ใช่เป้าหมายที่ถูกต้อง	
GAMEPLAY_EMOTE_HERO_05A_ERROR_TAUNT	ข้าต้องโจมตีมินเนี่ยนที่ยั่วยุ	
GAMEPLAY_EMOTE_HERO_05A_EVENT_FIRE_FESTIVAL	เทศกาลไฟมาถึงแล้ว	
GAMEPLAY_EMOTE_HERO_05A_EVENT_HALLOWS_END	สุขสันต์เทศกาล[b]ฮอลโลว์สเอนด์	
GAMEPLAY_EMOTE_HERO_05A_EVENT_LUNAR_NEW_YEAR	สวัสดี นักเดินทาง	
GAMEPLAY_EMOTE_HERO_05A_EVENT_NOBLEGARDEN	สุขสันต์เทศกาล[b]โนเบิ้ลการ์เด้น	
GAMEPLAY_EMOTE_HERO_05A_EVENT_PIRATE_DAY	ยาร์! ข้าจะจมเรือเจ้า!	
GAMEPLAY_EMOTE_HERO_05A_GOOD_GAME	เป็นเกมที่ดี	
GAMEPLAY_EMOTE_HERO_05A_GREETINGS	สวัสดี นักเดินทาง	
GAMEPLAY_EMOTE_HERO_05A_LOW_CARDS	การ์ดข้าใกล้จะหมดแล้ว!	
GAMEPLAY_EMOTE_HERO_05A_MIRROR_START	ข้าไม่เคยคุกเข่าให้ใคร	
GAMEPLAY_EMOTE_HERO_05A_NO_CARDS	การ์ดข้าหมดแล้ว!	
GAMEPLAY_EMOTE_HERO_05A_OOPS	ข้าพลาด	
GAMEPLAY_EMOTE_HERO_05A_SORRY	ข้าเสียใจด้วย	
GAMEPLAY_EMOTE_HERO_05A_START	จงคุกเข่าให้กับพลังอำนาจ แห่งเหล่าเอลฟ์!	
GAMEPLAY_EMOTE_HERO_05A_THANKS	ขอบใจ	
GAMEPLAY_EMOTE_HERO_05A_THINK1	อืมม...	
GAMEPLAY_EMOTE_HERO_05A_THINK2	ข้าจะยิงใครดี...	
GAMEPLAY_EMOTE_HERO_05A_THINK3	ทำอะไรดี...	
GAMEPLAY_EMOTE_HERO_05A_THREATEN	การแก้แค้นของข้า จะจบลงเดี๋ยวนี้!	
GAMEPLAY_EMOTE_HERO_05A_TIMER	เร็วเข้า รีบเลย!	
GAMEPLAY_EMOTE_HERO_05A_WELL_PLAYED	เล่นได้ดีมาก	
GAMEPLAY_EMOTE_HERO_05A_WINTERVEIL_GREETING	สุขสันต์งานฉลองวินเทอร์เวล	
GAMEPLAY_EMOTE_HERO_05A_WOW	เหลือเชื่อจริงๆ!	
GAMEPLAY_EMOTE_HERO_06_CONCEDE	ข้าขอยอมแพ้	
GAMEPLAY_EMOTE_HERO_06_ERROR_FULL_MINIONS	ข้ามีมินเนี่ยนมากเกินไปแล้ว	
GAMEPLAY_EMOTE_HERO_06_ERROR_GENERIC	ข้าทำเช่นนั้นไม่ได้	
GAMEPLAY_EMOTE_HERO_06_ERROR_HAND_FULL	ข้ามีการ์ดเต็มมือแล้ว!	
GAMEPLAY_EMOTE_HERO_06_ERROR_I_ATTACKED	ข้าโจมตีไปแล้ว	
GAMEPLAY_EMOTE_HERO_06_ERROR_JUST_PLAYED	ให้มินเนี่ยนตัวนั้น เตรียมพร้อมสักเทิร์นเถอะ	
GAMEPLAY_EMOTE_HERO_06_ERROR_MINION_ATTACKED	มินเนี่ยนตัวนั้นโจมตีไปแล้ว	
GAMEPLAY_EMOTE_HERO_06_ERROR_NEED_MANA	ข้ามีมานาไม่พอ	
GAMEPLAY_EMOTE_HERO_06_ERROR_NEED_WEAPON	ข้าต้องมีอาวุธ	
GAMEPLAY_EMOTE_HERO_06_ERROR_PLAY	ข้าเล่นแบบนั้นไม่ได้	
GAMEPLAY_EMOTE_HERO_06_ERROR_STEALTH	ไม่อาจเลือกมินเนี่ยนที่ซ่อนตัวเป็นเป้าหมายได้	
GAMEPLAY_EMOTE_HERO_06_ERROR_TARGET	ไม่ใช่เป้าหมายที่เหมาะสม	
GAMEPLAY_EMOTE_HERO_06_ERROR_TAUNT	มินเนี่ยนที่ยั่วยุขวางทางอยู่	
GAMEPLAY_EMOTE_HERO_06_EVENT_LUNAR_NEW_YEAR	สวัสดี	
GAMEPLAY_EMOTE_HERO_06_FIRE_FESTIVAL	สุขสันต์มิดซัมเมอร์! ระวังไฟป่าด้วยล่ะ	
GAMEPLAY_EMOTE_HERO_06_GOOD_GAME	เป็นเกมที่ดี	
GAMEPLAY_EMOTE_HERO_06_GREETINGS	สวัสดี	
GAMEPLAY_EMOTE_HERO_06_HALLOWS_END	สุขสันต์เทศกาล[b]ฮอลโลว์สเอนด์!	
GAMEPLAY_EMOTE_HERO_06_LOW_CARDS	การ์ดข้าใกล้จะหมดแล้ว!	
GAMEPLAY_EMOTE_HERO_06_MIRROR_START	ธรรมชาติต้องได้รับการปกป้อง!	
GAMEPLAY_EMOTE_HERO_06_NO_CARDS	ข้าไม่มีการ์ดเหลือแล้ว!	
GAMEPLAY_EMOTE_HERO_06_NOBLEGARDEN	สุขสันต์เทศกาล[b]โนเบิ้ลการ์เด้น!	
GAMEPLAY_EMOTE_HERO_06_OOPS	ความผิดพลาดเป็นเรื่องธรรมชาติ	
GAMEPLAY_EMOTE_HERO_06_PIRATE_DAY	ยาาาาร์!	
GAMEPLAY_EMOTE_HERO_06_SORRY	ขออภัยด้วย	
GAMEPLAY_EMOTE_HERO_06_START	ข้าต้องปกป้องธรรมชาติ!	
GAMEPLAY_EMOTE_HERO_06_START_TYRANDE	ทิรันเดอ ที่รักของข้า	
GAMEPLAY_EMOTE_HERO_06_THANKS	ข้าขอขอบใจ	
GAMEPLAY_EMOTE_HERO_06_THINK1	อืมมม...	
GAMEPLAY_EMOTE_HERO_06_THINK2	อืมมม... ถ้าหากว่า...	
GAMEPLAY_EMOTE_HERO_06_THINK3	ข้าควรทำเช่นไร...	
GAMEPLAY_EMOTE_HERO_06_THREATEN	ธรรมชาติจะลงโทษเจ้า!	
GAMEPLAY_EMOTE_HERO_06_TIMER	เวลาไม่เคยคอยผู้ใด!	
GAMEPLAY_EMOTE_HERO_06_WELL_PLAYED	อืมม ยอดเยี่ยมทีเดียว	
GAMEPLAY_EMOTE_HERO_06_WINTERVEIL_GREETINGS	สุขสันต์งานฉลองวินเทอร์เวล	
GAMEPLAY_EMOTE_HERO_06_WOW	อัศจรรย์ยิ่งนัก!	
GAMEPLAY_EMOTE_HERO_07_CONCEDE	เจ้าชนะแล้ว...	
GAMEPLAY_EMOTE_HERO_07_ERROR_FULL_MINIONS	ข้ามีมินเนี่ยนมากเกินไปแล้ว	
GAMEPLAY_EMOTE_HERO_07_ERROR_GENERIC	ข้าทำเช่นนั้นไม่ได้	
GAMEPLAY_EMOTE_HERO_07_ERROR_HAND_FULL	มือข้ามีที่ว่างไม่พอแล้ว!	
GAMEPLAY_EMOTE_HERO_07_ERROR_I_ATTACKED	ข้าโจมตีไปแล้ว	
GAMEPLAY_EMOTE_HERO_07_ERROR_JUST_PLAYED	ให้มินเนี่ยนเตรียมพร้อม ซักเทิร์นสิ	
GAMEPLAY_EMOTE_HERO_07_ERROR_MINION_ATTACKED	มินเนี่ยนตัวนั้นโจมตีไปแล้ว	
GAMEPLAY_EMOTE_HERO_07_ERROR_NEED_MANA	ข้ามีมานาไม่พอ	
GAMEPLAY_EMOTE_HERO_07_ERROR_NEED_WEAPON	ข้าต้องการอาวุธ	
GAMEPLAY_EMOTE_HERO_07_ERROR_PLAY	ข้าไม่อาจเล่นได้	
GAMEPLAY_EMOTE_HERO_07_ERROR_STEALTH	ข้าเลือกมินเนี่ยนที่ซ่อนตัว เป็นเป้าหมายไม่ได้	
GAMEPLAY_EMOTE_HERO_07_ERROR_TARGET	นั่นไม่ใช่เป้าหมายที่ถูกต้อง	
GAMEPLAY_EMOTE_HERO_07_ERROR_TAUNT	มินเนี่ยนที่ยั่วยุขวางทางอยู่	
GAMEPLAY_EMOTE_HERO_07_EVENT_LUNAR_NEW_YEAR	สวัสดี	
GAMEPLAY_EMOTE_HERO_07_FIRE_FESTIVAL	จุดไฟซะสิ	
GAMEPLAY_EMOTE_HERO_07_GOOD_GAME	เป็นเกมที่ดี	
GAMEPLAY_EMOTE_HERO_07_GREETINGS	สวัสดี	
GAMEPLAY_EMOTE_HERO_07_HALLOWS_END	ขอให้สนุกกับฮอลโลว์สเอนด์	
GAMEPLAY_EMOTE_HERO_07_LOW_CARDS	การ์ดของข้าใกล้จะหมดแล้ว!	
GAMEPLAY_EMOTE_HERO_07_MIRROR_START	ข้าคือฝันร้ายของเจ้า!	
GAMEPLAY_EMOTE_HERO_07_NO_CARDS	การ์ดข้าหมดแล้ว!	
GAMEPLAY_EMOTE_HERO_07_NOBLEGARDEN	สุขสันต์เทศกาล[b]โนเบิ้ลการ์เด้น	
GAMEPLAY_EMOTE_HERO_07_OOPS	นั่นคือความผิดพลาด	
GAMEPLAY_EMOTE_HERO_07_PIRATE_DAY	วันโจรสลัดเหรอ? ข้าไม่เข้าใจเลย	
GAMEPLAY_EMOTE_HERO_07_SORRY	เสียใจด้วย	
GAMEPLAY_EMOTE_HERO_07_START	ข้าจะกลืนกินวิญญาณเจ้า!	
GAMEPLAY_EMOTE_HERO_07_THANKS	ขอบใจ	
GAMEPLAY_EMOTE_HERO_07_THINK1	อืมมม...	
GAMEPLAY_EMOTE_HERO_07_THINK2	คิดดูก่อน...	
GAMEPLAY_EMOTE_HERO_07_THINK3	ทางเลือกช่างมากมายนัก...	
GAMEPLAY_EMOTE_HERO_07_THREATEN	เจ้าจะต้องทรมานไปถึงวิญญาณ!	
GAMEPLAY_EMOTE_HERO_07_TIMER	เวลาใกล้จะหมดแล้ว!	
GAMEPLAY_EMOTE_HERO_07_WELL_PLAYED	เล่นได้ดี	
GAMEPLAY_EMOTE_HERO_07_WINTERVEIL_GREETINGS	ขอให้มีความสุขกับวินเทอร์เวล....	
GAMEPLAY_EMOTE_HERO_07_WOW	เหลือเชื่อ!	
GAMEPLAY_EMOTE_HERO_08_CONCEDE	เจ้าชนะแล้ว	
GAMEPLAY_EMOTE_HERO_08_ERROR_FULL_MINIONS	มีมินเนี่ยนมากเกินไปแล้ว	
GAMEPLAY_EMOTE_HERO_08_ERROR_GENERIC	ทำแบบนั้นไม่ได้	
GAMEPLAY_EMOTE_HERO_08_ERROR_HAND_FULL	การ์ดเต็มมือข้าแล้ว!	
GAMEPLAY_EMOTE_HERO_08_ERROR_I_ATTACKED	ข้าโจมตีไปแล้ว	
GAMEPLAY_EMOTE_HERO_08_ERROR_JUST_PLAYED	ให้มินเนี่ยนตัวนั้น เตรียมพร้อมสักเทิร์นเถอะ	
GAMEPLAY_EMOTE_HERO_08_ERROR_MINION_ATTACKED	มินเนี่ยนตัวนั้นโจมตีไปแล้ว	
GAMEPLAY_EMOTE_HERO_08_ERROR_NEED_MANA	มานาไม่พอแล้ว	
GAMEPLAY_EMOTE_HERO_08_ERROR_NEED_WEAPON	ข้าต้องมีอาวุธ	
GAMEPLAY_EMOTE_HERO_08_ERROR_PLAY	เล่นใบนั้นไม่ได้นะ	
GAMEPLAY_EMOTE_HERO_08_ERROR_STEALTH	เลือกมินเนี่ยนที่ซ่อนตัว เป็นเป้าหมายไม่ได้	
GAMEPLAY_EMOTE_HERO_08_ERROR_TARGET	นั่นไม่ใช่เป้าหมายที่ถูกต้อง	
GAMEPLAY_EMOTE_HERO_08_ERROR_TAUNT	มินเนี่ยนที่ยั่วยุขวางทางอยู่	
GAMEPLAY_EMOTE_HERO_08_EVENT_LUNAR_NEW_YEAR	สวัสดี	
GAMEPLAY_EMOTE_HERO_08_FIRE_FESTIVAL	สุขสันต์เทศกาลไฟมิดซัมเมอร์!	
GAMEPLAY_EMOTE_HERO_08_GOOD_GAME	เป็นเกมที่ดี	
GAMEPLAY_EMOTE_HERO_08_GREETINGS	สวัสดี	
GAMEPLAY_EMOTE_HERO_08_HALLOWS_END	สุขสันต์เทศกาล[b]ฮอลโลว์สเอนด์	
GAMEPLAY_EMOTE_HERO_08_LOW_CARDS	การ์ดใกล้จะหมดแล้ว!	
GAMEPLAY_EMOTE_HERO_08_MIRROR_START	โอ้ ข้าพร้อมอยู่แล้ว	
GAMEPLAY_EMOTE_HERO_08_NO_CARDS	การ์ดข้าหมดแล้ว!	
GAMEPLAY_EMOTE_HERO_08_NOBLEGARDEN	สุขสันต์เทศกาล[b]โนเบิ้ลการ์เด้น	
GAMEPLAY_EMOTE_HERO_08_OOPS	อุ๊ปส์!	
GAMEPLAY_EMOTE_HERO_08_PIRATE_DAY	อ้าาาร์! อะฮ้อย!	
GAMEPLAY_EMOTE_HERO_08_SORRY	ขอโทษนะ	
GAMEPLAY_EMOTE_HERO_08_START	รนหาที่เองนะ!	
GAMEPLAY_EMOTE_HERO_08_THANKS	ขอบใจ	
GAMEPLAY_EMOTE_HERO_08_THINK1	อืมมม...	
GAMEPLAY_EMOTE_HERO_08_THINK2	แบบนี้ดีมั้ย...	
GAMEPLAY_EMOTE_HERO_08_THINK3	เอาไงดี... เอาไงดี...	
GAMEPLAY_EMOTE_HERO_08_THREATEN	เวทมนตร์ของข้า[b]จะทำลายเจ้า!	
GAMEPLAY_EMOTE_HERO_08_TIMER	เวลาจะหมดแล้ว!	
GAMEPLAY_EMOTE_HERO_08_WELL_PLAYED	ฉลาดมาก	
GAMEPLAY_EMOTE_HERO_08_WINTERVEIL_GREETINGS	สุขสันต์งานฉลองวินเทอร์เวล!	
GAMEPLAY_EMOTE_HERO_08_WOW	อัศจรรย์มาก!	
GAMEPLAY_EMOTE_HERO_08A_CELEBRATE	ไชโย! ฮ่าฮ่า!	
GAMEPLAY_EMOTE_HERO_08A_CONCEDE	รุกฆาต ยอดเยี่ยมมาก	
GAMEPLAY_EMOTE_HERO_08A_ERROR_FULL_MINIONS	ข้ามีมินเนี่ยนมากเกินไปแล้ว	
GAMEPLAY_EMOTE_HERO_08A_ERROR_GENERIC	ทำเช่นนั้นไม่ได้	
GAMEPLAY_EMOTE_HERO_08A_ERROR_HAND_FULL	การ์ดเต็มมือข้าแล้ว!	
GAMEPLAY_EMOTE_HERO_08A_ERROR_I_ATTACKED	ข้าโจมตีไปแล้ว	
GAMEPLAY_EMOTE_HERO_08A_ERROR_JUST_PLAYED	ให้มินเนี่ยนเตรียมพร้อม สักเทิร์นหนึ่งก่อน	
GAMEPLAY_EMOTE_HERO_08A_ERROR_MINION_ATTACKED	มินเนี่ยนตัวนั้นโจมตีไปแล้ว	
GAMEPLAY_EMOTE_HERO_08A_ERROR_NEED_MANA	ข้ามีมานาไม่เพียงพอ	
GAMEPLAY_EMOTE_HERO_08A_ERROR_NEED_WEAPON	ข้าต้องมีอาวุธ	
GAMEPLAY_EMOTE_HERO_08A_ERROR_PLAY	ข้าเล่นใบนั้นไม่ได้	
GAMEPLAY_EMOTE_HERO_08A_ERROR_STEALTH	ข้าเลือกมินเนี่ยนที่ซ่อนตัว เป็นเป้าหมายไม่ได้	
GAMEPLAY_EMOTE_HERO_08A_ERROR_TARGET	นั่นไม่ใช่เป้าหมายที่ถูกต้อง	
GAMEPLAY_EMOTE_HERO_08A_ERROR_TAUNT	ข้าต้องโจมตีมินเนี่ยนที่ยั่วยุ	
GAMEPLAY_EMOTE_HERO_08A_FIRE_FESTIVAL	เทศกาลไฟมิดซัมเมอร์เริ่มแล้ว!	
GAMEPLAY_EMOTE_HERO_08A_GOOD_GAME	เป็นเกมที่ดี	
GAMEPLAY_EMOTE_HERO_08A_GREETINGS	อ้า สวัสดี	
GAMEPLAY_EMOTE_HERO_08A_HALLOWS_END	สุขสันต์เทศกาล[b]ฮอลโลว์สเอนด์	
GAMEPLAY_EMOTE_HERO_08A_LOW_CARDS	การ์ดข้าใกล้จะหมดแล้ว!	
GAMEPLAY_EMOTE_HERO_08A_LUNAR_NEW_YEAR	อ้า สวัสดี	
GAMEPLAY_EMOTE_HERO_08A_MIRROR_START	โอ้ เกมน่ะเริ่มขึ้นนานแล้ว	
GAMEPLAY_EMOTE_HERO_08A_NO_CARDS	ข้าไม่มีการ์ดเหลือแล้ว!	
GAMEPLAY_EMOTE_HERO_08A_NOBLEGARDEN	สุขสันต์เทศกาล[b]โนเบิ้ลการ์เด้น!	
GAMEPLAY_EMOTE_HERO_08A_OOPS	ข้าช่างโง่เขลานัก	
GAMEPLAY_EMOTE_HERO_08A_PIRATE_DAY	ข้าคือเมดิฟห์ โจรสลัดผู้พิทักษ์	
GAMEPLAY_EMOTE_HERO_08A_SORRY	ขออภัยอย่างสุดซึ้ง	
GAMEPLAY_EMOTE_HERO_08A_START	เริ่มเกมได้	
GAMEPLAY_EMOTE_HERO_08A_THANKS	ข้าขอขอบใจ	
GAMEPLAY_EMOTE_HERO_08A_THINK1	อืมม...	
GAMEPLAY_EMOTE_HERO_08A_THINK2	น่าสนใจ...	
GAMEPLAY_EMOTE_HERO_08A_THINK3	หรือว่า...	
GAMEPLAY_EMOTE_HERO_08A_THREATEN	ไม่มีอะไรหยุดข้าได้ ไม่มี!	
GAMEPLAY_EMOTE_HERO_08A_TIMER	ข้าต้องไม่ประมาท!	
GAMEPLAY_EMOTE_HERO_08A_WELL_PLAYED	เจ้าทำได้ดี	
GAMEPLAY_EMOTE_HERO_08A_WINTERVEIL_GREETINGS	ขอให้สนุกกับงานฉลองนะ ผู้ท้าชิง	
GAMEPLAY_EMOTE_HERO_08A_WOW	มหัศจรรย์มาก!	
GAMEPLAY_EMOTE_HERO_08B_CONCEDE	ยอดมาก เจ้าชนะแล้ว	
GAMEPLAY_EMOTE_HERO_08B_ERROR_FULL_MINIONS	ข้ามีมินเนี่ยนมากเกินไปแล้ว	
GAMEPLAY_EMOTE_HERO_08B_ERROR_GENERIC	ข้าทำแบบนั้นไม่ได้	
GAMEPLAY_EMOTE_HERO_08B_ERROR_HAND_FULL	การ์ดเต็มมือข้าแล้ว!	
GAMEPLAY_EMOTE_HERO_08B_ERROR_I_ATTACKED	ข้าโจมตีไปแล้ว	
GAMEPLAY_EMOTE_HERO_08B_ERROR_JUST_PLAYED	ให้มินเนี่ยนตัวนั้น[b]เตรียมพร้อมสักเทิร์น	
GAMEPLAY_EMOTE_HERO_08B_ERROR_MINION_ATTACKED	มินเนี่ยนตัวนั้นโจมตีไปแล้ว	
GAMEPLAY_EMOTE_HERO_08B_ERROR_NEED_MANA	ข้ามีมานาไม่พอ	
GAMEPLAY_EMOTE_HERO_08B_ERROR_NEED_WEAPON	ข้าต้องมีอาวุธ	
GAMEPLAY_EMOTE_HERO_08B_ERROR_PLAY	ข้าเล่นแบบนั้นไม่ได้	
GAMEPLAY_EMOTE_HERO_08B_ERROR_STEALTH	เลือกมินเนี่ยนที่ซ่อนตัว[b]เป็นเป้าหมายไม่ได้	
GAMEPLAY_EMOTE_HERO_08B_ERROR_TARGET	นั่นไม่ใช่เป้าหมายที่ถูกต้อง	
GAMEPLAY_EMOTE_HERO_08B_ERROR_TAUNT	มินเนี่ยนที่ยั่วยุขวางทางอยู่	
GAMEPLAY_EMOTE_HERO_08B_FIRE_FESTIVAL	ขอให้เป็นมิดซัมเมอร์ที่ดีงาม!	
GAMEPLAY_EMOTE_HERO_08B_GOOD_GAME	เอาล่ะ  นี่มันเป็นเกมที่ดีจริง ๆ!	
GAMEPLAY_EMOTE_HERO_08B_GREETINGS	สวัสดี ผู้แสวงหาความจริง	
GAMEPLAY_EMOTE_HERO_08B_HALLOWS_END	สุขสันต์เทศกาล[b]ฮอลโลว์สเอนด์	
GAMEPLAY_EMOTE_HERO_08B_LOW_CARDS	การ์ดข้าใกล้จะหมดแล้ว!	
GAMEPLAY_EMOTE_HERO_08B_LUNAR_NEW_YEAR	สวัสดี ผู้แสวงหาความจริง	
GAMEPLAY_EMOTE_HERO_08B_MIRROR_START	เราจะเรียนรู้ไปด้วยกัน	
GAMEPLAY_EMOTE_HERO_08B_NO_CARDS	การ์ดหมดแล้ว!	
GAMEPLAY_EMOTE_HERO_08B_NOBLEGARDEN	สุขสันต์เทศกาล[b]โนเบิ้ลการ์เด้น!	
GAMEPLAY_EMOTE_HERO_08B_OOPS	โอ้ไม่ พลาดแล้ว	
GAMEPLAY_EMOTE_HERO_08B_PIRATE_DAY	เราฉลอง…\nให้กับอาชญากร\nแห่งท้องทะเลเนี่ยนะ?	
GAMEPLAY_EMOTE_HERO_08B_SORRY	โอ้ เสียใจด้วย	
GAMEPLAY_EMOTE_HERO_08B_START	ความรู้คือพลัง	
GAMEPLAY_EMOTE_HERO_08B_THANKS	ขอบใจนะสหาย	
GAMEPLAY_EMOTE_HERO_08B_THINK1	อืมม...	
GAMEPLAY_EMOTE_HERO_08B_THINK2	สังเกตและวิเคราะห์...	
GAMEPLAY_EMOTE_HERO_08B_THINK3	มันต้องมีทางสิ...	
GAMEPLAY_EMOTE_HERO_08B_THREATEN	เจ้าคนอวดดี ต้องสั่งสอนกันหน่อย!	
GAMEPLAY_EMOTE_HERO_08B_TIMER	ดูเวลาด้วย!	
GAMEPLAY_EMOTE_HERO_08B_WELL_PLAYED	ทำได้ดีมาก	
GAMEPLAY_EMOTE_HERO_08B_WINTERVEIL_GREETINGS	สุขสันต์งานฉลองวินเทอร์เวล!	
GAMEPLAY_EMOTE_HERO_08B_WOW	มหัศจรรย์มาก	
GAMEPLAY_EMOTE_HERO_09_CONCEDE	เจ้าชนะแล้ว	
GAMEPLAY_EMOTE_HERO_09_ERROR_FULL_MINIONS	ข้ามีมินเนี่ยนมากเกินไปแล้ว	
GAMEPLAY_EMOTE_HERO_09_ERROR_GENERIC	ทำแบบนั้นไม่ได้หรอก	
GAMEPLAY_EMOTE_HERO_09_ERROR_HAND_FULL	การ์ดเต็มมือแล้ว!	
GAMEPLAY_EMOTE_HERO_09_ERROR_I_ATTACKED	ข้าโจมตีไปแล้ว	
GAMEPLAY_EMOTE_HERO_09_ERROR_JUST_PLAYED	ให้มินเนี่ยนตัวนั้น เตรียมพร้อมสักเทิร์นเถอะ	
GAMEPLAY_EMOTE_HERO_09_ERROR_MINION_ATTACKED	มินเนี่ยนตัวนั้นโจมตีไปแล้ว	
GAMEPLAY_EMOTE_HERO_09_ERROR_NEED_MANA	มานาของข้าไม่พอ	
GAMEPLAY_EMOTE_HERO_09_ERROR_NEED_WEAPON	ข้าต้องมีอาวุธ	
GAMEPLAY_EMOTE_HERO_09_ERROR_PLAY	ข้าเล่นแบบนั้นไม่ได้	
GAMEPLAY_EMOTE_HERO_09_ERROR_STEALTH	เลือกมินเนี่ยนที่ซ่อนตัว เป็นเป้าหมายไม่ได้	
GAMEPLAY_EMOTE_HERO_09_ERROR_TARGET	นั่นไม่ใช่เป้าหมายที่ถูกต้อง	
GAMEPLAY_EMOTE_HERO_09_ERROR_TAUNT	มินเนี่ยนที่ยั่วยุขวางทางอยู่	
GAMEPLAY_EMOTE_HERO_09_EVENT_LUNAR_NEW_YEAR	สวัสดี	
GAMEPLAY_EMOTE_HERO_09_FIRE_FESTIVAL	ข้าจะรอดูดอกไม้ไฟนะ!	
GAMEPLAY_EMOTE_HERO_09_GOOD_GAME	เป็นเกมที่ดี	
GAMEPLAY_EMOTE_HERO_09_GREETINGS	สวัสดี	
GAMEPLAY_EMOTE_HERO_09_GREETINGS_DISABLED	<เสียงอู้อี้>	
GAMEPLAY_EMOTE_HERO_09_HALLOWS_END	สุขสันต์เทศกาล[b]ฮอลโลว์สเอนด์!	
GAMEPLAY_EMOTE_HERO_09_LOW_CARDS	การ์ดข้าใกล้จะหมดแล้ว!	
GAMEPLAY_EMOTE_HERO_09_MIRROR_START	แสงสว่างจะเกื้อหนุนผู้ทรงธรรม!	
GAMEPLAY_EMOTE_HERO_09_NO_CARDS	การ์ดหมดแล้ว!	
GAMEPLAY_EMOTE_HERO_09_NOBLEGARDEN	สุขสันต์เทศกาล[b]โนเบิ้ลการ์เด้น!	
GAMEPLAY_EMOTE_HERO_09_OOPS	ผิดแผนไปหน่อย	
GAMEPLAY_EMOTE_HERO_09_OOPS_DISABLED	<เสียงอู้อี้>	
GAMEPLAY_EMOTE_HERO_09_PIRATE_DAY	ยาาาร์ ข้าจะเป็นเจ้าแห่งโจรสลัด!	
GAMEPLAY_EMOTE_HERO_09_SORRY	ขออภัย	
GAMEPLAY_EMOTE_HERO_09_START	แสงสว่างจะนำเราสู่ชัยชนะ!	
GAMEPLAY_EMOTE_HERO_09_THANKS	ขอบคุณ	
GAMEPLAY_EMOTE_HERO_09_THANKS_DISABLED	<เสียงอู้อี้>	
GAMEPLAY_EMOTE_HERO_09_THINK1	อืมมม...	
GAMEPLAY_EMOTE_HERO_09_THINK2	ถ้าแบบนี้ล่ะ...	
GAMEPLAY_EMOTE_HERO_09_THINK3	ข้าต้องคิดให้ดี...	
GAMEPLAY_EMOTE_HERO_09_THREATEN	แสงสว่างจะเผาผลาญเจ้า!	
GAMEPLAY_EMOTE_HERO_09_THREATEN_DISABLED	<เสียงอู้อี้>	
GAMEPLAY_EMOTE_HERO_09_TIMER	ต้องรีบเลือกแล้ว!	
GAMEPLAY_EMOTE_HERO_09_WELL_PLAYED	ยอดเยี่ยมมาก	
GAMEPLAY_EMOTE_HERO_09_WELL_PLAYED_DISABLED	<เสียงอู้อี้>	
GAMEPLAY_EMOTE_HERO_09_WINTERVEIL_GREETINGS	สุขสันต์งานฉลองวินเทอร์เวล!	
GAMEPLAY_EMOTE_HERO_09_WOW	ว้าว....	
GAMEPLAY_EMOTE_HERO_09_WOW_DISABLED	<เสียงอู้อี้>	
GAMEPLAY_EMOTE_HERO_TBKTRAF_KT_CONCEDE	ข้า... จะ... กลับมา....	
GAMEPLAY_EMOTE_HERO_TBKTRAF_KT_GREETINGS	ในที่สุดเราก็ได้พบกัน!	
GAMEPLAY_EMOTE_HERO_TBKTRAF_KT_LOW_CARDS	การ์ดข้าใกล้จะหมดแล้ว!	
GAMEPLAY_EMOTE_HERO_TBKTRAF_KT_NO_CARDS	ไม่!!! ข้าขอสาปแช่งเจ้า ผู้บุกรุก!	
GAMEPLAY_EMOTE_HERO_TBKTRAF_KT_OOPS	*เฮ้อ!*  สงสัยต้องกลับไปออกแบบใหม่แล้วมั้ง	
GAMEPLAY_EMOTE_HERO_TBKTRAF_KT_SORRY	ไม่! ข้าขอสาปแช่งเจ้า ผู้บุกรุก!	
GAMEPLAY_EMOTE_HERO_TBKTRAF_KT_START	มาเผชิญหน้ากับข้าเลย ผู้บุกรุก!	
GAMEPLAY_EMOTE_HERO_TBKTRAF_KT_THANKS	ยินดี... มั้ง	
GAMEPLAY_EMOTE_HERO_TBKTRAF_KT_THINK1	ก็อาจเป็นได้ 	
GAMEPLAY_EMOTE_HERO_TBKTRAF_KT_THINK2	ใช่... ใช่เลย!	
GAMEPLAY_EMOTE_HERO_TBKTRAF_KT_THINK3	เจ้าคิดว่าไง บิกเกิลสเวิร์ธ?	
GAMEPLAY_EMOTE_HERO_TBKTRAF_KT_THREATEN	เจ้าจะต้องหนาวไปจนถึงกระดูก!	
GAMEPLAY_EMOTE_HERO_TBKTRAF_KT_WELL_PLAYED	มันแน่นอนอยู่แล้ว ข้าคือเคลธูซาด พ่อทุกสถาบันนะเฟ้ย!	
GAMEPLAY_EMOTE_HERO_TBKTRAF_RAF_CONCEDE	ไม่! ข้าไม่มีวันพ่ายแพ้...	
GAMEPLAY_EMOTE_HERO_TBKTRAF_RAF_GREETINGS	สวัสดี นักสำรวจ	
GAMEPLAY_EMOTE_HERO_TBKTRAF_RAF_LOW_CARDS	การ์ดข้าใกล้จะหมดแล้ว!	
GAMEPLAY_EMOTE_HERO_TBKTRAF_RAF_NO_CARDS	ขุมทรัพย์แสนสวยของข้า!	
GAMEPLAY_EMOTE_HERO_TBKTRAF_RAF_OOPS	ผิดพลาด!	
GAMEPLAY_EMOTE_HERO_TBKTRAF_RAF_SORRY	น่าสงสารจัง	
GAMEPLAY_EMOTE_HERO_TBKTRAF_RAF_START	ราฟาม! สุดยอดนักโบราณคดี!	
GAMEPLAY_EMOTE_HERO_TBKTRAF_RAF_THANKS	อ้า ขอบใจ	
GAMEPLAY_EMOTE_HERO_TBKTRAF_RAF_THINK1	อืมมม...	
GAMEPLAY_EMOTE_HERO_TBKTRAF_RAF_THINK2	เอาอะไรไปดีนะ...	
GAMEPLAY_EMOTE_HERO_TBKTRAF_RAF_THINK3	น่าสนใจมาก...	
GAMEPLAY_EMOTE_HERO_TBKTRAF_RAF_THREATEN	พลังล้นเหลือ!	
GAMEPLAY_EMOTE_HERO_TBKTRAF_RAF_WELL_PLAYED	ดีมาก...	
GAMEPLAY_EMOTE_HERO_TBMECHWAR01_CONCEDE	<ยอมแพ้>	The text is in brackets because the VO files is just Annoy-o-Tron's greeting
GAMEPLAY_EMOTE_HERO_TBMECHWAR01_ERROR_FULL_MINIONS	<ผิดพลาด!>	The text is in brackets because the VO files is just Annoy-o-Tron's greeting
GAMEPLAY_EMOTE_HERO_TBMECHWAR01_ERROR_HAND_FULL	<ผิดพลาด!>	The text is in brackets because the VO files is just Annoy-o-Tron's greeting
GAMEPLAY_EMOTE_HERO_TBMECHWAR01_ERROR_I_ATTACKED	<ผิดพลาด!>	The text is in brackets because the VO files is just Annoy-o-Tron's greeting
GAMEPLAY_EMOTE_HERO_TBMECHWAR01_ERROR_JUST_PLAYED	<ผิดพลาด!>	The text is in brackets because the VO files is just Annoy-o-Tron's greeting
GAMEPLAY_EMOTE_HERO_TBMECHWAR01_ERROR_MINION_ATTACKED	<ผิดพลาด!>	The text is in brackets because the VO files is just Annoy-o-Tron's greeting
GAMEPLAY_EMOTE_HERO_TBMECHWAR01_ERROR_NEED_MANA	<ผิดพลาด!>	The text is in brackets because the VO files is just Annoy-o-Tron's greeting
GAMEPLAY_EMOTE_HERO_TBMECHWAR01_ERROR_NEED_WEAPON	<ผิดพลาด!>	The text is in brackets because the VO files is just Annoy-o-Tron's greeting
GAMEPLAY_EMOTE_HERO_TBMECHWAR01_ERROR_PLAY	<ผิดพลาด!>	The text is in brackets because the VO files is just Annoy-o-Tron's greeting
GAMEPLAY_EMOTE_HERO_TBMECHWAR01_ERROR_STEALTH	<ผิดพลาด!>	The text is in brackets because the VO files is just Annoy-o-Tron's greeting
GAMEPLAY_EMOTE_HERO_TBMECHWAR01_ERROR_TARGET	<ผิดพลาด!>	The text is in brackets because the VO files is just Annoy-o-Tron's greeting
GAMEPLAY_EMOTE_HERO_TBMECHWAR01_ERROR_TAUNT	<ผิดพลาด!>	The text is in brackets because the VO files is just Annoy-o-Tron's greeting
GAMEPLAY_EMOTE_HERO_TBMECHWAR01_GREETINGS	<สวัสดี>	The text is in brackets because the VO files is just Annoy-o-Tron's greeting
GAMEPLAY_EMOTE_HERO_TBMECHWAR01_LOW_CARDS	<การ์ดเหลือน้อย>	The text is in brackets because the VO files is just Annoy-o-Tron's greeting
GAMEPLAY_EMOTE_HERO_TBMECHWAR01_NO_CARDS	<การ์ดหมด>	The text is in brackets because the VO files is just Annoy-o-Tron's greeting
GAMEPLAY_EMOTE_HERO_TBMECHWAR01_OOPS	<ผิดพลาด>	The text is in brackets because the VO files is just Annoy-o-Tron's greeting
GAMEPLAY_EMOTE_HERO_TBMECHWAR01_SORRY	<ขอโทษ>	The text is in brackets because the VO files is just Annoy-o-Tron's greeting
GAMEPLAY_EMOTE_HERO_TBMECHWAR01_START	<เริ่มเกม>	The text is in brackets because the VO files is just Annoy-o-Tron's greeting
GAMEPLAY_EMOTE_HERO_TBMECHWAR01_THANKS	<ขอบคุณ>	The text is in brackets because the VO files is just Annoy-o-Tron's greeting
GAMEPLAY_EMOTE_HERO_TBMECHWAR01_THINK1	<กำลังคิด...>	The text is in brackets because the VO files is just Annoy-o-Tron's greeting
GAMEPLAY_EMOTE_HERO_TBMECHWAR01_THINK2	<Acquiring target...>	The text is in brackets because the VO files is just Annoy-o-Tron's greeting
GAMEPLAY_EMOTE_HERO_TBMECHWAR01_THINK3	<ยังคิดอยู่...>	The text is in brackets because the VO files is just Annoy-o-Tron's greeting
GAMEPLAY_EMOTE_HERO_TBMECHWAR01_THREATEN	<ข่มขู่>	The text is in brackets because the VO files is just Annoy-o-Tron's attack
GAMEPLAY_EMOTE_HERO_TBMECHWAR01_TIMER	<เวลาเหลือน้อย>	The text is in brackets because the VO files is just Annoy-o-Tron's greeting
GAMEPLAY_EMOTE_HERO_TBMECHWAR01_WELL_PLAYED	<เล่นได้ดี>	The text is in brackets because the VO files is just Annoy-o-Tron's greeting
GAMEPLAY_EMOTE_HERO_TBMECHWAR01_WOW	<เหลือเชื่อจริง ๆ!>	The text is in brackets because the VO files is just Annoy-o-Tron's greeting
GAMEPLAY_EMOTE_HERO_TBMECHWAR02_CONCEDE	<ตาย>	The text is in brackets because the VO files is just Boom Bot's greeting
GAMEPLAY_EMOTE_HERO_TBMECHWAR02_ERROR_FULL_MINIONS	<ผิดพลาด!>	The text is in brackets because the VO files is just Boom Bot's greeting
GAMEPLAY_EMOTE_HERO_TBMECHWAR02_ERROR_HAND_FULL	<ผิดพลาด!>	The text is in brackets because the VO files is just Boom Bot's greeting
GAMEPLAY_EMOTE_HERO_TBMECHWAR02_ERROR_I_ATTACKED	<ผิดพลาด!>	The text is in brackets because the VO files is just Boom Bot's greeting
GAMEPLAY_EMOTE_HERO_TBMECHWAR02_ERROR_JUST_PLAYED	<ผิดพลาด!>	The text is in brackets because the VO files is just Boom Bot's greeting
GAMEPLAY_EMOTE_HERO_TBMECHWAR02_ERROR_MINION_ATTACKED	<ผิดพลาด!>	The text is in brackets because the VO files is just Boom Bot's greeting
GAMEPLAY_EMOTE_HERO_TBMECHWAR02_ERROR_NEED_MANA	<ผิดพลาด!>	The text is in brackets because the VO files is just Boom Bot's greeting
GAMEPLAY_EMOTE_HERO_TBMECHWAR02_ERROR_NEED_WEAPON	<ผิดพลาด!>	The text is in brackets because the VO files is just Boom Bot's greeting
GAMEPLAY_EMOTE_HERO_TBMECHWAR02_ERROR_PLAY	<ผิดพลาด!>	The text is in brackets because the VO files is just Boom Bot's greeting
GAMEPLAY_EMOTE_HERO_TBMECHWAR02_ERROR_STEALTH	<ผิดพลาด!>	The text is in brackets because the VO files is just Boom Bot's greeting
GAMEPLAY_EMOTE_HERO_TBMECHWAR02_ERROR_TARGET	<ผิดพลาด!>	The text is in brackets because the VO files is just Boom Bot's greeting
GAMEPLAY_EMOTE_HERO_TBMECHWAR02_ERROR_TAUNT	<ผิดพลาด!>	The text is in brackets because the VO files is just Boom Bot's greeting
GAMEPLAY_EMOTE_HERO_TBMECHWAR02_GREETINGS	<สวัสดี>	The text is in brackets because the VO files is just Annoy-o-Tron's greeting
GAMEPLAY_EMOTE_HERO_TBMECHWAR02_LOW_CARDS	<การ์ดเหลือน้อย>	The text is in brackets because the VO files is just Boom Bot's greeting
GAMEPLAY_EMOTE_HERO_TBMECHWAR02_NO_CARDS	<การ์ดหมด!>	The text is in brackets because the VO files is just Boom Bot's greeting
GAMEPLAY_EMOTE_HERO_TBMECHWAR02_OOPS	<ผิดพลาด!>	The text is in brackets because the VO files is just Boom Bot's greeting
GAMEPLAY_EMOTE_HERO_TBMECHWAR02_SORRY	<Apologies>	The text is in brackets because the VO files is just Boom Bot's greeting
GAMEPLAY_EMOTE_HERO_TBMECHWAR02_START	<เริ่มเกม>	The text is in brackets because the VO files is just Boom Bot's greeting
GAMEPLAY_EMOTE_HERO_TBMECHWAR02_THANKS	<ขอบคุณ>	The text is in brackets because the VO files is just Boom Bot's greeting
GAMEPLAY_EMOTE_HERO_TBMECHWAR02_THINK1	<กำลังคิด...>	The text is in brackets because the VO files is just Boom Bot's greeting
GAMEPLAY_EMOTE_HERO_TBMECHWAR02_THINK2	<Acquiring target...>	The text is in brackets because the VO files is just Boom Bot's greeting
GAMEPLAY_EMOTE_HERO_TBMECHWAR02_THINK3	<ยังคิดอยู่...>	The text is in brackets because the VO files is just Boom Bot's greeting
GAMEPLAY_EMOTE_HERO_TBMECHWAR02_THREATEN	<ข่มขู่!>	The text is in brackets because the VO files is just Boom Bot's Attack sound
GAMEPLAY_EMOTE_HERO_TBMECHWAR02_TIMER	<เวลาเหลือน้อย>	The text is in brackets because the VO files is just Boom Bot's greeting
GAMEPLAY_EMOTE_HERO_TBMECHWAR02_WELL_PLAYED	<เล่นได้ดี>	The text is in brackets because the VO files is just Boom Bot's greeting
GAMEPLAY_EMOTE_HERO_TBMECHWAR02_WOW	<ยอดเยี่ยม!>	The text is in brackets because the VO files is just Annoy-o-Tron's greeting
GAMEPLAY_EMOTE_ICC_481_CONCEDE	เย็นใจได้ เจ้าชนะแล้ว	
GAMEPLAY_EMOTE_ICC_481_GREETINGS	ยินดีต้อนรับสู่\nอ้อมกอดมรณะอันหนาวเหน็บ	
GAMEPLAY_EMOTE_ICC_481_LOW_CARDS	การ์ดข้าใกล้จะหมดแล้ว!	
GAMEPLAY_EMOTE_ICC_481_NO_CARDS	การ์ดหมดแล้ว!	
GAMEPLAY_EMOTE_ICC_481_OOPS	พลาดแบบสมควรตาย	
GAMEPLAY_EMOTE_ICC_481_START	เพื่อดูมแฮมเมอร์!	
GAMEPLAY_EMOTE_ICC_481_THANKS	ขอบคุณ	
GAMEPLAY_EMOTE_ICC_481_THINK1	อืมมม...	
GAMEPLAY_EMOTE_ICC_481_THINK2	พลังธาตุช่างเงียบงัน...	
GAMEPLAY_EMOTE_ICC_481_THINK3	ข้าต้องตัดสินใจเอง	
GAMEPLAY_EMOTE_ICC_481_THREATEN	ข้าจะทำลายเจ้า!	
GAMEPLAY_EMOTE_ICC_481_TIMER	ข้าต้องเลือกสักทาง!	
GAMEPLAY_EMOTE_ICC_481_WELL_PLAYED	เล่นได้ดี	
GAMEPLAY_EMOTE_ICC_481_WOW	เหนือคำบรรยาย!	
GAMEPLAY_EMOTE_ICC_827_CONCEDE	วันนี้เป็นวันของเจ้า	
GAMEPLAY_EMOTE_ICC_827_GREETINGS	ไปซ่อนตัวอยู่ที่ไหนมา?	
GAMEPLAY_EMOTE_ICC_827_LOW_CARDS	การ์ดข้าใกล้จะหมดแล้ว!	
GAMEPLAY_EMOTE_ICC_827_NO_CARDS	การ์ดหมดแล้ว!	
GAMEPLAY_EMOTE_ICC_827_OOPS	น่าสงสารจัง	
GAMEPLAY_EMOTE_ICC_827_START	ระวังตัวให้ดี	
GAMEPLAY_EMOTE_ICC_827_THANKS	ขอบคุณ	
GAMEPLAY_EMOTE_ICC_827_THINK1	อืมมม...	
GAMEPLAY_EMOTE_ICC_827_THINK2	เงาแห่งความตายคืบคลาน…	
GAMEPLAY_EMOTE_ICC_827_THINK3	เวลาเดินอยู่...	
GAMEPLAY_EMOTE_ICC_827_THREATEN	เจ้าจะกลัวแม้แต่เงาของตัวเอง	
GAMEPLAY_EMOTE_ICC_827_TIMER	ข้าต้องรีบเลือกแล้ว!	
GAMEPLAY_EMOTE_ICC_827_WELL_PLAYED	ดีงาม	
GAMEPLAY_EMOTE_ICC_827_WOW	เหลือเชื่อ!	
GAMEPLAY_EMOTE_ICC_828_CONCEDE	เจ้าชนะแล้ว	
GAMEPLAY_EMOTE_ICC_828_GREETINGS	วิ่งหนีไปสิ เหยื่อเอ๋ย	
GAMEPLAY_EMOTE_ICC_828_LOW_CARDS	การ์ดข้าใกล้จะหมดแล้ว!	
GAMEPLAY_EMOTE_ICC_828_NO_CARDS	การ์ดหมดแล้ว!	
GAMEPLAY_EMOTE_ICC_828_OOPS	ไม่เข้าเป้า	
GAMEPLAY_EMOTE_ICC_828_START	ออกล่ากันเถอะ!	
GAMEPLAY_EMOTE_ICC_828_THANKS	ขอบใจ	
GAMEPLAY_EMOTE_ICC_828_THINK1	อืมมม...	
GAMEPLAY_EMOTE_ICC_828_THINK2	ตามรอยไหนดี…	
GAMEPLAY_EMOTE_ICC_828_THINK3	ขอคิดก่อน...	
GAMEPLAY_EMOTE_ICC_828_THREATEN	ข้าจะตามล่าเจ้า...ตลอดกาล	
GAMEPLAY_EMOTE_ICC_828_TIMER	กลิ่นจางลงทุกที!	
GAMEPLAY_EMOTE_ICC_828_WELL_PLAYED	เล่นได้ดี	
GAMEPLAY_EMOTE_ICC_828_WOW	ยอดเยี่ยมมาก	
GAMEPLAY_EMOTE_ICC_829_CONCEDE	เจ้าชนะแล้ว... อย่างน้อยก็คราวนี้	
GAMEPLAY_EMOTE_ICC_829_GREETINGS	ข้าคือความยุติธรรมเพียงหนึ่งเดียว	
GAMEPLAY_EMOTE_ICC_829_LOW_CARDS	การ์ดข้าใกล้จะหมดแล้ว!	
GAMEPLAY_EMOTE_ICC_829_NO_CARDS	การ์ดหมดแล้ว!	
GAMEPLAY_EMOTE_ICC_829_OOPS	น่าผิดหวัง	
GAMEPLAY_EMOTE_ICC_829_START	ข้าจะสู้อย่างมีเกียรติ!	
GAMEPLAY_EMOTE_ICC_829_THANKS	ขอบคุณ	
GAMEPLAY_EMOTE_ICC_829_THINK1	อืมมม...	
GAMEPLAY_EMOTE_ICC_829_THINK2	ฟรอสต์มอร์นเรียกหาข้า...	
GAMEPLAY_EMOTE_ICC_829_THINK3	บัลลังก์เยือกแข็งเรียกหาข้า…	
GAMEPLAY_EMOTE_ICC_829_THREATEN	เจ้าจะร้องขอความเมตตา และข้าจะปฏิเสธ!	
GAMEPLAY_EMOTE_ICC_829_TIMER	จุดจบใกล้เข้ามาแล้ว!	
GAMEPLAY_EMOTE_ICC_829_WELL_PLAYED	เล่นได้ดี	
GAMEPLAY_EMOTE_ICC_829_WOW	เหลือเชื่อที่สุด!	
GAMEPLAY_EMOTE_ICC_830_CONCEDE	ไม่ ชัยชนะของเจ้าไม่มีความหมาย!	
GAMEPLAY_EMOTE_ICC_830_GREETINGS	ข้าจะแก้แค้นด้วยความมืดมิด	
GAMEPLAY_EMOTE_ICC_830_LOW_CARDS	การ์ดข้าใกล้จะหมดแล้ว!	
GAMEPLAY_EMOTE_ICC_830_NO_CARDS	การ์ดหมดแล้ว!	
GAMEPLAY_EMOTE_ICC_830_OOPS	ทำผิดซ้ำซาก	
GAMEPLAY_EMOTE_ICC_830_START	ความมืดนำเราสู่ชัยชนะ!	
GAMEPLAY_EMOTE_ICC_830_THANKS	ขอบคุณ	
GAMEPLAY_EMOTE_ICC_830_THINK1	อืมมม...	
GAMEPLAY_EMOTE_ICC_830_THINK2	ความมืดกระซิบบอกข้า...	
GAMEPLAY_EMOTE_ICC_830_THINK3	มืดแปดด้าน...	
GAMEPLAY_EMOTE_ICC_830_THREATEN	ความมืดจะกลืนกินเจ้า!	
GAMEPLAY_EMOTE_ICC_830_TIMER	ใกล้หมดเวลาแล้ว!	
GAMEPLAY_EMOTE_ICC_830_WELL_PLAYED	เล่นได้ดี	
GAMEPLAY_EMOTE_ICC_830_WOW	ไม่น่าเชื่อ!	
GAMEPLAY_EMOTE_ICC_831_CONCEDE	ครั้งนี้... เจ้าชนะ	
GAMEPLAY_EMOTE_ICC_831_GREETINGS	จงกลัวข้า	
GAMEPLAY_EMOTE_ICC_831_LOW_CARDS	การ์ดข้าใกล้จะหมดแล้ว!	
GAMEPLAY_EMOTE_ICC_831_NO_CARDS	การ์ดหมดแล้ว!	
GAMEPLAY_EMOTE_ICC_831_OOPS	เปล่าประโยชน์เสียจริง	
GAMEPLAY_EMOTE_ICC_831_START	ข้าจะกลืนกินวิญญาณเจ้า!	
GAMEPLAY_EMOTE_ICC_831_THANKS	อ้า ขอบใจ	
GAMEPLAY_EMOTE_ICC_831_THINK1	อืมมม...	
GAMEPLAY_EMOTE_ICC_831_THINK2	กระหายเหลือเกิน…	
GAMEPLAY_EMOTE_ICC_831_THINK3	เลือกยากเลือกเย็นเหลือเกิน...	
GAMEPLAY_EMOTE_ICC_831_THREATEN	ความเจ็บปวดของเจ้าจะต้อง... เป็นตำนาน!	
GAMEPLAY_EMOTE_ICC_831_TIMER	ข้าต้องจัดการแล้ว!	
GAMEPLAY_EMOTE_ICC_831_WELL_PLAYED	ดีมาก	
GAMEPLAY_EMOTE_ICC_831_WOW	แม่เจ้าโว้ย	
GAMEPLAY_EMOTE_ICC_832_CONCEDE	เจ้าชนะ ข้าพักผ่อนได้แล้ว	
GAMEPLAY_EMOTE_ICC_832_GREETINGS	วงจรมรณะเริ่มขึ้นแล้ว	
GAMEPLAY_EMOTE_ICC_832_LOW_CARDS	การ์ดข้าใกล้จะหมดแล้ว!	
GAMEPLAY_EMOTE_ICC_832_NO_CARDS	การ์ดหมดแล้ว!	
GAMEPLAY_EMOTE_ICC_832_OOPS	ยุ่งเหยิงไปหมด	
GAMEPLAY_EMOTE_ICC_832_START	วัฏจักรแห่งชีวิตสิ้นสุดแล้ว!	
GAMEPLAY_EMOTE_ICC_832_THANKS	ข้าขอขอบใจ	
GAMEPLAY_EMOTE_ICC_832_THINK1	อืมมม...	
GAMEPLAY_EMOTE_ICC_832_THINK2	ความคิดยุ่งเหยิง...	
GAMEPLAY_EMOTE_ICC_832_THINK3	สมองข้าขุ่นมัว...	
GAMEPLAY_EMOTE_ICC_832_THREATEN	จงแห้งเหี่ยวสลายไป	
GAMEPLAY_EMOTE_ICC_832_TIMER	ความตายเป็นนิรันดร์ แต่เทิร์นข้าไม่ใช่!	
GAMEPLAY_EMOTE_ICC_832_WELL_PLAYED	เล่นได้เยี่ยม	
GAMEPLAY_EMOTE_ICC_832_WOW	ตะลึงเลย!	
GAMEPLAY_EMOTE_ICC_833_CONCEDE	แข็งแกร่งมาก ข้ายอมแพ้	
GAMEPLAY_EMOTE_ICC_833_GREETINGS	ตัวสั่นหมดแล้ว... กลัวล่ะสิ?	
GAMEPLAY_EMOTE_ICC_833_LOW_CARDS	การ์ดข้าใกล้จะหมดแล้ว!	
GAMEPLAY_EMOTE_ICC_833_NO_CARDS	การ์ดหมดแล้ว!	
GAMEPLAY_EMOTE_ICC_833_OOPS	พลาดแบบนี้ตายแน่	
GAMEPLAY_EMOTE_ICC_833_START	รนหาที่เองนะ!	
GAMEPLAY_EMOTE_ICC_833_THANKS	ขอบคุณ	
GAMEPLAY_EMOTE_ICC_833_THINK1	อืมมม...	
GAMEPLAY_EMOTE_ICC_833_THINK2	เวลาเหลือน้อยแล้ว...	
GAMEPLAY_EMOTE_ICC_833_THINK3	อืม ต้องเลือกแล้ว...	
GAMEPLAY_EMOTE_ICC_833_THREATEN	จงก้มหัวให้ราชินี!	
GAMEPLAY_EMOTE_ICC_833_TIMER	ถึงเวลาแล้ว!	
GAMEPLAY_EMOTE_ICC_833_WELL_PLAYED	เล่นได้ดี	
GAMEPLAY_EMOTE_ICC_833_WOW	ใจละลายหมดแล้ว!	
GAMEPLAY_EMOTE_ICC_834_CONCEDE	ข้ายอมตาย	
GAMEPLAY_EMOTE_ICC_834_GREETINGS	เจ้าไม่มีทางรอดพ้น\nจากโทสะแห่งเฮลสครีม	
GAMEPLAY_EMOTE_ICC_834_LOW_CARDS	การ์ดใกล้จะหมดแล้ว!	
GAMEPLAY_EMOTE_ICC_834_NO_CARDS	การ์ดหมดแล้ว	
GAMEPLAY_EMOTE_ICC_834_OOPS	ล้มเหลว	
GAMEPLAY_EMOTE_ICC_834_START	ชัยชนะหรือความตาย	
GAMEPLAY_EMOTE_ICC_834_THANKS	ขอบใจ	
GAMEPLAY_EMOTE_ICC_834_THINK1	อืมมม...	
GAMEPLAY_EMOTE_ICC_834_THINK2	เวลาเดินอยู่...	
GAMEPLAY_EMOTE_ICC_834_THINK3	เอาไงดีล่ะ....	
GAMEPLAY_EMOTE_ICC_834_THREATEN	เจ้าจะต้องคุกเข่าลงเป็นคนแรก	
GAMEPLAY_EMOTE_ICC_834_TIMER	ต้องเลือกแล้ว!	
GAMEPLAY_EMOTE_ICC_834_WELL_PLAYED	ศัตรูที่คู่ควร	
GAMEPLAY_EMOTE_ICC_834_WOW	ยอดเยี่ยม!	
VO_Arthas_Male_Human_Attack_01	ความชั่วร้ายต้องถูกกำจัด...	
VO_Arthas_Male_Human_CONCEDE_01	การต่อสู้จบลงแล้ว เจ้าชนะ	
VO_Arthas_Male_Human_ERROR_FULL_MINIONS_01	มีมินเนี่ยนมากเกินไปแล้ว!	
VO_Arthas_Male_Human_ERROR_GENERIC_01	ข้าทำแบบนั้นไม่ได้	
VO_Arthas_Male_Human_ERROR_HAND_FULL_01	การ์ดเต็มมือข้าแล้ว!	
VO_Arthas_Male_Human_ERROR_I_ATTACKED_01	ข้าโจมตีไปแล้ว	
VO_Arthas_Male_Human_ERROR_JUST_PLAYED_01	ให้มินเนี่ยนตัวนั้น[b]เตรียมพร้อมสักเทิร์น	
VO_Arthas_Male_Human_ERROR_MINION_ATTACKED_01	มินเนี่ยนตัวนั้นโจมตีไปแล้ว	
VO_Arthas_Male_Human_ERROR_NEED_MANA_01	ข้ามีมานาไม่พอ	
VO_Arthas_Male_Human_ERROR_NEED_WEAPON_01	ข้าต้องมีอาวุธ	
VO_Arthas_Male_Human_ERROR_PLAY_01	ข้าเล่นแบบนั้นไม่ได้	
VO_Arthas_Male_Human_ERROR_STEALTH_01	เลือกมินเนี่ยนที่ซ่อนตัว เป็นเป้าหมายไม่ได้	
VO_Arthas_Male_Human_ERROR_TARGET_01	เป้าหมายไม่ถูกต้อง	
VO_Arthas_Male_Human_ERROR_TAUNT_01	มินเนี่ยนที่ยั่วยุขวางทางอยู่	
VO_Arthas_Male_Human_FIRE_FESTIVAL_01	จุดไฟเลย!	
VO_Arthas_Male_Human_GREETINGS_01	สวัสดี ยินดีที่ได้พบ	
VO_Arthas_Male_Human_HAPPY_HALLOWEEN_01	สุขสันต์เทศกาล[b]ฮอลโลว์สเอนด์...	
VO_Arthas_Male_Human_HAPPY_HOLIDAYS_01	สุขสันต์งานฉลองวินเทอร์เวล!	
VO_Arthas_Male_Human_HAPPY_NEW_YEAR_01	สวัสดีปีใหม่!	
VO_Arthas_Male_Human_HAPPY_NEW_YEAR_LUNAR_01	สวัสดีปีใหม่!	
VO_Arthas_Male_Human_HAPPY_NOBLEGARDEN	สุขสันต์เทศกาล[b]โนเบิ้ลการ์เด้น	
VO_Arthas_Male_Human_LOW_CARDS_01	การ์ดใกล้จะหมดแล้ว!	
VO_Arthas_Male_Human_MIRROR_GREETINGS_01	ยินดีเช่นกัน!	
VO_Arthas_Male_Human_MIRROR_START_01	เพื่อท่านพ่อของข้า!	
VO_Arthas_Male_Human_NO_CARDS_01	การ์ดหมดแล้ว!	
VO_Arthas_Male_Human_OOPS_01	พลาดแล้ว	
VO_Arthas_Male_Human_PIRATE_DAY_01	เป็นอาาาาร์ธัสนี่ดีจริงๆ!	
VO_Arthas_Male_Human_SORRY_01	ขอโทษอย่างสูง สหายข้า	
VO_Arthas_Male_Human_START_01	เพื่อลอร์เดอรัน!	
VO_Arthas_Male_Human_THANKS_01	ขอบคุณเจ้ามาก	
VO_Arthas_Male_Human_THINK1_01	อืมม…	
VO_Arthas_Male_Human_THINK2_01	เลือกทางไหนดี…	
VO_Arthas_Male_Human_THINK3_01	อูเธอร์จะทำยังไงนะ…	
VO_Arthas_Male_Human_THREATEN_01	เจ้ามันเกินเยียวยาแล้ว!	
VO_Arthas_Male_Human_TIMER_01	ต้องลงมือแล้ว!	
VO_Arthas_Male_Human_WELL_PLAYED_01	เล่นได้ดี	
VO_Arthas_Male_Human_WOW_01	พระเจ้าช่วย!	
VO_BRM_027h__LUNAR_NEW_YEAR	ไฟจะเผาผลาญเจ้า!	
VO_BRM_027h_Attack_15	รับไปสิ เปลวเพลิงแห่งซัลฟิวรอน!	
VO_BRM_027h_Concede_11	เจ้าชนะแล้ว เป็นเกมที่ดีมาก!	
VO_BRM_027h_Emote_Start	แล้วข้าจะกลับมาแก้แค้น เจ้ามังกร!	
VO_BRM_027h_ERROR01_51	ข้าต้องการอาวุธ	
VO_BRM_027h_ERROR02_52	มานาไม่พอ	
VO_BRM_027h_ERROR03_53	มันโจมตีไปแล้ว	
VO_BRM_027h_ERROR04_54	ข้าโจมตีไปแล้ว	
VO_BRM_027h_ERROR05_55	เจ้าพวกไร้ค่าต้องการ หนึ่งเทิร์นเพื่อเตรียมพร้อม	
VO_BRM_027h_ERROR06_56	การ์ดมากเกินไป!	
VO_BRM_027h_ERROR07_57	มินเนี่ยนมากเกินไป	
VO_BRM_027h_ERROR08_58	มันซ่อนตัวอยู่	
VO_BRM_027h_ERROR09_59	เล่นใบนั้นไม่ได้	
VO_BRM_027h_ERROR10_60	ไม่ได้	
VO_BRM_027h_ERROR11_61	มินเนี่ยนที่ยั่วยุขวางทางข้าอยู่	
VO_BRM_027h_ERROR12_62	ทำแบบนั้นไม่ได้	
VO_BRM_027h_FIRE_FESTIVAL	นี่คืองานเทศกาลของข้า!	
VO_BRM_027h_GG_16	เป็นเกมที่ดี!	
VO_BRM_027h_Greetings_04	ไฟจะเผาผลาญเจ้า!	
VO_BRM_027h_HALLOWS_END	สุขสันต์เทศกาลฮอลโลว์สเอนด์!	
VO_BRM_027h_HAPPY_NEW_YEAR_38	ข้าจะฉลองปีใหม่อย่างเร่าร้อน!	
VO_BRM_027h_LowCards_49	การ์ดข้าไหม้เกือบหมดแล้ว	
VO_BRM_027h_NOBLEGARDEN	ข้าจะต้มจน[b]ไข่สุกเลย!	
VO_BRM_027h_NoCards_50	การ์ดข้าไหม้จนไม่เหลือแล้ว	
VO_BRM_027h_Oops_07	ฮึ่ย! พลาดแล้ว!	
VO_BRM_027h_PIRATE_DAY	ข้าคือเจ้าแห่งโจรสลัด... เพลิง!	
VO_BRM_027h_Sorry_10	โทษที	
VO_BRM_027h_Thanks_09	ขอบใจ	
VO_BRM_027h_Thinking1_12	อืมมม...	
VO_BRM_027h_Thinking2_13	ยังไงดี...	
VO_BRM_027h_Thinking3_14	จะเผาอะไรก่อนดี…	
VO_BRM_027h_Threaten_08	เจ้าจะมอดม้วยด้วยเปลวเพลิง!	
VO_BRM_027h_Time_48	ช้าไม่ได้แล้ว!	
VO_BRM_027h_Well_Played_06	เล่นได้ดี	
VO_BRM_027h_Winterveil_Greetings	หน้าหนาวควรจะอุ่นกว่านี้!	
VO_BRM_027h_WOW_20	ร้อนแรงเหลือเกิน!	
VO_EX1_323h_HAPPY_NEW_YEAR_13	สวัสดีปีใหม่!	
VO_GIL_504_Female_Orc_Concede_01	ครั้งนี้เจ้าชนะ...	
VO_GIL_504_Female_Orc_Greetings_02	ขอรับสู่ดินแดนของข้า	
VO_GIL_504_Female_Orc_LowCards_01	การ์ดของข้าใกล้หมดแล้ว!	
VO_GIL_504_Female_Orc_NoCards_01	การ์ดหมดแล้ว!	
VO_GIL_504_Female_Orc_Oops_01	ไม่ฉลาดเลย	
VO_GIL_504_Female_Orc_Start_01	ป่ายามราตรีช่างอันตราย	
VO_GIL_504_Female_Orc_Thanks_01	ขอบคุณ	
VO_GIL_504_Female_Orc_Thinking_01	อืมม…	
VO_GIL_504_Female_Orc_Thinking_02	สับสนเหลือเกิน…	
VO_GIL_504_Female_Orc_Thinking_03	หนทางช่างมืดมน...	
VO_GIL_504_Female_Orc_Threaten_02	คำสาปจะพรากชีวิตเจ้า!	
VO_GIL_504_Female_Orc_Time_01	ต้องรีบตัดสินใจ!	
VO_GIL_504_Female_Orc_Well_Played_01	ทำได้ดีมาก	
VO_GIL_504_Female_Orc_Wow_01	ร้ายกาจที่สุด!	
VO_GILA_400h_Male_Human_Concede_01	เจ้ามันเก่งเกินไป!	
VO_GILA_400h_Male_Human_Death_02	<ตาย>	
VO_GILA_400h_Male_Human_ERROR_FULL_MINIONS_01	ไม่มีที่ว่างแล้ว	
VO_GILA_400h_Male_Human_ERROR_GENERIC_01	ข้าทำไม่ได้	
VO_GILA_400h_Male_Human_ERROR_GENERIC_04	ทำไม่ได้หรอก	
VO_GILA_400h_Male_Human_ERROR_HAND_FULL_01	มีการ์ดมากไปแล้ว!	
VO_GILA_400h_Male_Human_ERROR_I_ATTACKED_01	ข้าโจมตีไปแล้ว	
VO_GILA_400h_Male_Human_ERROR_MINION_ATTACKED_01	ตัวนั้นโจมตีไปแล้ว	
VO_GILA_400h_Male_Human_ERROR_NEED_MANA_02	ข้าไม่มีมานาแล้ว!	
VO_GILA_400h_Male_Human_ERROR_NEED_WEAPON_02	ข้าต้องมีอาวุธ!	
VO_GILA_400h_Male_Human_ERROR_STEALTH_01	มันซ่อนตัวอยู่!	
VO_GILA_400h_Male_Human_ERROR_SUMMON_SICKNESS_01	มันยังไม่พร้อม	
VO_GILA_400h_Male_Human_ERROR_TARGET_01	เลือกเป้าหมายนั้นไม่ได้	
VO_GILA_400h_Male_Human_ERROR_TAUNT_01	มินเนี่ยนยั่วยุขวางทางอยู่	
VO_GILA_400h_Male_Human_Greetings_01	ข้าไม่ชอบหน้าเจ้า หมาของข้า[b]ไม่ชอบหน้าเจ้า	
VO_GILA_400h_Male_Human_LowCards_01	การ์ดข้าใกล้หมดแล้ว!	
VO_GILA_400h_Male_Human_NoCards_01	การ์ดหมดแล้ว!	
VO_GILA_400h_Male_Human_Oops_01	ไม่ได้เรื่องเลย	
VO_GILA_400h_Male_Human_Sorry_01	เสียใจด้วย	
VO_GILA_400h_Male_Human_Start_01	ดูสิว่าหมาขุดเจออะไร	
VO_GILA_400h_Male_Human_Thanks_01	ขอบใจ	
VO_GILA_400h_Male_Human_Thinking_01	ขอคิดก่อน...	
VO_GILA_400h_Male_Human_Thinking_03	ต้องคิดให้ดี…	
VO_GILA_400h_Male_Human_Thinking_04	คิดสิ คิด...	
VO_GILA_400h_Male_Human_Threaten_04	เจ้าเหมาะกับเล่น[b]แกล้งตายที่สุด	
VO_GILA_400h_Male_Human_Time_01	เวลาเหลือน้อยแล้ว	
VO_GILA_400h_Male_Human_Well_Played_01	ฉลาดเหมือนกันนี่!	
VO_GILA_400h_Male_Human_WOW_01	บ้าแล้ว!	
VO_GILA_500h3_Female_Human_Concede_01	ข้าเอาชนะเจ้าไม่ได้	
VO_GILA_500h3_Female_Human_ERROR_FULL_MINIONS_01	มีที่ว่างไม่พอ	
VO_GILA_500h3_Female_Human_ERROR_GENERIC_04	ทำแบบนั้นไม่ได้!	
VO_GILA_500h3_Female_Human_ERROR_HAND_FULL_02	มือข้ามีที่ว่าง[b]ไม่พอแล้ว!	
VO_GILA_500h3_Female_Human_ERROR_I_ATTACKED_02	ข้าโจมตีซ้ำไม่ได้!	
VO_GILA_500h3_Female_Human_ERROR_MINION_ATTACKED_01	มันโจมตีไปแล้ว	
VO_GILA_500h3_Female_Human_ERROR_NEED_MANA_02	ข้ามีมานาไม่พอ	
VO_GILA_500h3_Female_Human_ERROR_NEED_WEAPON_02	ข้าต้องใช้อาวุธ	
VO_GILA_500h3_Female_Human_ERROR_PLAY_01	ข้าฝืนกฎไม่ได้หรอก	
VO_GILA_500h3_Female_Human_ERROR_STEALTH_01	ข้าหามันไม่เจอ!	
VO_GILA_500h3_Female_Human_ERROR_SUMMON_SICKNESS_01	มินเนี่ยนตัวนั้นยังไม่พร้อม	
VO_GILA_500h3_Female_Human_ERROR_TARGET_01	เลือกเป้าหมายนั้นไม่ได้	
VO_GILA_500h3_Female_Human_ERROR_TAUNT_01	มินเนี่ยนยั่วยุขวางทางอยู่!	
VO_GILA_500h3_Female_Human_Greetings_01	อันคราวน์ฝาก[b]ความคิดถึงมาให้	
VO_GILA_500h3_Female_Human_LowCards_01	เหลือการ์ดไม่มากแล้ว...	
VO_GILA_500h3_Female_Human_NoCards_01	ข้าไม่มีการ์ดเหลือแล้ว!	
VO_GILA_500h3_Female_Human_Oops_02	นั่นมัน... ผิดจากที่คิด	
VO_GILA_500h3_Female_Human_Sorry_01	ขอโทษที	
VO_GILA_500h3_Female_Human_Start_01	ร่องรอยนำทางมาที่นี่	
VO_GILA_500h3_Female_Human_Thanks_01	ขอบใจ	
VO_GILA_500h3_Female_Human_Thinking_02	ต้องมีทางสิ…	
VO_GILA_500h3_Female_Human_Thinking_03	คิดสิ เทส คิด	
VO_GILA_500h3_Female_Human_Thinking_05	เอ้อ... อืม	
VO_GILA_500h3_Female_Human_Threaten_03	ข้าจะกำจัดเจ้า!	
VO_GILA_500h3_Female_Human_Time_01	ต้องรีบลงมือแล้ว	
VO_GILA_500h3_Female_Human_Well_Played_01	เป็นแผนที่ดี 	
VO_GILA_500h3_Female_Human_WOW_01	สุดยอดที่สุด	
VO_GILA_600h_Male_Worgen_Concede_01	ข้าพลาดท่าให้เจ้าแล้ว!	
VO_GILA_600h_Male_Worgen_ERROR_FULL_MINIONS_02	มีมินเนี่ยนใน[b]สนามมากเกินไป	
VO_GILA_600h_Male_Worgen_ERROR_GENERIC_01	เป็นไปไม่ได้	
VO_GILA_600h_Male_Worgen_ERROR_GENERIC_02	ข้าทำแบบนั้นไม่ได้	
VO_GILA_600h_Male_Worgen_ERROR_HAND_FULL_01	การ์ดมากเกินไป!	
VO_GILA_600h_Male_Worgen_ERROR_I_ATTACKED_01	ข้าโจมตีไปแล้ว	
VO_GILA_600h_Male_Worgen_ERROR_MINION_ATTACKED_01	มินเนี่ยนตัวนั้นโจมตีไปแล้ว	
VO_GILA_600h_Male_Worgen_ERROR_NEED_MANA_01	มานาหมดแล้ว 	
VO_GILA_600h_Male_Worgen_ERROR_NEED_WEAPON_02	ข้าต้องมีอาวุธ	
VO_GILA_600h_Male_Worgen_ERROR_STEALTH_01	มินเนี่ยนตัวนั้นซ่อนอยู่!	
VO_GILA_600h_Male_Worgen_ERROR_SUMMON_SICKNESS_01	มันยังไม่พร้อมออกศึก	
VO_GILA_600h_Male_Worgen_ERROR_TARGET_01	ข้าเลือกมันไม่ได้	
VO_GILA_600h_Male_Worgen_ERROR_TAUNT_01	มินเนี่ยนยั่วยุขวางทางอยู่!	
VO_GILA_600h_Male_Worgen_Greetings_01	ทักทายเพื่อนตัวโต[b]ของข้าสิ	
VO_GILA_600h_Male_Worgen_LowCards_01	การ์ดข้าจะหมดแล้วนะ	
VO_GILA_600h_Male_Worgen_NoCards_01	การ์ดข้าหมดแล้ว!	
VO_GILA_600h_Male_Worgen_Oops_01	ผิดแผน!	
VO_GILA_600h_Male_Worgen_Sorry_01	ข้า... เสียใจด้วย	
VO_GILA_600h_Male_Worgen_Start_01	เข้าประจำตำแหน่งแล้ว	
VO_GILA_600h_Male_Worgen_Thanks_01	ขอบคุณ	
VO_GILA_600h_Male_Worgen_Thinking_01	ขอคิดก่อน...	
VO_GILA_600h_Male_Worgen_Thinking_02	แผนต่อไปคืออะไร...	
VO_GILA_600h_Male_Worgen_Thinking_04	ข้าต้องหาทาง...	
VO_GILA_600h_Male_Worgen_Threaten_01	ข้าจะถล่มเจ้าให้กระจุย!	
VO_GILA_600h_Male_Worgen_Time_01	อย่าเร่งข้า!	
VO_GILA_600h_Male_Worgen_Well_Played_01	เป็นยุทธวิธีที่ดี	
VO_GILA_600h_Male_Worgen_WOW_01	เหลือเชื่อที่สุด!	
VO_GILA_900h_Female_Gnome_Concede_01	ข้าหมดหนทางแล้ว เจ้าชนะ!	
VO_GILA_900h_Female_Gnome_ERROR_FULL_MINIONS_02	มินเนี่ยนเต็มสนามแล้ว	
VO_GILA_900h_Female_Gnome_ERROR_GENERIC_01	ข้าทำแบบนั้นไม่ได้	
VO_GILA_900h_Female_Gnome_ERROR_HAND_FULL_01	มีการ์ดมากไปแล้ว!	
VO_GILA_900h_Female_Gnome_ERROR_I_ATTACKED_02	ข้ายังโจมตีซ้ำไม่ได้!	
VO_GILA_900h_Female_Gnome_ERROR_MINION_ATTACKED_01	มินเนี่ยนตัวนั้น[b]โจมตีไปแล้ว	
VO_GILA_900h_Female_Gnome_ERROR_NEED_MANA_01	มานาไม่พอ	
VO_GILA_900h_Female_Gnome_ERROR_NEED_WEAPON_01	ข้าไม่มีอาวุธ	
VO_GILA_900h_Female_Gnome_ERROR_PLAY_01	ต่อให้เป็น ข้าก็ทำไม่ได้ 	
VO_GILA_900h_Female_Gnome_ERROR_STEALTH_01	เป้าหมายซ่อนตัวอยู่	
VO_GILA_900h_Female_Gnome_ERROR_SUMMON_SICKNESS_01	ขอเวลาให้มินเนี่ยน[b]เตรียมพร้อมก่อน	
VO_GILA_900h_Female_Gnome_ERROR_TARGET_01	เลือกเป้าหมายนั้นไม่ได้	
VO_GILA_900h_Female_Gnome_ERROR_TAUNT_01	มินเนี่ยนที่ยั่วยุ[b]ขวางทางอยู่!	
VO_GILA_900h_Female_Gnome_GG_01	เป็นเกมที่ดีจริงๆ!	
VO_GILA_900h_Female_Gnome_Greetings_01	อ้าว หวัดดี เจอกันอีกแล้ว	
VO_GILA_900h_Female_Gnome_LowCards_01	เหลือการ์ดไม่มากแล้ว…	
VO_GILA_900h_Female_Gnome_NoCards_01	การ์ดหมดแล้ว!	
VO_GILA_900h_Female_Gnome_Oops_02	พลาดซะแล้ว	
VO_GILA_900h_Female_Gnome_Sorry_01	เอ่อ เสียใจด้วย	
VO_GILA_900h_Female_Gnome_Start_01	หมดเวลาของเจ้าแล้ว!	
VO_GILA_900h_Female_Gnome_Thanks_01	ขอบใจ	
VO_GILA_900h_Female_Gnome_Thinking_02	อืมมม…	
VO_GILA_900h_Female_Gnome_Thinking_03	...ต้องคิดแบบ 4 มิติ	
VO_GILA_900h_Female_Gnome_Thinking_05	...ฟันเฟืองหมุนอยู่...	
VO_GILA_900h_Female_Gnome_Threaten_01	ข้าจะลบเจ้า[b]ออกจากมิติเวลา!	
VO_GILA_900h_Female_Gnome_Time_01	อย่างข้าเนี่ยนะจะหมดเวลา	
VO_GILA_900h_Female_Gnome_Well_Played_01	เป็นข้าก็ทำให้ดี[b]กว่านั้นไม่ได้หรอก!	
VO_GILA_900h_Female_Gnome_WOW_02	เป็นไปไม่ได้!	
VO_HERO_01_HAPPY_NEW_YEAR_06	สวัสดีปีใหม่!	
VO_HERO_02_HAPPY_NEW_YEAR_07	สวัสดีปีใหม่ สหายข้า!	
VO_HERO_03_HAPPY_NEW_YEAR_06	สวัสดีปีใหม่!	
VO_HERO_03a_Attack_15	ข้าคือความยุติธรรม!	
VO_HERO_03a_CONCEDE_06	ฉลาดมาก ข้ายอมแพ้	
VO_HERO_03a_ERROR_FULL_MINIONS_25	มีมินเนี่ยนมากเกินไปแล้ว!	
VO_HERO_03a_ERROR_GENERIC_30	ข้าทำแบบนั้นไม่ได้	
VO_HERO_03a_ERROR_HAND_FULL_24	การ์ดเต็มมือข้าแล้ว!	
VO_HERO_03a_ERROR_I_ATTACKED_22	ข้าโจมตีไปแล้ว	
VO_HERO_03a_ERROR_JUST_PLAYED_23	ให้มินเนี่ยนตัวนั้น เตรียมพร้อมสักเทิร์น	
VO_HERO_03a_ERROR_MINION_ATTACKED_21	มินเนี่ยนตัวนั้นโจมตีไปแล้ว	
VO_HERO_03a_ERROR_NEED_MANA_20	ข้ามีมานาไม่พอ	
VO_HERO_03a_ERROR_NEED_WEAPON_19	ข้าต้องมีอาวุธ	
VO_HERO_03a_ERROR_PLAY_27	เล่นการ์ดนั้นไม่ได้	
VO_HERO_03a_ERROR_STEALTH_26	เลือกมินเนี่ยนที่ซ่อนตัว เป็นเป้าหมายไม่ได้	
VO_HERO_03a_ERROR_TARGET_28	เป้าหมายไม่ถูกต้อง	
VO_HERO_03a_ERROR_TAUNT_29	มินเนี่ยนที่ยั่วยุขวางทางอยู่	
VO_HERO_03a_FIRE_FESTIVAL	สุขสันต์เทศกาลมิดซัมเมอร์!	
VO_HERO_03a_GREETINGS_03	สวัสดี สหาย	
VO_HERO_03a_HALLOWS_END	สุขสันต์เทศกาล[b]ฮอลโลว์สเอนด์	
VO_HERO_03a_HAPPY_HOLIDAYS_52	สุขสันต์งานฉลองวินเทอร์เวล!	
VO_HERO_03a_HAPPY_NEW_YEAR_53	สวัสดีปีใหม่!	
VO_HERO_03a_LOW_CARDS_17	การ์ดใกล้จะหมดแล้ว!	
VO_HERO_03a_MIRROR_GREETINGS_04	สวัสดี ยินดีที่ได้พบ!	
VO_HERO_03a_MIRROR_START_02	ข้าคือกำปั้นเหล็ก\nแห่งความยุติธรรม	
VO_HERO_03a_NO_CARDS_18	การ์ดหมดแล้ว!	
VO_HERO_03a_NOBLEGARDEN	สุขสันต์เทศกาล[b]โนเบิ้ลการ์เด้น![b]ไข่อยู่ไหนล่ะ	
VO_HERO_03a_OOPS_08	ผิดพลาดทางกลยุทธ์	
VO_HERO_03a_PICKED_11	ตอนนี้แหละ!	
VO_HERO_03a_PIRATE_DAY	ยาาร์! ออกเรือได้!	
VO_HERO_03a_SORRY_10	เสียใจด้วย	
VO_HERO_03a_START_01	ไม่มีใครรอดจากโทสะ\nของข้าไปได้	
VO_HERO_03a_THANKS_09	ขอบคุณ	
VO_HERO_03a_THINK1_12	อืมม…	
VO_HERO_03a_THINK2_13	ขอคิดก่อน...	
VO_HERO_03a_THINK3_14	คิดสิ…	
VO_HERO_03a_THREATEN_05	เจ้ายั่วโมโหข้าแล้ว!	
VO_HERO_03a_TIMER_16	ต้องรีบแล้ว!	
VO_HERO_03a_WELL_PLAYED_07	เล่นได้ดี	
VO_HERO_03a_WOW_35	เยี่ยมมาก	
VO_HERO_04_HAPPY_NEW_YEAR_15	สวัสดีปีใหม่นะแชมเปี้ยน!	
VO_HERO_05_HAPPY_NEW_YEAR_15	สวัสดีปีใหม่!	
VO_HERO_06_HAPPY_NEW_YEAR_15	สวัสดีปีใหม่!	
VO_HERO_07_HAPPY_NEW_YEAR_15	สวัสดีปีใหม่!	
VO_HERO_08_HAPPY_NEW_YEAR_15	สวัสดีปีใหม่!	
VO_HERO_08b_HAPPY_NEW_YEAR_53	สวัสดีปีใหม่!	
VO_HERO_09_HAPPY_NEW_YEAR_15	สวัสดีปีใหม่!	
VO_HERO_09a_Attack_15	แด่เอลูน!	
VO_HERO_09a_CONCEDE_06	มันจบแล้ว เจ้าเป็นฝ่ายชนะ	
VO_HERO_09a_ERROR_FULL_MINIONS_25	ข้ามีมินเนี่ยนมากเกินไปแล้ว!	
VO_HERO_09a_ERROR_GENERIC_30	ทำแบบนั้นไม่ได้	
VO_HERO_09a_ERROR_HAND_FULL_24	การ์ดเต็มมือข้าแล้ว!	
VO_HERO_09a_ERROR_I_ATTACKED_22	ข้าโจมตีไปแล้ว	
VO_HERO_09a_ERROR_JUST_PLAYED_23	มินเนี่ยนตัวนั้นต้องการ 1 เทิร์นเพือเตรียมพร้อม	
VO_HERO_09a_ERROR_MINION_ATTACKED_21	มินเนี่ยนตัวนั้นโจมตีไปแล้ว	
VO_HERO_09a_ERROR_NEED_MANA_20	ข้ามีมานาไม่เพียงพอ	
VO_HERO_09a_ERROR_NEED_WEAPON_19	ข้าต้องมีอาวุธ	
VO_HERO_09a_ERROR_PLAY_27	ข้าเล่นใบนั้นไม่ได้	
VO_HERO_09a_ERROR_STEALTH_26	เลือกมินเนี่ยนที่ซ่อนตัว\nเป็นเป้าหมายไม่ได้	
VO_HERO_09a_ERROR_TARGET_28	นั่นไม่ใช่เป้าหมายที่ถูกต้อง	
VO_HERO_09a_ERROR_TAUNT_29	มินเนี่ยนที่ยั่วยุขวางทางอยู่	
VO_HERO_09a_FIRE_FESTIVAL	สุขสันต์เทศกาลมิดซัมเมอร์	
VO_HERO_09a_GREETINGS_03	ขอพรจงมีแก่เจ้า	
VO_HERO_09a_HALLOWS_END	สุขสันต์เทศกาล[b]ฮอลโลว์สเอนด์	
VO_HERO_09a_HAPPY_HOLIDAYS_52	สุขสันต์งานฉลองวินเทอร์เวล!	
VO_HERO_09a_HAPPY_NEW_YEAR_01	สวัสดีปีใหม่!	
VO_HERO_09a_HAPPY_NEW_YEAR_LUNAR_53	ขอพรจงมีแก่เจ้า	
VO_HERO_09a_LOW_CARDS_17	การ์ดของข้าใกล้จะหมดแล้ว	
VO_HERO_09a_MIRROR_GREETINGS_04	เจ้าก็เช่นกัน	
VO_HERO_09a_MIRROR_START_02	เทพธิดาปกป้องข้า	
VO_HERO_09a_NO_CARDS_18	การ์ดของข้าหมดแล้ว!	
VO_HERO_09a_NOBLEGARDEN	สุขสันต์เทศกาล[b]โนเบิ้ลการ์เด้น	
VO_HERO_09a_OOPS_08	ข้าพลาด	
VO_HERO_09a_PICKED_11	เทพธิดาเรียกหาข้า!	
VO_HERO_09a_PIRATE_DAY	วาจาแห่งพลัง: ยาาร์!	
VO_HERO_09a_SORRY_10	ยกโทษให้ข้าด้วย	
VO_HERO_09a_START_01	เอลูนมอบพลังให้ข้า	
VO_HERO_09a_START_MALFURION	มัลฟิวเรียน ที่รักของข้า	
VO_HERO_09a_THANKS_09	ขอบคุณ	
VO_HERO_09a_THINK1_12	อืมม…	
VO_HERO_09a_THINK2_13	ยังไงดี...	
VO_HERO_09a_THINK3_14	เอลูนประสงค์สิ่งใดกัน…	
VO_HERO_09a_THREATEN_05	แล้วเจ้าจะเสียใจ!	
VO_HERO_09a_TIMER_16	รีบหน่อย!	
VO_HERO_09a_WELL_PLAYED_07	เล่นได้ดีมาก	
VO_HERO_09a_WOW_10	ยอดเยี่ยมมาก!	
VO_HERO_11_HAPPY_NEW_YEAR_20	สวัสดีปีใหม่!	
VO_HERO_12_HAPPY_NEW_YEAR_20	สวัสดีปีใหม่!	
VO_HERO_13_HAPPY_NEW_YEAR_20	สวัสดีปีใหม่!	
VO_HERO_14_HAPPY_NEW_YEAR_20	สวัสดีปีใหม่!	
VO_HERO_15_HAPPY_NEW_YEAR_24	<สวัสดีปีใหม่!>	
VO_HERO_16_Female_Dryad_Concede_01	แพ้บ้างก็ได้	
VO_HERO_16_Female_Dryad_ERROR_01	ข้าไม่มีอาวุธนะ	
VO_HERO_16_Female_Dryad_ERROR_02	ข้าต้องมีมานามากกว่านี้!	
VO_HERO_16_Female_Dryad_ERROR_03	มินเนี่ยนตัวนั้น[b]โจมตีอีกไม่ได้แล้ว!	
VO_HERO_16_Female_Dryad_ERROR_04	ข้าโจมตีไปแล้ว	
VO_HERO_16_Female_Dryad_ERROR_05	มินเนี่ยนตัวนั้น[b]ยังโจมตีไม่ได้	
VO_HERO_16_Female_Dryad_ERROR_06	การ์ดล้นมือข้าแล้ว!	
VO_HERO_16_Female_Dryad_ERROR_07	ข้ามีมินเนี่ยน[b]มากเกินไปแล้ว!	
VO_HERO_16_Female_Dryad_ERROR_08	มินเนี่ยนขี้ขลาด[b]นั่นซ่อนตัวอยู่	
VO_HERO_16_Female_Dryad_ERROR_09	ข้าทำแบบนั้นไม่ได้	
VO_HERO_16_Female_Dryad_ERROR_10	เป็นไปไม่ได้	
VO_HERO_16_Female_Dryad_ERROR_11	ข้าต้องโจมตี[b]มินเนี่ยนที่[b]ยั่วยุก่อน!	
VO_HERO_16_Female_Dryad_ERROR_12	ไม่มีทางเป็นอย่างนั้นแน่	
VO_HERO_16_Female_Dryad_FIRE_FESTIVAL_01	ข้าชอบเทศกาลไฟ!	
VO_HERO_16_Female_Dryad_Greetings_01	ธรรมชาติอวยพรเจ้า	
VO_HERO_16_Female_Dryad_HAPPY_HALLOWEEN_01	สุขสันต์เทศกาล[b]ฮอลโลว์สเอนด์!	
VO_HERO_16_Female_Dryad_HAPPY_HOLIDAYS_01	สุขสันต์งานฉลอง[b]วินเทอร์เวล!	
VO_HERO_16_Female_Dryad_HAPPY_NEW_YEAR_01	มาฉลองปีใหม่กัน!	
VO_HERO_16_Female_Dryad_HAPPY_NOBLEGARDEN_01	สุขสันต์เทศกาล[b]โนเบิ้ลการ์เด้น!	
VO_HERO_16_Female_Dryad_LowCards_01	การ์ดข้าใกล้จะหมดแล้ว!	
VO_HERO_16_Female_Dryad_MALFURION_START_01	อิชนู'อาลา อาร์คดรูอิด	
VO_HERO_16_Female_Dryad_MIRROR_GREETINGS_01	สวัสดีเจ้าด้วย!	
VO_HERO_16_Female_Dryad_MIRROR_START_01	เพื่อธรรมชาติ!	
VO_HERO_16_Female_Dryad_NoCards_01	ไม่มีการ์ดเหลือแล้ว!	
VO_HERO_16_Female_Dryad_Oops_02	หลงป่าไปไกลเลย	
VO_HERO_16_Female_Dryad_PIRATE_DAY_01	ยาร์! ข้าคือโจรสลัด!	
VO_HERO_16_Female_Dryad_Sorry_01	ขอโทษด้วยนะ	
VO_HERO_16_Female_Dryad_Start_01	ธรรมชาติมาเอาคืนแล้ว	
VO_HERO_16_Female_Dryad_Thanks_01	ขอบใจในความพยายาม	
VO_HERO_16_Female_Dryad_Thinking_01	ไหนดูซิ…	
VO_HERO_16_Female_Dryad_Thinking_02	เอาอย่างนี้ดีมั้ย…	
VO_HERO_16_Female_Dryad_Thinking_03	ถ้าแบบนี้ล่ะ…	
VO_HERO_16_Female_Dryad_Threaten_01	จงรับรู้[b]ความเจ็บปวด[b]ของผืนป่า!	
VO_HERO_16_Female_Dryad_Time_01	เวลาสั้นลงทุกที	
VO_HERO_16_Female_Dryad_Well_Played_01	ทำได้ดีมาก	
VO_HERO_16_Female_Dryad_WOW_01	ดุเดือดมาก!	
VO_HERO_18_Female_Gnome_Concede_01	ยอดเยี่ยม เจ้าชนะแล้ว	
VO_HERO_18_Female_Gnome_ERROR_01	ต้องมีอาวุธไม่ใช่เหรอ?	
VO_HERO_18_Female_Gnome_ERROR_03	มานาไม่พอ	
VO_HERO_18_Female_Gnome_ERROR_04	มันโจมตีไปแล้ว	
VO_HERO_18_Female_Gnome_ERROR_06	โจมตีสองครั้งไม่ได้	
VO_HERO_18_Female_Gnome_ERROR_07	ชู่วว มันยังหลับอยู่	
VO_HERO_18_Female_Gnome_ERROR_08	โว้ว มีการ์ดเยอะไปแล้ว!	
VO_HERO_18_Female_Gnome_ERROR_10	มินเนี่ยนได้แค่เจ็ดตัวนะจ๊ะ!	
VO_HERO_18_Female_Gnome_ERROR_12	มันซ่อนตัวอยู่!	
VO_HERO_18_Female_Gnome_ERROR_14	ฮึ ทำไม่ได้	
VO_HERO_18_Female_Gnome_ERROR_15	เลือกเป้าหมายนั้นไม่ได้	
VO_HERO_18_Female_Gnome_ERROR_17	มินเนี่ยนยั่วยุขวางทางอยู่	
VO_HERO_18_Female_Gnome_FIRE_FESTIVAL_01	ข้าชอบพลุมิดซัมเมอร์ที่สุด!	
VO_HERO_18_Female_Gnome_Greetings_01	เฮ้ หวัดดี!	
VO_HERO_18_Female_Gnome_HAPPY_HALLOWEEN_01	ฮอลโลว์สเอนด์?! น่ากลัวจัง...	
VO_HERO_18_Female_Gnome_HAPPY_HOLIDAYS_01	สุขสันต์งานฉลองวินเทอร์เวล	
VO_HERO_18_Female_Gnome_HAPPY_NEW_YEAR_01	สวัสดีปีใหม่!	
VO_HERO_18_Female_Gnome_HAPPY_NEW_YEAR_LUNAR_16	สวัสดีปีใหม่!	
VO_HERO_18_Female_Gnome_LowCards_01	การ์ดข้าใกล้จะหมดแล้ว!	
VO_HERO_18_Female_Gnome_MIRROR_START_01	เย้! นี่มันต้องสุดยอดแน่ๆ!	
VO_HERO_18_Female_Gnome_NOBLEGARDEN	ข้าชอบโนเบิ้ลการ์เด้น!	
VO_HERO_18_Female_Gnome_NoCards_01	ข้าไม่มีการ์ดเหลือแล้ว!	
VO_HERO_18_Female_Gnome_Oops_02	วู๊ปซี่!	
VO_HERO_18_Female_Gnome_PIRATE_DAY_01	ย้าร์ ข้าคือโจรสลัด! ย้าาาร์!	
VO_HERO_18_Female_Gnome_Sorry_01	อ๋อยย ขอโทษนะ	
VO_HERO_18_Female_Gnome_Start_01	มาสนุกกันดีกว่า!	
VO_HERO_18_Female_Gnome_Thanks_02	อ๋อยย ขอบคุณนะ!	
VO_HERO_18_Female_Gnome_Thinking_01	อืมมม...	
VO_HERO_18_Female_Gnome_Thinking_03	ฮัม ดัม ดี ดัม ดัม...	
VO_HERO_18_Female_Gnome_Thinking_04	แบบนี้เป็นไง...	
VO_HERO_18_Female_Gnome_Threaten_01	มาเป็นหุ่นเชิดของข้าเถอะ	
VO_HERO_18_Female_Gnome_Time_01	ต้องรีบแล้ว!	
VO_HERO_18_Female_Gnome_Well_Played_01	ว้าว เล่นดีเชียวนะ!	
VO_HERO_18_Female_Gnome_WOW_01	นี่มันเจ๋งสุดๆ!	
VO_ICC08_LichKing_Male_Human_YoungArthas_02	ข้าเกลียดการสู้กับตัวเอง	
VO_TBA01_4__Concede	*คำราม*	
VO_TBA01_4__Error_Full_Minions	*คำราม*	
VO_TBA01_4__Error_Generic	*คำราม*	
VO_TBA01_4__Error_Hand_Full	*คำราม*	
VO_TBA01_4__Error_I_Attacked	*คำราม*	
VO_TBA01_4__Error_Just_Played	*คำราม*	
VO_TBA01_4__Error_Minion_Attacked	*คำราม*	
VO_TBA01_4__Error_Need_Mana	*คำราม*	
VO_TBA01_4__Error_Need_Weapon	*คำราม*	
VO_TBA01_4__Error_Play	*คำราม*	
VO_TBA01_4__Error_Stealth	*คำราม*	
VO_TBA01_4__Good_Game	*คำราม*	
VO_TBA01_4__Greetings	เริ่มเกมกันได้แล้ว!	
VO_TBA01_4__Low_Cards	*คำราม*	
VO_TBA01_4__No_Cards	*คำราม*	
VO_TBA01_4__Oops	โอ๊ะ	
VO_TBA01_4__Sorry	เสียใจด้วย	
VO_TBA01_4__Start	ที่นี่ข้าคือราชา!	
VO_TBA01_4__Thanks	ขอบใจ	
VO_TBA01_4__Threaten	จงดู! นี่คือพลังที่แท้จริงของเนฟาเรี่ยน!	
VO_TBA01_4__Timer	*คำราม*	
VO_TBA01_4__Well_Played	เล่นได้ดี	
