TAG	TEXT	COMMENT
ChromaggusBoss_Death_1	แฮรรรรรร่!	
ChromaggusBoss_EmoteResponse_1	*คำราม*	
ChromaggusBoss_Start_1	แฮ่!	
GiantRat_LOOTA_BOSS_18h_DefeatPlayer	<เสียงร้อง>	
GiantRat_LOOTA_BOSS_18h_EmoteResponse	<เสียงร้อง>	
GILA_BOSS_65h_Gobbles_DefeatPlayer	<เสียงร้อง>	
GILA_BOSS_65h_Gobbles_EmoteResponse	<เสียงร้อง>	
GILA_BOSS_65h_Gobbles_Intro	<เสียงร้อง>	
LOE_07_MINE_CART_EMOTES	แก๊ง	
LOOTA_BOSS_21h_GnoshTheGreatWorm_EmoteResponse	<คำราม>	
LOOTA_BOSS_47h_Lava_FilledRoom_Emote	<คลั่ง>	
LOOTA_BOSS_52h_TreasureVault_Emote	<ชิ๊ง>	
OnyxiaBoss_Death_1	แฮรรรรรร่!	
OnyxiaBoss_EmoteResponse_1	*คำราม*	
OnyxiaBoss_Start_1	แฮ่!	
POPUP_FROST_BRAWL	การ์ดหมด! ใครก็ตามที่มีพลังชีวิตมากกว่าเมื่อจบเทิร์นหน้าจะเป็นผู้ชนะ	
POPUP_FROST_BRAWL_ARMOR	เกมท้าประลองนี้ห้ามหลบหลังเกราะ!	
TheMothergloop_LOOTA_BOSS_24h_EmoteResponse	<เรอ>	
TrappedRoom_LOOTA_BOSS_48h_EmoteResponse	<ฉุนเฉียว>	
VO_Ahune_Male_Elemental_Brawl_01	นั่นแหละ! บดขยี้แร็กนารอส!	
VO_Ahune_Male_Elemental_Brawl_02	ตอนนี้ข้าเหนือกว่าแล้ว เจ้าโง่จอมหัวร้อน! 	
VO_Ahune_Male_Elemental_Brawl_03	นี่คือการแก้แค้นของข้า	
VO_Ahune_Male_Elemental_Brawl_04	เอาตำแหน่ง ‘ผู้ที่มีโอกาสถูกนักผจญภัยฆ่ามากที่สุดในอาเซรอธ’ ไปเลย!	
VO_Ahune_Male_Elemental_Brawl_05	เจ้าว่าใคร\nเป็นมดปลวกนะ!?	
VO_Ahune_Male_Elemental_Brawl_07	ศิลาน้ำแข็งละลายแล้ว!	
VO_Ahune_Male_Elemental_Brawl_08	ใครจะกำจัดพวกโง่ได้เยอะสุด!?	
VO_Ahune_Male_Elemental_Brawl_11	ทำคะแนนได้ดีมาก!	
VO_Ahune_Male_Elemental_Brawl_15	เจ้าต้องทำลายแร็กนารอสให้เละกว่านี้!	
VO_Ahune_Male_Elemental_Brawl_16	โฮ่\nเจ้าคงเกลียด\nแร็กนารอสมากสินะ!	
VO_Aran_Male_Shade_AranCrackle_01	เฮอะ สมัยที่ข้ายังหนุ่มๆ น่ะ ใบนี้สร้างความเสียหาย 6 แต้มทุกครั้ง	
VO_Aran_Male_Shade_AranDeath_02	อีกแล้วเหรอ…	
VO_Aran_Male_Shade_AranEmoteResponse_01	ออกไป! ออกไป!	
VO_Aran_Male_Shade_AranHeroPower_01	พวกอันธพาลต้องโดนไฟเผา!	
VO_Aran_Male_Shade_AranMedivhSkin_01	เมดิฟห์? เปล่า เปล่า…ข้าไม่ได้รบกวน\nพวกแขกเลย	
VO_Aran_Male_Shade_AranOpen_01	ข้าจะสอนให้เจ้ารู้จัก\nความเคารพซะบ้าง!	
VO_Aran_Male_Shade_AranSpell_03	จงกลับสู่ความมืด\nอันหนาวเหน็บซะ!	
VO_Aran_Male_Shade_AranSpell_04	นายท่านคือผู้ยิ่งใหญ่ แต่ข้าก็ทรงพลังเหมือนกัน!	
VO_Aran_Male_Shade_AranTrons_02	ไม่! ไม่! ไม่เอาเสียงนั่น! เสียง 'หวัดดี' ที่ชั่วร้ายนั่น!	
VO_Aran_Male_Shade_AranTurn1_01	ห้ามส่งเสียงดัง\nในหอคอยของข้า!	
VO_Aran_Male_Shade_AranTurn5_01	ข้าไม่ใช่ตัวตลก! ข้าคือนีลัส อาราน!	
VO_Barnes_Male_Human_FinalNazraTurn5_02	ช่วยด้วย! เราไม่มีกล้วยแล้ว! มุคล่าอาละวาดจนห้องอาหารพังหมดแล้ว!	
VO_Barnes_Male_Human_JulianneTurn5_01	จะเรียกว่าปาร์ตี้ได้ยังไง[b]ถ้าไม่มีการแสดง? และจะเรียกว่า[b]เป็นการแสดงได้ยังไงถ้าไม่มีผู้ชม?	
VO_Barnes_Male_Human_JulianneWin_01	องก์แรกจบลงแล้ว! ยังเหลืออีกสององก์!	
VO_Barnes_Male_Human_Wing2Intro_02	ยินดีต้อนรับสู่โรงละคร! ข้าคือบาร์นส์ ผู้กำกับเวที  ประตูที่จะไปช่วยเมดิฟห์อยู่ข้างบน แต่ก่อนหน้านั้น เจ้าต้องชมการแสดงของเราให้ได้นะ!	
VO_Barnes_Male_Human_WolfBigMinion_01	คุณยายจ๋า ทำไมมินเนี่ยนของยายถึงได้ตัวโตนักล่ะ!	
VO_Barnes_Male_Human_WolfClaws_01	ไม่ต้องห่วง!  กรงเล็บใหญ่ๆ นั่นเป็นแค่พร็อพเท่านั้น!	
VO_Barnes_Male_Human_WolfTurn5_01	ข้าล่ะชอบให้ผู้ชมมีส่วนร่วมจริงๆ!  วิ่งเร็ว แขกตัวน้อย วิ่ง!	
VO_Barnes_Male_Human_WolfTurn9_01	ฮ่าฮ่า! โชว์อลังการมาก! ดีกว่าออเกอร์ที่เราไล่จับ[b]เมื่อสัปดาห์ที่แล้วอีก!	
VO_Barnes_Male_Human_WolfWin_01	อะฮ้า! ฉากสุดท้ายรอเราอยู่!	
VO_BigBadWolf_Male_Worgen_WolfBigMinion_01	จะได้บดขยี้เจ้าได้ถนัดๆ ไงล่ะ!	
VO_BigBadWolf_Male_Worgen_WolfDeath_01	ถูกล่าเหรอ? ไม่…	
VO_BigBadWolf_Male_Worgen_WolfDireWolfAlpha_01	*คำราม*	
VO_BigBadWolf_Male_Worgen_WolfDireWolfAlpha_02	*ร้องคราง*	
VO_BigBadWolf_Male_Worgen_WolfEmoteResponse_01	อืมมม...\nอร่อย…	
VO_BigBadWolf_Male_Worgen_WolfOpen_01	วิ่งสิ หนูน้อย วิ่ง!	
VO_BigBadWolf_Male_Worgen_WolfScarletCrusader_01	โอ สาวน้อยชุดแดง จะไปไหนเหรอจ๊ะ!	
VO_BigBadWolf_Male_Worgen_WolfTurn1_01	ดูมินเนี่ยนของเจ้าสิ เห็นมั้ยว่ามันตัวหดเหลือนิดเดียว[b]เมื่ออยู่ต่อหน้าข้า?	
VO_BlackKing_Male_ChessPiece_ChessEmoteGreetings_01	พร้อมเสมอ	
VO_BlackKing_Male_ChessPiece_ChessEmoteOops_01	หรือเป็นกับดักกันแน่?	
VO_BlackKing_Male_ChessPiece_ChessEmoteSorry_01	ต้องยอมเสียสละกันบ้าง	
VO_BlackKing_Male_ChessPiece_ChessEmoteThanks	ด้วยความยินดี	
VO_BlackKing_Male_ChessPiece_ChessEmoteThanks_01	ด้วยความยินดี	
VO_BlackKing_Male_ChessPiece_ChessEmoteThreaten_01	ข้าทำได้ใน 3 ตา	
VO_BlackKing_Male_ChessPiece_ChessEmoteWellPlayed_01	ยังหรอก	
VO_BlackKing_Male_ChessPiece_ChessEmoteWow_01	แน่นอนอยู่แล้ว	
VO_BlackKing_Male_ChessPiece_ChessOpen_01	ข้าไม่ให้เจ้าผ่าน!	
VO_BOSS_AYA_Female_Pandaren_BC_0_Jade_Golem_02	มีโกเล็มอีกเหรอ? สุดยอด!	
VO_BOSS_AYA_Female_Pandaren_BC_0_Jade_Golem_03	ฮี่ฮี่!  ลุยเลยกองทัพของข้า!	
VO_BOSS_AYA_Female_Pandaren_BC_0_Jade_Golem_04	เอาอีก! เอาอีก!	
VO_BOSS_AYA_Female_Pandaren_BC_2_1st_Turn_Start_01	ตัดสินใจแล้ว! แกดเจ็ตแซน\nต้องเป็นของข้า!	
VO_BOSS_AYA_Female_Pandaren_BC_2_2nd_Turn_Start_01	แกดเจ็ตแซน\nเป็นของเจดโลตัส ส่วนเจดโลตัส\nก็เป็นของข้า!	
VO_BOSS_AYA_Female_Pandaren_BC_2_Arms_Dealing1_01	แจกอาวุธเนี่ยนะ  ซ้ำซากเป็นบ้า	
VO_BOSS_AYA_Female_Pandaren_BC_2_Fill1_01	อู้ว เจ้าจะต้องชอบ\nไอ้นี่แน่!	
VO_BOSS_AYA_Female_Pandaren_BC_2_Fill2_01	ไม่เอา ข้าชอบที่นี่! ข้าจะอยู่นี่แหละ!	
VO_BOSS_AYA_Female_Pandaren_BC_2_Goons_Win_01	ไม่ไม่ไม่ไม่ไม่! ท่าไม่ดีแล้ว!	
VO_BOSS_AYA_Female_Pandaren_BC_2_Goons_Winning_02	เจ้าก็น่าจะหุบปากซะ!	
VO_BOSS_AYA_Female_Pandaren_BC_2_Jade_Win_01	เจดโลตัสชนะอีกแล้ว! ข้านี่แหละ\nเจ๋งสุด!	
VO_BOSS_AYA_Female_Pandaren_BC_2_Lotus_Winning_01	*ฮี่ฮี่* เล่นอีก เล่นอีก!	
VO_BOSS_AYA_Female_Pandaren_BC_3_1st_Turn_Start_01	แกดเจ็ตแซนสุดยอด! ข้าจะเอา!	
VO_BOSS_AYA_Female_Pandaren_BC_3_1st_Turn_Start_02	ฮี่ฮี่ฮี่ เดี๋ยวจัดให้...	
VO_BOSS_AYA_Female_Pandaren_BC_3_2nd_Turn_Start_01	โอ้ย พวกคาบาลอย่างเจ้า นี้มันน่าเบื่อ!	
VO_BOSS_AYA_Female_Pandaren_BC_3_Fill1_01	วันนี้อากาศดีนะ หืม แคสซี่?	
VO_BOSS_AYA_Female_Pandaren_BC_3_Fill2_01	ให้ตายเหอะแคสซี่ อย่าเครียดนักสิ เฮฮาหน่อยเร็ว	
VO_BOSS_AYA_Female_Pandaren_BC_3_Jade_Golem3_01	ฮี่ฮี่ฮี่ฮี่!	
VO_BOSS_AYA_Female_Pandaren_BC_3_Kabal_Winning_01	ก็เพราะเจ้ามันน่าเบื่อไงล่ะ	
VO_BOSS_AYA_Female_Pandaren_BC_3_Kabal_Wins_01	ไม่จริง! ไม่ ไม่ ไม่ ไม่ ไม่!	
VO_BOSS_AYA_Female_Pandaren_BC_3_Lotus_Winning_01	อ้าว เป็นอะไรไปล่ะแคสซี่ สภาพดูไม่ได้เลยนะ!	
VO_BOSS_AYA_Female_Pandaren_BC_3_Lotus_Wins_01	วู้ว สนุกจัง ขอบใจที่\nมาเล่นกับข้านะ[b]แคสซี่!	
VO_BOSS_AYA_Female_Pandaren_BC_3_Potion1_02	บลา บลา น้ำยา บลา บลา บลา มาสู้กับข้าซะทีเซ่!	
VO_BOSS_AYA_Female_Pandaren_BC_3_Potion3_01	แหวะ! ไอ้นี่น่าหยะแหยงสุดๆ!	
VO_BOSS_AYA_Female_Pandaren_Concede_01	อ๋อย เจ้านี่น่าเบื่อจัง	
VO_BOSS_AYA_Female_Pandaren_Greetings_01	ไฮย่า!	
VO_BOSS_AYA_Female_Pandaren_Oops_01	อุ๊ยตาย!	
VO_BOSS_AYA_Female_Pandaren_START_01	เตรียมโกเล็ม!	
VO_BOSS_AYA_Female_Pandaren_Thanks_02	ขอบใจ!	
VO_BOSS_AYA_Female_Pandaren_Threaten_02	คงต้องให้เจ้าตายซะแล้ว	
VO_BOSS_AYA_Female_Pandaren_Well_Played_01	เจ๋งเป้ง!	
VO_BOSS_AYA_Female_Pandaren_Wow_02	โว้ว!	
VO_BOSS_CHO_Male_Ogre_BC_1_1st_Turn_Start_01	อันตรายเพราะมี\nไกรมี่กูนส์!	
VO_BOSS_CHO_Male_Ogre_BC_1_Fill2_01	เล่นมันเลย!	
VO_BOSS_CHO_Male_Ogre_BC_2_Fill1_01	นังหนูโกรธแล้ว!	
VO_BOSS_CHO_Male_Ogre_Concede_01	ใช่! เดี๋ยว! เจ้านั่นแหละ!	
VO_BOSS_CHO_Male_Ogre_Oops_02	พลาดแล้ว!	
VO_BOSS_CHO_Male_Ogre_Thanks_01	ขอบใจ	
VO_BOSS_HAN_Male_Ogre_BC_0_Arms_Dealing_01	เจ๋งใช่มั้ยล่ะ ใครก็ไม่รู้ลืมทิ้งไว้น่ะ เฮะเฮะ….	
VO_BOSS_HAN_Male_Ogre_BC_0_Arms_Dealing_02	กูนส์ระดมพล!	
VO_BOSS_HAN_Male_Ogre_BC_0_Arms_Dealing_03	แจกอาวุธ\nให้กูนส์คนนั้น แล้วส่งไปลุยเลย!	
VO_BOSS_HAN_Male_Ogre_BC_0_Arms_Dealing_04	ไกรมี่กูนส์\nสู้ด้วยกัน!	
VO_BOSS_HAN_Male_Ogre_BC_1_1st_Turn_Start_01	รู้มั้ยว่าแถวนี้อันตรายนะ คาซากัส	
VO_BOSS_HAN_Male_Ogre_BC_1_2nd_Turn_Start_01	แกดเจ็ตแซนเป็นของชาวกูนส์!	
VO_BOSS_HAN_Male_Ogre_BC_1_2nd_Turn_Start_02	อยากพูดอะไรก็พูดไป แต่แกดเจ็ตแซน เป็นของชาวกูนส์	
VO_BOSS_HAN_Male_Ogre_BC_1_Fill1_01	เอาน้ำยาของแกไปไกลๆ เลย	
VO_BOSS_HAN_Male_Ogre_BC_1_Fill2_01	เฮ้ โช เรียกพวกกูนส์มา เจ้าโทรลล์นี่ ต้องโดนสั่งสอนซะแล้ว	test
VO_BOSS_HAN_Male_Ogre_BC_1_Goons_Win_01	โทษที คาซากัส มันเป็นธุรกิจน่ะ	
VO_BOSS_HAN_Male_Ogre_BC_1_Goons_Winning_01	โอย สภาพดูไม่ได้เลยนะ คาซากัส!	
VO_BOSS_HAN_Male_Ogre_BC_1_Kabal_Win_02	ไม่จบแค่… นี้… หรอก… คาซากัส...	
VO_BOSS_HAN_Male_Ogre_BC_1_Kabal_Winning_02	เฮะ เก่งนี่หว่า ตาแก่	
VO_BOSS_HAN_Male_Ogre_BC_1_Potion1_01	รู้มั้ย ข้าไม่เคยชอบไอ้น้ำยานั่นเลย	
VO_BOSS_HAN_Male_Ogre_BC_1_Potion2_01	โอ้! จะขว้างอะไร\nก็ดูตาม้าตาเรือบ้างสิ!	
VO_BOSS_HAN_Male_Ogre_BC_2_1st_Turn_Start_01	แกดเจ็ตแซน\nเป็นของเรา ไสหัวไปซะ\nยัยเปี๊ยก!	
VO_BOSS_HAN_Male_Ogre_BC_2_1st_Turn_Start_04	เหรอ? ถ้าอย่างงั้น ก็ต้องถามไกรมี่กูนส์ อย่างเราซะก่อน…	
VO_BOSS_HAN_Male_Ogre_BC_2_Fill1_01	อย่ามองเราแบบนั้น อาย่า...	
VO_BOSS_HAN_Male_Ogre_BC_2_Goons_Win_01	นอนพักก่อนนะ อาย่า  เฮะเฮะ จะได้โตเร็วๆ	
VO_BOSS_HAN_Male_Ogre_BC_2_Goons_Winning_01	เจ้าน่าจะประเมินสถานการณ์ใหม่นะ	
VO_BOSS_HAN_Male_Ogre_BC_2_Jade_Golem2_01	ข้าเบื่อเจ้าพวกเจดนี่เต็มแก่แล้ว	
VO_BOSS_HAN_Male_Ogre_BC_2_Lotus_Win_01	*อ๊าก* แกดเจ็ตแซน\nต้องเป็นของเรา….	
VO_BOSS_HAN_Male_Ogre_BC_2_Lotus_Winning_01	ใครก็ได้ช่วยไล่นังเด็กนี่ไปที	
VO_BOSS_HAN_Male_Ogre_Concede_01	ความผิดเจ้าทั้งนั้น รู้ตัวมั้ย	
VO_BOSS_HAN_Male_Ogre_Greetings_01	ยินดีต้อนรับสู่แกดเจ็ตแซน ไอ้น้อง	
VO_BOSS_HAN_Male_Ogre_INTRO_PACK_OPEN_7	เฮ้ เฮ้ เฮ้… พ่อรูปหล่อคนนั้นใครน่ะ	
VO_BOSS_HAN_Male_Ogre_Oops_01	ท่าไม่ดีแล้ว	
VO_BOSS_HAN_Male_Ogre_START_01	กล้าบุกถิ่นของเรางั้นเหรอ!	
VO_BOSS_HAN_Male_Ogre_Thanks_01	ทำงานได้ดีมาก	test
VO_BOSS_HAN_Male_Ogre_Threaten_01	ใครก็ปฏิเสธไม่ได้	
VO_BOSS_HAN_Male_Ogre_Well_Played_02	ขอบอกว่าข้าประทับใจมาก	
VO_BOSS_HAN_Male_Ogre_WOW_01	ไม่เลว!	
VO_BOSS_KAZAKUS_Male_Troll_BC_0_Potion_01	อ้า ชื่นใจเหลือเกิน...	
VO_BOSS_KAZAKUS_Male_Troll_BC_0_Potion_02	รับไปซะ!	
VO_BOSS_KAZAKUS_Male_Troll_BC_0_Potion_04	ดื่มซะให้พอ	
VO_BOSS_KAZAKUS_Male_Troll_BC_0_Potion_05	รสชาติเป็นไงบ้างล่ะ	
VO_BOSS_KAZAKUS_Male_Troll_BC_1_1st_Turn_Start_01	แกดเจ็ตแซน\nต้องตกเป็นของข้า ฮาน'โช!	
VO_BOSS_KAZAKUS_Male_Troll_BC_1_2nd_Turn_Start_01	คาบาลมีอยู่ทุกที่! แกดเจ็ตแซนก้มหัวให้เรา!	
VO_BOSS_KAZAKUS_Male_Troll_BC_1_Arms_Dealing1_01	ฮึ่ม ขี้ขลาดสมกับเป็นพวกกูนส์ เลิกซ่อนตัวอยู่ในมือได้แล้ว!	
VO_BOSS_KAZAKUS_Male_Troll_BC_1_Fill1_01	คาบาลของข้า ครอบครอง\nพลังไร้ขีดจำกัด	
VO_BOSS_KAZAKUS_Male_Troll_BC_1_Goons_Win_01	ข้าจะกลับมา... อย่างทรงพลังกว่าที่เคย!	
VO_BOSS_KAZAKUS_Male_Troll_BC_1_Goons_Winning_01	ชะตาเจ้าใกล้ขาดแล้ว ฮาน'โช	
VO_BOSS_KAZAKUS_Male_Troll_BC_1_Kabal_Win_01	แน่นอน	
VO_BOSS_KAZAKUS_Male_Troll_BC_1_Kabal_Winning_01	ชะตาเจ้าใกล้ขาดแล้ว ฮาน’โช	
VO_BOSS_KAZAKUS_Male_Troll_BC_3_1st_Turn_Start_01	เฮะเฮะเฮะ เจ้าต้อง\nข้ามศพข้าไปก่อน...	
VO_BOSS_KAZAKUS_Male_Troll_BC_3_Fill1_01	อย่าเรียกข้าแบบนั้น! นังเด็กสามหาว!	
VO_BOSS_KAZAKUS_Male_Troll_BC_3_Fill2_01	จงสยบต่อ\nอำนาจแห่งคาบาล!	
VO_BOSS_KAZAKUS_Male_Troll_BC_3_Jade_Golem2_01	นังเด็กโอหัง!\nเจ้ากล้าดูหมิ่นผู้นำ\nที่ยิ่งใหญ่ที่สุด\nแห่งแกดเจ็ตแซนงั้นรึ	
VO_BOSS_KAZAKUS_Male_Troll_BC_3_Jade_Golem3_01	นังเด็กสามหาว! ข้าเบื่อโกเล็มไร้สาระของเจ้าเต็มทนแล้ว	
VO_BOSS_KAZAKUS_Male_Troll_BC_3_Kabal_Winning_01	เฮะเฮะ เจ้าดูเหนื่อยๆ นะ นังหนู	
VO_BOSS_KAZAKUS_Male_Troll_BC_3_Kabal_Winning_02	ว่าไงนะ!? เจ้าเด็กสามหาว! เตรียมตัวพบจุดจบได้เลย!	test
VO_BOSS_KAZAKUS_Male_Troll_BC_3_Kabal_Wins_01	ฮ่าฮ่า!  ไม่ว่าหน้าไหนก็พ่ายแพ้ ให้อำนาจแห่งคาบาล!	
VO_BOSS_KAZAKUS_Male_Troll_BC_3_Lotus_Winning_01	นังเด็กทะลึ่ง!	
VO_BOSS_KAZAKUS_Male_Troll_BC_3_Lotus_Wins_01	นังเด็กโง่ มันไม่จบ\nแค่นี้หรอก....	
VO_BOSS_KAZAKUS_Male_Troll_BC_3_Potion1_01	ข้าจะให้เจ้าเห็นอิทธิฤทธิ์ ของน้ำยาแห่งคาบาล!	
VO_BOSS_KAZAKUS_Male_Troll_Concede_01	ถนนทุกสาย… เป็น... ของข้า….	
VO_BOSS_KAZAKUS_Male_Troll_Greetings_02	สวัสดี เจ้าพวกโง่	test
VO_BOSS_KAZAKUS_Male_Troll_Mirror_Start_01	เจ้ามีฝีมือทีเดียว	
VO_BOSS_KAZAKUS_Male_Troll_Oops_01	คำนวณพลาด	
VO_BOSS_KAZAKUS_Male_Troll_START_01	มานาเรียกข้า	
VO_BOSS_KAZAKUS_Male_Troll_Thanks_01	ขอบใจมาก เจ้าไพร่	
VO_BOSS_KAZAKUS_Male_Troll_Threaten_01	ข้าปกครองแกดเจ็ตแซน!	
VO_BOSS_KAZAKUS_Male_Troll_Well_Played_02	ศักยภาพช่างล้นเหลือ	
VO_BOSS_KAZAKUS_Male_Troll_Wow_01	ทรงพลังเหลือเกิน!	
VO_BRANN_MITHRIL_ALT_02	น่าสนใจมาก รูนมิธริลพวกนี้มีรหัสผู้พิทักษ์อยู่ มันต้องมีมาตั้งแต่ยุคไททันแน่ๆ!	
VO_BRANN_WIN_07_ALT_07	หนีพ้นแล้ว! ส่วนหัวอยู่ในห้องถัดไปนี่แหละ!	
VO_BRM_027h_Death_63	ไม่! ไม่! ม่ายยยยยยยยยยยย!!!!	
VO_BRMA01_1_CARD_05	โอ้ เอาล่ะ [b]เรามาต้อนรับพวกมัน[b]อย่างอบอุ่นกันเถอะ!	
VO_BRMA01_1_DEATH_09	โว้ว! เกิดอะ...? ข้าไม่ชอบแบบนี้เลย แต่มันก็เกิดขึ้นแล้ว!	
VO_BRMA01_1_ETC_06	ได้เวลาแสดงโชว์แบบสดๆ กันแล้ว! โปรดต้อนรับ อีลีต ทอเรน ชีฟเทน!	
VO_BRMA01_1_HERO_POWER_04	ฮ่าฮ่าฮ่าฮ่า! ตะลุมบอน!	
VO_BRMA01_1_RESPONSE_03	ฮ่าฮ่าฮ่าฮ่า! ช่าย.. *อึ๊ก* โอ้ โทษที	
VO_BRMA01_1_START_01	ยินดีต้อนรับสู่\nกริม กัซเลอร์	
VO_BRMA01_1_SUCCUBUS_08	นายหญิงนักมาร่า ดูเหมือน "สหาย" ของเราอยากจะ "ดื่ม" กับท่านน่ะ	
VO_BRMA01_1_TURN1_02	ทุกคน! ฮ่าฮ่า ดูสิดู เรามี "แขก" มาเยือนด้วย	
VO_BRMA01_1_WARGOLEM_07	โอโฮโฮ่! เจ้ามีปัญหาแล้วล่ะ เฟแลงซ์! จัดการมัน!	
VO_BRMA02_1_ALAKIR_34	เขาคือเจ้าแห่งธาตุผู้ชื่นชอบการบดขยี้แมลง: อัลอาเคียร์!	
VO_BRMA02_1_ALEXSTRAZA_32	ผู้ปกป้องชีวิต! ราชินีแห่งมังกร! นักสู้แห่งลานประลองดาร์คไอรอน! เธอคือ อเล็กสตราสซา!	
VO_BRMA02_1_BEAST_22	อาหารโปรดของเขาคือโนม แต่ถ้ามีอย่างอื่นเขาก็เต็มใจที่จะกินเช่นกัน เขาคือ บีสต์!	
VO_BRMA02_1_BOOM_28	ข้าหวังว่าจะไม่มีใครนั่งอยู่แถวหน้านะ เพราะผู้ท้าชิงคนต่อไปของเราคือ ด็อกเตอร์บูม!	
VO_BRMA02_1_CAIRNE_20	เขากำลังเลี้ยงดูลูกชายเพื่อให้[b]เจริญรอยตามเขา ขอเสียงให้กับ เคร์น บลัดฮูฟ!	
VO_BRMA02_1_CHO_07	เตรียมตัวฟังนิทานก่อนนอน\nจากแพนดาเร็นที่น่ากอดที่สุด:\nลอร์วอล์คเกอร์ โช!	
VO_BRMA02_1_DEATH_38	ฮึก! หือ? โว้ว! *เสียงหอบ*	
VO_BRMA02_1_DEATHWING_35	โอ้วววว! ท่านสุภาพสตรีและสุภาพบุรุษ! ขอเชิญพบกับเขาคนนี้ เดธวิง!	
VO_BRMA02_1_ETC_18	และขอเชิญพบกับทอเรนผู้ลึกลับ[b]และเป็นตำนาน: อีลีต ทอเรน ชีฟเทน!	
VO_BRMA02_1_FEUGEN_15	ขอเสียงให้ฟิวเก้นหน่อย!	
VO_BRMA02_1_FOEREAPER_29	เขาได้รับการปรับแต่งกลไก[b]เพื่อความสามารถในการทำลายล้างสูงสุด[b]หุ่นเกี่ยวหัว 4000!	
VO_BRMA02_1_GEDDON_13	โอ้โห ลานประลองของเราร้อนระอุขึ้นเรื่อยๆ แล้ว โปรดต้อนรับ บารอนเก็ดดอน!	
VO_BRMA02_1_GELBIN_21	ส่งตรงมาจากนิว ทิงเกอร์ทาวน์ โปรดต้อนรับผู้นำของเหล่าโนม เกลบิน เมคคาทอร์ค!	
VO_BRMA02_1_GRUUL_31	ฉายานักฆ่ามังกรของเขา ไม่ได้เรียกกันเล่นๆ! ขอเสียงปรบมือให้กับ กรูล!	
VO_BRMA02_1_HERO_POWER_05	ผู้ชมเริ่มตื่นเต้นกันแล้ว! ฮ่าฮ่าฮ่า!	
VO_BRMA02_1_HOGGER_27	โปรดต้อนรับโนลเลเวล 11 ผู้เป็นตำนาน ฮ็อกเกอร์!	
VO_BRMA02_1_ILLIDAN_23	เมื่อมีดาบศึกคู่อยู่ในมือ การมองเห็นก็ไม่จำเป็นอีกต่อไป เชิญพบกับ อิลลิดัน สตอร์มเรจ!	
VO_BRMA02_1_LEVIATHAN_12	เพิ่งยกเครื่องใหม่เสร็จหยกๆ และพร้อมจะอาละวาดแล้ว นี่คือ ลิเวียธานไฟลุก!	
VO_BRMA02_1_LOATHEB_16	อุดจมูก ปิดปาก[b]และพร้อมใจกันเชียร์ให้กับ[b]สุดยอดแห่งความเน่าเหม็น[b]โลเธ็บ!	
VO_BRMA02_1_MAEXXNA_24	เธอคือแมงมุมยักษ์! และชื่อของเธอออกเสียงยากมาก เมเอ็กซ์น่า!	
VO_BRMA02_1_MILLHOUSE_09	เฮ้ย ไม่เอาน่า ใครปล่อยไอ้หมอนี่เข้ามาในลานประลองน่ะ	
VO_BRMA02_1_MOGOR_25	แม้เขาจะรู้ศัพท์แค่ไม่กี่คำ แต่ความดุร้ายของเขาไม่มีที่สิ้นสุด เขาคือ ออเกอร์ยักษ์ โมกอร์!	
VO_BRMA02_1_MUKLA_10	ต่อไปขอเชิญพบกับ เจ้าแห่งกล้วย: คิงมุคล่า!	
VO_BRMA02_1_NOZDORMU_36	ท่านสุภาพสตรีและ... โอ๊ะ! หมดเวลาแล้ว!	
VO_BRMA02_1_ONYXIA_33	ส่งตรงจากหนองน้ำดัสต์วอลโลว์[b]และปราสาทสตอร์มวินด์ เตรียมต้อนรับ โอนิกเซีย!	
VO_BRMA02_1_PAGLE_08	เพิ่งกลับมาจากทริปตกปลาสดๆ ร้อนๆ นักตกปลามือหนึ่ง แนท เพเกิ้ล!	
VO_BRMA02_1_RESPONSE_04	ต่อหน้าตำนานเหล่านี้ ไม่มีใครรอดชีวิตไปได้	
VO_BRMA02_1_SNEED_30	ผู้ท้าชิงคนต่อไปของเราซ่อนตัวอยู่หลัง[b]แผงควบคุมเชรดเดอร์เก่า! เขาเป็นใครกันนะ?	
VO_BRMA02_1_STALAGG_14	สตาแล็กก์จะรอดจากลานประลองไปได้มั้ย มาลุ้นไปด้วยกัน!	
VO_BRMA02_1_START_01	ผู้ท้าชิงคนใหม่!	
VO_BRMA02_1_SYLVANAS_19	ใจของเธอลุกโชนไปด้วย[b]ความเกลียดชังชั่วนิรันดร์ โปรดให้การต้อนรับ[b]ซิลวานัส วินด์รันเนอร์!	
VO_BRMA02_1_THALNOS_06	ขอเสียงปรบมือต้อนรับ[b]โครงกระดูกในชุดเดรส จอมเวทโลหิต ธาลนอส!	
VO_BRMA02_1_THAURISSAN_37	เขาอุตส่าห์เดินทางมาจาก ภารกิจถัดไปเพื่อมาพบกับทุกท่าน ขอต้อนรับ จักรพรรดิธอริสซัน!	
VO_BRMA02_1_TINKMASTER_11	ขอเสียงปรบมือต้อนรับนักประดิษฐ์อัจฉริยะ สุดยอดนักประดิษฐ์ โอเวอร์สปาร์ค!	
VO_BRMA02_1_TOSHLEY_26	เขาคือโนมที่ต้องจากบ้านมาไกล โปรดให้การต้อนรับอย่างอบอุ่นแก่ ทอชลีย์!	
VO_BRMA02_1_TURN1_02	ท่านสุภาพสตรี[b]และสุภาพบุรุษ![b]วันนี้เรามีโชว์พิเศษ!	
VO_BRMA02_1_TURN1_PT2_03	สุดยอดตำนานแห่งอาเซรอธ ปะทะกับนักผจญภัยตัวคนเดียว!	
VO_BRMA02_1_VOLJIN_17	โปรดเงียบก่อน! เรามีแขกพิเศษมาด้วย หัวหน้าเผ่า โวลจิน!	
VO_BRMA03_1_CARD_04	ด้วยอำนาจแห่งแร็กนารอส! ข้าคือผู้ครอบครองพลัง!	
VO_BRMA03_1_DEATH_09	อ๊าาาาาาาา!	
VO_BRMA03_1_HERO_POWER_06	ตาย!	
VO_BRMA03_1_MOIRA_DEATH_05	ไม่นะ! มอยร่า! เจ้าจะต้องชดใช้!	
VO_BRMA03_1_RESPONSE_03	หุบปากไม่งั้นข้า[b]จะทำให้เจ้า[b]เงียบเอง!	
VO_BRMA03_1_START_01	คนแคระดาร์คไอรอน จะไม่มีวันพ่ายแพ้!	
VO_BRMA03_1_TURN1_02	นี่! อย่ามายุ่งกับเมียข้านะ!	
VO_BRMA03_1_VS_RAG_07	ไม่! แร็กนารอส! ไม่เอาแล้ว!	
VO_BRMA04_1_CARD_04	ผู้ปฏิญาณเพลิง! เดินหน้า	
VO_BRMA04_1_DEATH_06	รรรรรรรรรรร่า!	
VO_BRMA04_1_HERO_POWER_05	แม็กม่า!	
VO_BRMA04_1_RESPONSE_03	ข้านี่แหละหินที่สุด	
VO_BRMA04_1_START_01	เจ้าเจองานหินแล้ว	
VO_BRMA04_1_TURN1_02	ลุยล่ะนะ	
VO_BRMA05_1_CARD_05	ติ๊ก ต่อก ติ๊ก ต่อก	
VO_BRMA05_1_DEATH_04	นี่คือครั้งสุดท้าย...	
VO_BRMA05_1_HERO_POWER_06	จงมอดไหม้!	
VO_BRMA05_1_RESPONSE_03	โลกาวินาศ!	
VO_BRMA05_1_START_01	เจ้าจะต้องไหม้ไม่เหลือซาก!	
VO_BRMA05_1_TURN1_02	แร็กนารอสจะกลืนกินเจ้า!	
VO_BRMA06_1_DEATH_04	ข้ายอมแล้ว! ข้ายอมแล้ว!	
VO_BRMA06_1_RESPONSE_03	เจ้าคิดว่าเจ้าชนะแล้วสินะ? ข้าจะสอนบทเรียน ความเจ็บปวดให้เจ้าเอง!	
VO_BRMA06_1_START_01	อย่าบังอาจต่อกร กับเปลวเพลิงมีชีวิต!	
VO_BRMA06_1_SUMMON_RAG_05	ขออัญเชิญแร็กนารอส! ผู้ดำรงอยู่มาเนิ่นนาน แม้ในยามที่โลกเพิ่งถือกำเนิด!	
VO_BRMA06_1_TURN1_02_ALT	ไล่ล่าพวกมัน!	
VO_BRMA06_3_INTRO_01	เร็วเกินไป! เจ้าปลุกข้าเร็วเกินไป เอ็กเซคิวตัส!	
VO_BRMA06_3_RESPONSE_03	การบุกรุกครั้งนี้ หมายความว่าอะไร!	
VO_BRMA06_3_TURN1_02	เจ้าพวกมดปลวก! บังอาจรุกล้ำ\nเข้ามาในอาณาเขตของข้างั้นรึ	
VO_BRMA07_1_CARD_04	ทุบแหลกเละ!	
VO_BRMA07_1_DEATH_06	ม่ายยยยยย!	
VO_BRMA07_1_HERO_POWER_05	ข้าทุบ! เจ้าตาย!	
VO_BRMA07_1_RESPONSE_03	แฮร่! ข้าทุบ!	
VO_BRMA07_1_START_01	ข้าบดขยี้เจ้า	
VO_BRMA07_1_TURN1_02	ฮื่ม ทุบหรือทำลาย? ยากจัง!	
VO_BRMA08_1_CARD_05	ข้าจะปกป้องยอดเขาเอง	
VO_BRMA08_1_DEATH_06	อึ่ก อ้า! ม่ายยยยย!	
VO_BRMA08_1_RESPONSE_04	ทำไม?! บอกข้าทีว่าทำไม! ได้โปรดเถอะ ข้าชอบเจ้านะ	
VO_BRMA08_1_START_01	เจ้ามาทำอะไรที่นี่น่ะ	
VO_BRMA08_1_TURN1_03	ลอร์ดเนฟาเรียส! ข้านึกว่า\nนี่คือคนที่จัดการแร็กนารอสให้เราซะอีก	
VO_BRMA08_1_TURN1_ALT_02	เจ้ามาเพื่อช่วยข้า กำจัดพวกมนุษย์ ให้สิ้นซากใช่ไหมล่ะ	
VO_BRMA09_1_CARD_05	ยอดเขาเป็นของเรา!	
VO_BRMA09_1_DEATH_11	ก๊าาาาาาาา!	
VO_BRMA09_1_HERO_POWER1_06	เปิดประตู!	
VO_BRMA09_1_HERO_POWER2_07	ฆ่าตัวที่อยู่ข้างหลังก่อน	
VO_BRMA09_1_HERO_POWER3_08	เล็งไปที่ฮีโร่สิ เจ้าพวกโง่!	
VO_BRMA09_1_HERO_POWER4_09	เมื่อเราอยู่ด้วยกัน ใครก็หยุดไม่อยู่!	
VO_BRMA09_1_RESPONSE_04	ฮ่าฮ่าฮ่าฮ่าฮ่า	
VO_BRMA09_1_START_01	พวกเราคือชนเผ่าที่แท้จริง!	
VO_BRMA09_1_TURN1_03	เจ้าเลือกขึ้นภูเขาผิดลูกแล้ว	
VO_BRMA09_1_TURN1_ALT_02	ไม่มีใครขวางทางเราได้ ตาย!	
VO_BRMA10_1_DEATH_08	รรรรรรรรรร่าห์!	
VO_BRMA10_1_EGG_DEATH_1_05	เจ้าโง่! ไข่พวกนี้มีค่ามากกว่าที่เจ้าคิดนะ!	
VO_BRMA10_1_EGG_DEATH_2_06	ไม่นะ! อีกฟองแล้วเหรอ![b]ข้าจะตัดหัวเจ้าเพื่อ[b]ชดใช้ความโหดร้ายนี้!	
VO_BRMA10_1_EGG_DEATH_3_07	เจ้าจะต้องชดใช้!	
VO_BRMA10_1_HERO_POWER_04	อย่ายุ่งกับไข่พวกนั้นนะ!	
VO_BRMA10_1_RESPONSE_03	ข้าจะป่นเจ้าให้เป็นผง!	
VO_BRMA10_1_START_01	ดูซะสิ ไข่แห่งความชั่วร้าย\nของดราก้อนไฟลท์รุ่นใหม่	
VO_BRMA10_1_TURN1_02	ไข่พวกนี้จะกลายเป็น[b]หายนะของเจ้า	
VO_BRMA11_1_ALEXSTRAZA_07	ช่วยด้วย ผู้ปกป้องชีวิต! ช่วยข้าด้วย!	
VO_BRMA11_1_CARD_04	โทสะแห่งแบล็คร็อค\nไหลเวียนอยู่ในกายข้า!	
VO_BRMA11_1_DEATH_ALT_08	จบสักที ความทรมานจบลงแล้ว	
VO_BRMA11_1_HERO_POWER_05	อ๊ากกก! ทำลาย!	
VO_BRMA11_1_KILL_PLAYER_06	อภัยให้ข้าด้วยสหาย ข้าพลาดไปแล้ว	
VO_BRMA11_1_RESPONSE_03	เจ้าน่าจะหนีไป[b]ในตอนที่ยังทำได้[b]เจ้ามนุษย์	
VO_BRMA11_1_START_01	หนีไป! ก่อนที่ข้าจะควบคุมตัวเองไม่ได้...	
VO_BRMA11_1_TURN1_02	สายไปแล้ว ความชั่วร้าย ของเนฟาเรี่ยนครอบงำข้าแล้ว	
VO_BRMA13_1_DEATH_ALT_23	ไม่! ไม่! ข้าจะกลับมาาาาา!	
VO_BRMA13_1_DEATHWING_19	พ-พ่อ??	
VO_BRMA13_1_HP_DRUID_14	ดรูอิด ธรรมชาติจะต้องอยู่ใต้บัญชาข้า!	
VO_BRMA13_1_HP_GENERIC_18	เวทมนตร์ของเจ้าเป็นของข้า!	
VO_BRMA13_1_HP_HUNTER_12	ผู้ล่าจะกลายเป็นผู้ถูกล่า!	
VO_BRMA13_1_HP_MAGE_11	เมจ เจ้าควรระวังตัวให้ดี[b]ถ้าคิดจะเล่นกับเวทมนตร์	
VO_BRMA13_1_HP_PALADIN_07	พาลาดิน แสงสว่างทอดทิ้งเจ้า[b]แล้วงั้นหรือ?	
VO_BRMA13_1_HP_PRIEST_08	พรีสต์ แสงสว่างอยู่ใต้อาณัติข้าแล้ว!	
VO_BRMA13_1_HP_ROGUE_15	โร้ก เลิกซ่อนตัวแล้วออกมา[b]เผชิญหน้ากับข้า!	
VO_BRMA13_1_HP_SHAMAN_13	ชาแมน พลังแห่งธาตุ\nอยู่ใต้การควบคุมของข้าแล้ว	
VO_BRMA13_1_HP_WARLOCK_10	วอร์ล็อค! เจ้ากำลังล้อเล่นกับ[b]เวทมนตร์ที่อยู่เหนือ[b]ความเข้าใจของเจ้า!	
VO_BRMA13_1_HP_WARRIOR_09	วอริเออร์! ความแข็งแกร่งกลับกลายเป็น[b]จุดอ่อนของเจ้าแล้ว!	
VO_BRMA13_1_RESPONSE_05	ที่นี่ข้าคือราชา!	
VO_BRMA13_1_START_01	ยินดีต้อนรับสู่[b]อาณาเขตของข้า ฮีโร่	
VO_BRMA13_1_TURN1_PT1_02	จงดู! นี่คือพลังที่แท้จริง ของเนฟาเรี่ยน!	
VO_BRMA13_1_TURN1_PT2_03	มานาไร้ที่สิ้นสุด! เกล็ดมังกรคลุมกาย!	
VO_BRMA14_1_CARD_09	กำลังเปลี่ยนเส้นทาง พลังงานส่วนเกิน	
VO_BRMA14_1_DEATH_08	ระบบรักษาความปลอดภัย ถูกทำลาย กำลังปิดตัวเอง	
VO_BRMA14_1_HP1_03	เปิดระบบยูนิตอีเล็คทรอน	
VO_BRMA14_1_HP2_04	เปิดระบบยูนิตท็อกซิทรอน	
VO_BRMA14_1_HP3_05	เปิดระบบยูนิต[b]อาร์คาโนทรอน	
VO_BRMA14_1_HP4_06	เปิดระบบยูนิตแม็กมาทรอน	
VO_BRMA14_1_HP5_07	ยูนิตรักษาความปลอดภัย ออนไลน์	
VO_BRMA14_1_RESPONSE1_10	บี๊ป บู๊ป บี๊ป	
VO_BRMA14_1_RESPONSE2_11	กำลังพยายามเชื่อมต่อ	
VO_BRMA14_1_RESPONSE3_12	การเชื่อมต่อเสร็จสมบูรณ์ กำลังดาวน์โหลดการอัพเดต OS	
VO_BRMA14_1_RESPONSE4_13	ติดตั้งการอัพเดตแล้ว หวัดดี! หวัดดี! หวัดดี!	
VO_BRMA14_1_RESPONSE5_14	หวัดดี! หวัดดี! หวัดดี!	
VO_BRMA14_1_START_01	ตรวจพบผู้บุกรุก	
VO_BRMA14_1_TURN1_02	ระบบรักษา[b]ความปลอดภัยหลัก:[b] เริ่มทำงาน	
VO_BRMA15_1_CARD_05	ความล้มเหลวของข้า คือจุดจบของเจ้า!	
VO_BRMA15_1_DEATH_04	อ๊าาาาาาาาาาา!	
VO_BRMA15_1_HERO_POWER_06	ผสมและคน เติมน้ำร้อน!	
VO_BRMA15_1_RESPONSE_03	ต้องไม่มีอะไรสูญเปล่า!	
VO_BRMA15_1_START_01	ห้ามใครมารบกวนเด็ดขาด	
VO_BRMA15_1_TURN1_02	โอ้! ข้าต้องไม่ปล่อยให้นายท่านคอย ข้าต้องไม่ทำพลาดอีก!	
VO_BRMA16_1_CARD_04	หนีข้าไม่พ้นหรอก	
VO_BRMA16_1_DEATH_06	รรราาาาาาาาาห์!	
VO_BRMA16_1_GONG1_10	อ๊ากก! เสียงนั่น!	
VO_BRMA16_1_GONG2_11	ไม่! อีกนิดเดียว!	
VO_BRMA16_1_GONG3_12	หูข้า!	
VO_BRMA16_1_HERO_POWER_05	เสียงฝีเท้าอันซุ่มซ่าม[b]และกลิ่นสาบอันน่าขยะแขยง[b]คอยบอกข้าว่าเจ้าอยู่ไหน	
VO_BRMA16_1_RESPONSE_03	ดี พูดอีกสิ! ข้าใกล้จะเจอตัวเจ้าแล้ว	
VO_BRMA16_1_START_01	ข้าได้ยินเสียงหัวใจเจ้าเต้น	
VO_BRMA16_1_TRIGGER1_07	อ้า ข้าได้ยินเจ้าแล้ว!	
VO_BRMA16_1_TRIGGER2_08	ข้าได้ยินเสียงฝีเท้า	
VO_BRMA16_1_TRIGGER3_09	ข้าได้ยินเสียงหัวใจเจ้าเต้น หนีไม่พ้นหรอก!	
VO_BRMA16_1_TURN1_02	ความตายรอเจ้า[b]อยู่ในความมืด	
VO_BRMA17_1_CARD_86	สนใจลงไปว่ายน้ำหน่อยมั้ย... ในบ่อลาวาเดือดนะ!	
VO_BRMA17_1_DEATH_97	อ๊ากกกก!	
VO_BRMA17_1_DEATH_HEROIC_98	ม่ายยยยยยยยยยย!	
VO_BRMA17_1_DEATHWING_88	ท่านพ่อ??	
VO_BRMA17_1_HERO_POWER_87	เพลิงเงาของข้า[b]คืนชีพให้เหล่า[b]โครงกระดูกอีกครั้ง!	
VO_BRMA17_1_NEF_AIR1_89	คอยดูข้าพ่นลูกไฟ จากฟากฟ้าให้ดี! ความเสียหายหนึ่งแต้ม มันแค่เริ่มต้นเท่านั้น!	
VO_BRMA17_1_NEF_AIR2_90	ลูกไฟสองลูก! ข้าจะพ่นมันใส่เจ้าจากฟากฟ้า!	
VO_BRMA17_1_NEF_AIR3_91	ครั้งนี้ข้าจะพ่นบอลเพลิงแค่ลูกเดียว เพราะข้าจะเก็บแรงไว้สำหรับชุดใหญ่ในเทิร์นหน้า!	
VO_BRMA17_1_NEF_AIR4_92	โอ้โฮ่! ลูกไฟสามลูก! รับไปเลย! จากฟากฟ้า!	
VO_BRMA17_1_NEF_AIR5_93	จากนี้ไปข้าจะพ่นลูกไฟแค่ 1 ลูกแล้วกัน	
VO_BRMA17_1_NEF_AIR6_94	ล้อเล่นน่า! สี่ลูกต่างหาก! ฮ่าฮ่าฮ่าฮ่า!	
VO_BRMA17_1_NEF_AIR7_95	เทิร์นนี้ข้าจะยังไม่พ่นลูกไฟ... แต่เตรียมตัวไว้เถอะ	
VO_BRMA17_1_NEF_AIR8_96	ลูกไฟยี่สิบลูก! อ๊าฮ่าฮ่าฮ่าฮ่า!	
VO_BRMA17_1_RESPONSE_85	จิตใจของมนุษย์… ช่างควบคุมได้ง่ายเหลือเกิน	
VO_BRMA17_1_RESURRECT1_82	ข้าจะโปรยฝนเพลิง[b]แห่งการทำลายล้าง[b]ใส่เจ้าจากฟากฟ้า!	
VO_BRMA17_1_RESURRECT2_83	ระหว่างที่ข้าอยู่บนนี้ ข้ามีเซอร์ไพรส์ให้เจ้าข้างล่างด้วยนะ!	
VO_BRMA17_1_RESURRECT3_84	จงมองดูสุดยอดผลงาน[b]สร้างสรรค์ของข้า! จงตื่นขึ้น[b]น้องข้า! ตื่นขึ้นมา โอนิกเซีย!	
VO_BRMA17_1_START_78	ในที่สุดเจ้าก็\nมาถึงฉากจบอันยิ่งใหญ่แล้ว!	
VO_BRMA17_1_TRANSFORM1_80	ข้าพยายามที่จะ เป็นเจ้าบ้านที่ดีแล้ว แต่เจ้าไม่ยอมตายเองนะ	
VO_BRMA17_1_TRANSFORM2_81	ถึงเวลาที่ข้าจะต้องเลิกเสแสร้ง แล้วลงมือฆ่าเจ้าซักที!	
VO_BRMA17_1_TURN1_79	สุดยอดผลงาน[b]สร้างสรรค์ของข้า[b]รอเจ้าอยู่ มนุษย์	
VO_COOP02_00	ข้าจะปลดปล่อยเจ้าทั้งคู่จากคำสาปร่างเนื้อเอง!	
VO_COOP02_02	ร่วมมือกันปราบเจ้าแห่งเฟือง เมคาซ็อดเพื่อคว้าชัยชนะ!	
VO_COOP02_ABILITY_05	เร่งความเร็วระบบ!	
VO_COOP02_ABILITY_06	เขาเลิกอ่านหนังสือกันแล้ว ลอร์วอล์คเกอร์ โช!	
VO_COOP03_01	ที่นี่ข้าคือราชา!	
VO_COOP03_02	ไม่... ไม่! ข้าจะทำลายเจ้า!	
VO_COOP03_03	จิตใจของมนุษย์… ช่างควบคุมได้ง่ายเหลือเกิน....	
VO_COOP03_04	ข้าพยายามที่จะเป็นเจ้าบ้านที่ดีแล้ว แต่เจ้าไม่ยอมตายเองนะ!	
VO_COOP03_05	ถึงเวลาที่ข้าจะต้อง[b]เลิกเสแสร้งแล้ว[b]ลงมือฆ่าเจ้าซักที!	
VO_COOP03_06	พรีสต์! แสงสว่างอยู่ใต้อาณัติข้าแล้ว!	
VO_COOP03_07	ชาแมน! พลังแห่งธาตุอยู่ใต้การควบคุมของข้าแล้ว!	
VO_COOP03_08	ฮ่าฮ่าฮ่าฮ่าฮ่า... จงดู! นี่คือพลังที่แท้จริงของเนฟาเรี่ยน!	
VO_COOP03_09	หึหึหึหึหึ... ในที่สุดเจ้าก็มาถึงฉากจบอันยิ่งใหญ่แล้ว!	
VO_Crone_Female_Troll_CroneDeath_02	ไม่! ข้าจะเล่นงานเจ้า! ข้าจะ…	
VO_Crone_Female_Troll_CroneEmoteResponse_02	ฮ่าฮ่าฮ่าฮ่าฮ่า!	
VO_Crone_Female_Troll_CroneFlyingMonkeys_01	เอาตัวเด็กนั่นมาให้ข้า!	
VO_Crone_Female_Troll_CroneHeroPower_02	ฮี่ฮี่ฮี่ฮี่ฮี่!	
VO_Crone_Female_Troll_CroneOpen_01	ฮ่า ฮ่าฮ่าฮ่าฮ่า หนีไปสิ แม่สาวน้อย!!	
VO_Curator_Male_ArcaneGolem_CuratorArcaneGolem_01	น่าสนใจ เราคล้ายกันอย่างไม่น่าเชื่อ	
VO_Curator_Male_ArcaneGolem_CuratorBeasts_01	ภัณฑารักษ์คนนี้แพ้สัตว์	
VO_Curator_Male_ArcaneGolem_CuratorDemons_01	ปีศาจห้ามเข้าห้องจัดแสดง	
VO_Curator_Male_ArcaneGolem_CuratorDragons_01	พอกันทีกับอึมังกร	
VO_Curator_Male_ArcaneGolem_CuratorEmoteResponse_01	ไม่สามารถดำเนินการ[b]ตามที่ขอได้	
VO_Curator_Male_ArcaneGolem_CuratorHarrison_02	ตรวจพบหัวขโมย! แฮริสัน โจนส์ห้ามเข้า	
VO_Curator_Male_ArcaneGolem_CuratorMechs_01	ตั้งโปรแกรมผู้ช่วยใหม่	
VO_Curator_Male_ArcaneGolem_CuratorMedivhSkin_01	สายตาบ้าคลั่งนั่นบอกข้าว่า\nเจ้าเป็นเมดิฟห์ตัวปลอม	
VO_Curator_Male_ArcaneGolem_CuratorMurlocs_01	เจ้าหน้าปลาตัวจิ๋วเข้าฟรี	
VO_Curator_Male_ArcaneGolem_CuratorPirates_01	โจรสลัดควรจะปารรรร์ตี้	
VO_Curator_Male_ArcaneGolem_CuratorReno_02	ตรวจพบหัวขโมย! รีโน่ แจ็คสันห้ามเข้า	
VO_Curator_Male_ArcaneGolem_CuratorTurn1_01	ภัณฑารักษ์คนนี้ติดตั้ง\nระบบจัดการงานแสดง	
VO_Curator_Male_ArcaneGolem_CuratorTurn5_01	โปรดปฏิบัติตามกฎระเบียบ\nของห้องจัดแสดง	
VO_Curator_Male_ArcaneGolem_CuratorTurn9_01	แขกทั้งหมดต้องอยู่ภายใน\nห้องจัดแสดง	
VO_Curator_Male_ArcaneGolem_IllhoofKilrekResponse_01	ภัณฑารักษ์คนนี้ไม่สนใจ การอัญเชิญเป็นสิ่งต้องห้าม	
VO_Curator_Male_ArcaneGolem_IllhoofSenseDemons_01	ตรวจพบปีศาจจำนวนมาก	
VO_Curator_Male_ArcaneGolem_IllhoofTurn1_01	ไม่อนุญาตให้ทำพิธีอัญเชิญ	
VO_Curator_Male_ArcaneGolem_IllhoofTurn5_01	พิธีกรรมก่อให้เกิดอันตรายต่อผู้อื่น ปีศาจต้องหยุดเดี๋ยวนี้	
VO_Curator_Male_ArcaneGolem_IllhoofWin_01	ภัณฑารักษ์คนนี้ขอขอบคุณ ห้องจัดแสดงจะกลับสู่สภาพเดิม	
VO_Curator_Male_ArcaneGolem_NightbaneCorruption_01	ไม่! [b]ห้องจัดแสดงต้องไม่ถูก[b]ความชั่วร้ายครอบงำ!	
VO_Curator_Male_ArcaneGolem_NightbaneTour_01	มังกรไนท์เบน ครั้งหนึ่งมีชื่อว่าอาร์คานากอส เวทมนตร์ที่ไม่อาจควบคุมได้ทำลายจิตใจของเขา	
VO_Curator_Male_ArcaneGolem_NightbaneTour_02	ทางด้านซ้ายของท่านคือรูปปั้นของอาราน ส่วนทางด้านขวาคือตะเกียงแห่งพลัง	
VO_Curator_Male_ArcaneGolem_NightbaneTurn1_01	สัตว์จัดแสดงอาจ[b]ได้รับอันตราย ทั้งหมดต้องถูกนำมาคืน[b]ที่งานจัดแสดง	
VO_Curator_Male_ArcaneGolem_NightbaneTurn3_01	สัตว์ประหลาดต้องถูกนำตัวกลับมา จากนั้นท่านจึงจะไปต่อได้	
VO_Curator_Male_ArcaneGolem_NightbaneUnstablePortal_01	แขกโปรดใช้ความนุ่มนวล มังกรตัวนี้หวาดกลัวเวทมนตร์ที่แปรปรวน	
VO_Curator_Male_ArcaneGolem_NightbaneWin_01	โปรดให้ความช่วยเหลือเพิ่มเติม	
VO_Curator_Neither_ArcaneGolem_CuratorDeath_04	หยุด-ทำ-งานนนนน…	
VO_Curator_Neither_ArcaneGolem_CuratorOpen_01	ห้ามแตะต้องของจัดแสดง	
VO_ELISE_LOE16_ALT_1_FIRST_HALF_02	ราฟามจะเป็นอมตะ ในระหว่างที่ไม้เท้ากำลัง ชาร์จพลัง	
VO_ELISE_LOE16_ALT_1_SECOND_HALF_03	หลังจากชาร์จเสร็จ จะมีช่องว่างให้เราตอบโต้ แต่เราจะต้องรับมือกับสัตว์ประหลาด ที่มันเรียกออกมาด้วย!	
VO_ELISE_WEIRD_DECK_05	เสียใจด้วยนะเรื่องเด็ค เราจัดไว้เพื่อลงแข่ง ทัวร์นาเมนท์ตั้งแต่ปีที่แล้ว และยังไม่ได้เปลี่ยนแปลง อะไรเลย	
VO_EMOTE_HERO_TBKTRAF_KT_DRAWING_BOARD	*เฮ้อ!*  สงสัยต้องกลับไปออกแบบใหม่แล้วมั้ง	
VO_EMOTE_HERO_TBKTRAF_KT_GLOAT	ร้องขอความเมตตาสิ	
VO_EMOTE_HERO_TBKTRAF_KT_MINIONS_SERVANTS	เหล่าสมุน ข้ารับใช้ และทหารแห่งขุมนรกเย็นยะเยือก...	
VO_FP1_014t_EnterPlay_01	ถึงตาเจ้าเจ็บปวดแล้ว!	
VO_FP1_031_Attack_07	เจ้าลูกแกะในโรงฆ่าสัตว์...	
VO_FP1_031_EnterPlay_06	เหล่ามฤตยูจะกลืนกินเจ้า!	
VO_GIL_504_Female_Orc_TUT_LootSelect2_01	ใครบังอาจทำร้ายเหล่าอสูรกายลูกรักของข้า 	
VO_GIL_504_Female_Orc_TUT_Victory_Generic_01	ชนะไปก็เท่านั้น ข้าเป็นหนึ่งเดียวกับป่า อย่าคิดว่าจะหยุดข้าได้ง่ายๆ	
VO_GIL_504_Female_Orc_TUT_Victory1_01	เจ้าไม่มีทางผ่านป่าวิทช์วู้ดได้ง่ายๆ หรอก คนอื่นจะทำได้ดีเหมือนเจ้าไหมนะ	
VO_GIL_504_Female_Orc_TUT_Victory2_01	ผู้กล้าสองรายพิชิตวิทช์วู้ดได้ แต่เจ้ายังหาข้าไม่เจอด้วยซ้ำ	
VO_GIL_504_Female_Orc_TUT_Victory3_01	หนทางของเจ้าจะพาเจ้ามาพบข้า ผู้กล้าคนสุดท้ายของเจ้าจะชนะได้หรือเปล่า	
VO_GIL_504_Female_Orc_TUT_Victory4_01	ทุกสิ่งจะจบลงในคืนนี้ มาหาข้าที่ใจกลางป่าสิ แล้วเจ้าจะได้เห็นความน่ากลัวของจริง!	
VO_GIL_504_Female_Orc_UI_Monster_Azlina_02	_โอ้ อาซาลิน่าผู้น่าสงสาร แต่เดี๋ยวนางก็หาทางออกได้ ไม่ทางใดก็ทางหนึ่ง	
VO_GIL_504_Female_Orc_UI_Monster_Baran_01	บารันช่างอ่อนโยน… น่าเสียดายที่ข้าต้องควักตาเขา	
VO_GIL_504_Female_Orc_UI_Monster_Brushwood_Cent_01	เขาเคยเป็นดรูอิดผู้ยิ่งใหญ่ แต่ความโกรธทำให้ข้าควบคุมเขาได้ง่ายดาย	
VO_GIL_504_Female_Orc_UI_Monster_Chupacabran_01	ชูปาคาบราน โอ! กว่าข้าจะได้เขามามันช่างยากเย็นเหลือเกิน 	
VO_GIL_504_Female_Orc_UI_Monster_Cragtorr_01	จงสัมผัสความโกรธเกรี้ยวของแผ่นดินที่ถูกย่ำยี แครกทอร์ จงตื่นขึ้น!	
VO_GIL_504_Female_Orc_UI_Monster_Crowskin_01	กลินดา จัดการมันซะ เจ้ามีสาวกทั้งลัทธิให้ใช้ตามใจชอบ	
VO_GIL_504_Female_Orc_UI_Monster_DrSezavo_01	พวกเจ้าคือโรคร้าย แต่เซซาโวมียารักษา 	
VO_GIL_504_Female_Orc_UI_Monster_Experiment3C_01	อืม... ข้าไม่ได้สร้างเจ้าตัวนั้น	
VO_GIL_504_Female_Orc_UI_Monster_Face_Collector_01	ใบหน้าเจ้าจะเป็นของสะสมชิ้นเยี่ยมของเขา	
VO_GIL_504_Female_Orc_UI_Monster_Gnarlroot_01	วิญญาณโบราณ จงฟังเสียงข้า! รากไม้และเถาวัลย์ กำจัดพวกมันให้พ้นตา 	
VO_GIL_504_Female_Orc_UI_Monster_Griselda_01	กริเซลดาบังอาจต่อต้านข้า นางเลยต้องชดใช้	
VO_GIL_504_Female_Orc_UI_Monster_Groddo_01	บ็อกวอร์เดนของข้า… เขาคอยปกป้องตอนที่ข้าถูกทิ้งให้ตาย	
VO_GIL_504_Female_Orc_UI_Monster_Grubb_01	แม้แต่ข้าก็ควบคุมกรับบ์ไม่ได้ 	
VO_GIL_504_Female_Orc_UI_Monster_Grum_01	ผืนดินเก่าแก่ ทนทุกข์ทรมาน จงขยับเคลื่อนไหว ทำลายเรือนและบ้าน!	
VO_GIL_504_Female_Orc_UI_Monster_Gustave_01	กุสตาฟ สัตว์เลี้ยงของข้า! เหลือซากไว้ให้ข้าด้วยนะ	
VO_GIL_504_Female_Orc_UI_Monster_Hannigul_01	ครั้งหนึ่งฮันนิกูลเคยกำจัดหนูจนหมดเมือง หนูอย่างเจ้านี่แหละ	
VO_GIL_504_Female_Orc_UI_Monster_Havnixx_01	ฮาฟนิกซ์ได้ยินความคิดเจ้า เขาจะสูบความกลัวของเจ้า	
VO_GIL_504_Female_Orc_UI_Monster_Infinite_Toki_01	เจ้าโนมน่ารำคาญ จบกันสักทีคราวนี้ พวกเจ้าสองคนน่าจะรู้จักกันนะ	
VO_GIL_504_Female_Orc_UI_Monster_Ivan_01	ไอวานเคยเป็นพวกเจ้า ตอนนี้เขาเป็นพวกข้าแล้ว	
VO_GIL_504_Female_Orc_UI_Monster_Lord_Godfrey_01	ก็อดเฟรย์! เราตกลงกันแล้ว\nมันเป็นของเจ้า 	
VO_GIL_504_Female_Orc_UI_Monster_Lovers_01	นี่คือเรื่องราวความรัก นี่คือเรื่องราวสยองขวัญ และนี่คือเรื่องราวจุดจบของเจ้า	
VO_GIL_504_Female_Orc_UI_Monster_Mistwraith_01	ในป่าลึกยามดึกสงัด เจ้าจะได้ยินเสียงกระซิบ 	
VO_GIL_504_Female_Orc_UI_Monster_Mute_01	เงียบกริบ แต่อันตราย 	
VO_GIL_504_Female_Orc_UI_Monster_Niira_01	เล่นสนุกมาพอแล้ว นีร่า จัดการมัน!	
VO_GIL_504_Female_Orc_UI_Monster_Raeth_01	ชาวฟอร์เซคเคนไม่ได้ไปจากป่านี้ทุกคน บางคนเลือกรับใช้ข้า	
VO_GIL_504_Female_Orc_UI_Monster_Rancel_01	พิษของแรนเซลช่วยข้าบิดเบือนป่าแห่งนี้	
VO_GIL_504_Female_Orc_UI_Monster_Sazzmi_01	อยู่ฟังเรื่องเล่าสักเดี๋ยวสิ ไม่ต้องไปไหนแล้ว	
VO_GIL_504_Female_Orc_UI_Monster_Sephira_01	พี่น้องฮาร์ปี้ของข้ารักษาความสงบในป่า[b]ด้วยปีกและกรงเล็บ!	
VO_GIL_504_Female_Orc_UI_Monster_Shivers_01	ลุกขึ้นมา ชิเวอร์ส! ถึงเวลาแก้แค้นแล้ว ข้ายกองค์หญิงแห่งกิลเนสให้เจ้า	
VO_GIL_504_Female_Orc_UI_Monster_Shudderwock_01	ชัดเดอร์ว็อก! ร้ายกาจจนไม่ควรปล่อยออกมา... แต่ปล่อยแล้วสนุกเป็นบ้า 	
VO_GIL_504_Female_Orc_UI_Monster_Splintergraft_01	ป่าคำรามลั่น โศกเศร้าหวาดผวา มวลหมู่แมกไม้ ทำลายศัตรูข้า…	
VO_GIL_504_Female_Orc_UI_Monster_Sthara_01	ชาวกิลเนสจะต้องเทิดทูนข้า... หลังจากซาธาราเกลี้ยกล่อมพวกเขา	
VO_GIL_504_Female_Orc_UI_Monster_Vitus_01	เขาคือพรรคพวกที่ถูกเจ้าทอดทิ้ง! แต่เขาพบบ้านใหม่ในป่าของข้า...	
VO_GIL_504_Female_Orc_UI_Monster_Wharrgarbl_01	ข้าชอบเมอร์ล็อค พวกมันเหมือนกบแต่... ฉลาดน้อยกว่า	
VO_GIL_598_Female_Human_SpecialSylvanas_01	นางแม่มดชั่ว! เจ้าฆ่าพี่ชายข้า!	
VO_GIL_692_Male_Worgen_TUT_AdventureSelect_01	ฮีโร่ทั้งหลาย! มีผู้ใดกล้าอาสาเดินทางเข้าสู่วิทช์วู้ดบ้าง	
VO_GIL_692_Male_Worgen_TUT_BossReveal1_01	สัตว์ประหลาดร้ายแฝงตัวในป่ารอบกิลเนส\nจงกำจัดพวกมันให้สิ้นซาก	
VO_GIL_692_Male_Worgen_TUT_BossReveal2_01	ยิ่งเจ้าเดินทางลึกเข้าไปในป่า สัตว์ร้ายก็จะยิ่งอันตรายมากขึ้น	
VO_GIL_692_Male_Worgen_TUT_BossReveal3_01	"ฮากาธา" คือผู้ใช้พลังมืดครอบงำวิทช์วู้ด หานางให้เจอแล้วหยุดนางให้ได้!	
VO_GIL_692_Male_Worgen_TUT_BossReveal3ALT_01	มอนสเตอร์พวกนี้คือผลงานของฮากาธา กำจัดพวกมันจนกว่าเราจะหานางเจอ!	
VO_GIL_692_Male_Worgen_TUT_CharacterSelect_01	ข้าจัดตั้งหน่วยพิเศษเพื่อการนี้ แต่ละคนมีทักษะพิเศษเฉพาะตัว 	
VO_GIL_692_Male_Worgen_TUT_Defeat1_01	ถ้าเจ้าพ่ายแพ้ในวิทช์วู้ด เจ้าจะเสียเด็คที่สร้างมา	
VO_GIL_692_Male_Worgen_TUT_FightBegin1Crowley_01	โครวลีย์! เคลื่อนย้ายปืนใหญ่สนาม[b]ของเจ้าเพื่อเพิ่ม[b]อำนาจยิงสูงสุด 	
VO_GIL_692_Male_Worgen_TUT_FightBegin1Shaw_01	การล่าเริ่มแล้ว ชอว์ ใช้สุนัขของเจ้า[b]ชิงจู่โจมพวกมันก่อน	
VO_GIL_692_Male_Worgen_TUT_FightBegin1Tess_01	เจ้าต้องพึ่งตัวเองแล้ว ลองตระเวนหาเวทมนตร์[b]จากสนามรบดู	
VO_GIL_692_Male_Worgen_TUT_FightBegin1Tess_02	ข้าเหลือเจ้าเป็น[b]ลูกคนเดียวแล้ว เทส[b]ระวังตัวด้วยนะ	
VO_GIL_692_Male_Worgen_TUT_FightBegin1Toki_01	โทคิ การควบคุมเวลาของเจ้า[b]ทำให้เจ้าโชคดีกว่าคนอื่นเขา 	
VO_GIL_692_Male_Worgen_TUT_FightBegin2_01	ตัวประหลาดพวกนี้[b]ล้วนผิดธรรมชาติ[b]ต้องมีใครสักคน[b]ควบคุมป่าให้ทำร้ายเรา!	
VO_GIL_692_Male_Worgen_TUT_LootSelect1_01	สร้างเด็คที่จะช่วยให้เจ้าเดินทางเข้าป่าได้อย่างปลอดภัย	
VO_GIL_692_Male_Worgen_TUT_LootSelect2_02	เจ้า! เจ้าคือผู้บงการสัตว์ประหลาดพวกนี้ใช่ไหม	
VO_GIL_692_Male_Worgen_TUT_TreasureSelect1_01	ฆ่ามอนสเตอร์เพื่อรับรางวัลทรงพลัง เลือกรางวัลของเจ้าให้ดีล่ะ!	
VO_GIL_692_Male_Worgen_TUT_Victory_Final_01	สำเร็จแล้ว! ป่าสงบลง แสงสว่างกลับสู่เมืองของเราแล้ว!	
VO_GILA_400h_Male_Human_EVENT_HAGATHA_ALMOSTDEAD_02	ข้าไม่ยอมง่ายๆ หรอกน่า 	
VO_GILA_400h_Male_Human_EVENT_HAGATHA_INTRO_01	หมาของข้า[b]เจอนางแล้ว! ฮากาธาอยู่นี่!	
VO_GILA_400h_Male_Human_EVENT_HAGATHA_LOWHEALTH_01	นางบาดเจ็บแล้ว ตามรอยไป เด็กๆ 	
VO_GILA_400h_Male_Human_EVENT_HAGATHA_TURN4_01	แต่ข้ามีหมา 	
VO_GILA_400h_Male_Human_EVENT_IVAN_INTRO_01	เจ้าเคยเป็นพวกเรา ไอวาน!	
VO_GILA_400h_Male_Human_EVENT_NEMESIS_INTRO_01	ในที่สุดข้าก็เจอตัวเจ้า โครวสกิน!	
VO_GILA_400h_Male_Human_EVENT_NEMESIS_TURN2_01	ทำไมกัน ทำไมเจ้า[b]ถึงไปข้องเกี่ยว[b]กับฮากาธา	
VO_GILA_500h3_Female_Human_EVENT_HAGATHA_SUB_IN_01	หาที่หลบก่อน! ข้าจัดการเอง 	
VO_GILA_500h3_Female_Human_EVENT_HAGATHA_TURN2_01	กิลเนสเคยเจอ[b]สิ่งที่เลวร้าย[b]กว่าเจ้าเยอะ ฮากาธา 	
VO_GILA_500h3_Female_Human_EVENT_HAGATHA_TURN4_01	ไปจากที่นี่ซะ นางแม่มด!	
VO_GILA_500h3_Female_Human_EVENT_HAGATHA_WOUNDED_01	ไปจากป่าแห่งนี้ แล้วข้าจะไว้ชีวิตเจ้า	
VO_GILA_500h3_Female_Human_EVENT_IVAN_INTRO_01	ไอวาน! มากับข้าเดี๋ยวนี้	
VO_GILA_500h3_Female_Human_EVENT_NEMESIS_INTRO_01	ชิเวอร์ส ข้านึกว่า[b]เจ้าตายไปแล้ว	
VO_GILA_500h3_Female_Human_EVENT_NEMESIS_TURN2_01	ข้าจะสานต่อ[b]สิ่งที่พ่อข้าทำไว้เอง	
VO_GILA_600h_Male_Worgen_EVENT_HAGATHA_SUB_IN_01	เจ้าไม่รอดแน่ ฮากาธา	
VO_GILA_600h_Male_Worgen_EVENT_HAGATHA_TURN2_01	ดินแดนนี้[b]เป็นของ[b]ชาวกิลเนส	
VO_GILA_600h_Male_Worgen_EVENT_HAGATHA_TURN4_01	อย่างน้อยพวกเขา[b]ก็ไม่ใช่สัตว์ประหลาด	
VO_GILA_600h_Male_Worgen_EVENT_HAGATHA_WOUNDED_01	ข้าจะยิงถล่ม[b]ต้นไม้ทุกต้น ป่าแห่งนี้จะต้อง[b]ราบเป็นหน้ากลอง	
VO_GILA_600h_Male_Worgen_EVENT_IVAN_INTRO_01	เจอตัวจนได้! ไอ้คนทรยศ	
VO_GILA_600h_Male_Worgen_EVENT_NEMESIS_INTRO_01	ก็อดเฟรย์ เจ้าคนทรยศ! ถึงเวลาชดใช้แล้ว	
VO_GILA_600h_Male_Worgen_EVENT_NEMESIS_TURN02_01	เจ้ามันเน่าเหม็น[b]ตั้งแต่ก่อนตายแล้ว ก็อดเฟรย์	
VO_GILA_900h_Female_Gnome_EVENT_HAGATHA_ALMOST_DEAD_01	เวลาจะเยียวยาทุกสิ่งเอง	
VO_GILA_900h_Female_Gnome_EVENT_HAGATHA_SUB_IN_01	พักก่อนเถอะ ถึงเวลาของข้าแล้ว 	
VO_GILA_900h_Female_Gnome_EVENT_HAGATHA_TURN2_01	ข้าพลิกฟ้า[b]พลิกแผ่นดิน[b]เพื่อจะจัดการเจ้า	
VO_GILA_900h_Female_Gnome_EVENT_HAGATHA_WOUNDED_01	เวลาของเจ้า[b]ใกล้หมดแล้ว นางแม่มด 	
VO_GILA_900h_Female_Gnome_EVENT_IVAN_INTRO_01	เจ้าเสร็จแน่ไอวาน ข้าเห็นอนาคต[b]มาหมดแล้ว	
VO_GILA_900h_Female_Gnome_EVENT_NEMESIS_INTRO_B_01	นี่มัน... เคยเกิดขึ้น[b]มาก่อนรึเปล่า	
VO_GILA_900h_Female_Gnome_EVENT_NEMESIS_TURN2_02	นั่นข้าคิดอะไร[b]ของข้ากันนะ	
VO_GILA_900h_Female_Gnome_EVENT_NEMESIS_TURN6_01	เจ้ามาจาก[b]อนาคตเหรอ เราคนไหนชนะล่ะ	
VO_GILA_BOSS_20h_MangyWolf_DefeatPlayer	<เสียงหอน>	
VO_GILA_BOSS_20h_MangyWolf_Emote	<เสียงคำราม>	
VO_GILA_BOSS_20h_MangyWolf_Intro	<เสียงหอน>	
VO_GILA_BOSS_21h_Rottooth_Emote	<เสียงคำราม>	
VO_GILA_BOSS_21h_Rottooth_Intro	<เสียงคำราม>	
VO_GILA_BOSS_21h_Rottooth_PlayerDefeat	<เสียงคำราม>	
VO_GILA_BOSS_22h_Male_Undead_Death_01	<ตาย>	
VO_GILA_BOSS_22h_Male_Undead_DefeatPlayer_01	แจ่มเลย! ทีนี้ข้าก็มีเงิน[b]ไปซื้อปลอกมีดแล้ว	
VO_GILA_BOSS_22h_Male_Undead_EmoteResponse_01	พูดไปเถอะ ลูกเรือของข้า[b]กำลังมา	
VO_GILA_BOSS_22h_Male_Undead_EmoteResponseTess_01	ไปอ้อนวอน[b]กัปตันชิเวอร์สเถอะ องค์หญิง!	
VO_GILA_BOSS_22h_Male_Undead_EventPlaysCoin_01	นึกแล้วว่าเจ้า[b]ต้องพกเหรียญ!	
VO_GILA_BOSS_22h_Male_Undead_EventPlaysShiv_01	ข้าชอบที่เจ้าทำ	
VO_GILA_BOSS_22h_Male_Undead_Intro_01	กัปตันอยากให้[b]เจ้าหายหัวไป	
VO_GILA_BOSS_22h_Male_Undead_IntroCrowley_01	เจ้าเป็นแม่ทัพเรอะ เงินดีรึเปล่า	
VO_GILA_BOSS_22h_Male_Undead_IntroTess_01	กัปตันรอ[b]เอาคืนเจ้าอยู่ องค์หญิง	
VO_GILA_BOSS_23h_Male_Ettin_DefeatPlayer_01	ข้าชนะ!\n(<i>มินเนี่ยนข้าไปไหนหมด</i>)	
VO_GILA_BOSS_23h_Male_Ettin_EmoteResponse_02	ข้าไม่ชอบเจ้า!\n(<i>ข้าชอบเจ้านิดเดียว</i>)	
VO_GILA_BOSS_23h_Male_Ettin_HeroPower_01	บินไปเลย!	
VO_GILA_BOSS_23h_Male_Ettin_HeroPower_02	ฮึ่ย!	
VO_GILA_BOSS_23h_Male_Ettin_HeroPower_03	ย้าก!	
VO_GILA_BOSS_23h_Male_Ettin_HeroPower_04	บิน!	
VO_GILA_BOSS_23h_Male_Ettin_HeroPower_05	เล่นมันเลย!	
VO_GILA_BOSS_23h_Male_Ettin_Intro_01	ท่าทางขว้างง่าย\n(<i>ง่ายง๊ายง่าย</i>)	
VO_GILA_BOSS_24h_Male_Bogbeast_DefeatPlayer_01	ตอนแรกลอยน้ำ เสร็จแล้วก็บวมน้ำ...	
VO_GILA_BOSS_24h_Male_Bogbeast_EmoteResponse_01	น้ำลายแตกฟอง ปุดๆ...	
VO_GILA_BOSS_24h_Male_Bogbeast_EventPlaysSmallMinion_01	เฮะเฮะเฮะเฮะเฮะ	
VO_GILA_BOSS_24h_Male_Bogbeast_EventPlaysSmallMinion_02	ฮ่าฮ่าฮ่าฮ่าฮ่า	
VO_GILA_BOSS_24h_Male_Bogbeast_EventPlaysSmallMinion_03	หึหึหึฮ่าฮ่าฮ่า	
VO_GILA_BOSS_24h_Male_Bogbeast_EventPlaysSmallMinion_04	พลาดแล้ว	
VO_GILA_BOSS_24h_Male_Bogbeast_HeroPower_01	ข้าไม่เคยอยู่ลำพัง	
VO_GILA_BOSS_24h_Male_Bogbeast_HeroPower_02	บึงน้ำมี[b]ความลับซ่อนอยู่	
VO_GILA_BOSS_24h_Male_Bogbeast_HeroPower_04	ดูสิว่าอะไรโผล่ขึ้นมา	
VO_GILA_BOSS_24h_Male_Bogbeast_Intro_01	ที่นี่บึงน้ำของข้า! มีแต่คนตายเท่านั้น	
VO_GILA_BOSS_25h_Male_Dwarf_DefeatPlayerALT_01	ฮากาธาตั้ง[b]ค่าหัวเจ้าไว้ รู้ตัวไหม	
VO_GILA_BOSS_25h_Male_Dwarf_EmoteResponse_01	อยากพูด[b]อะไรก็ตามใจ ข้าวางกับดัก[b]ไว้หมดแล้ว	
VO_GILA_BOSS_25h_Male_Dwarf_EventPlayCompass_01	เข็มทิศสวยดีนี่! เอามาให้ข้า	
VO_GILA_BOSS_25h_Male_Dwarf_EventPlaysSecret_01	เกมนั้นเล่น[b]ได้สองคนนะ	
VO_GILA_BOSS_25h_Male_Dwarf_EventPlaysSecret_02	ข้าเคยเห็น[b]กับดักนั่นมาแล้ว	
VO_GILA_BOSS_25h_Male_Dwarf_EventPlaysSecret_03	คิดว่าตัวเอง[b]ฉลาดแล้วใช่ไหม	
VO_GILA_BOSS_25h_Male_Dwarf_EventPlayToolsOfTheTrade_01	ของพวกนั้น[b]บางชิ้นเคย[b]เป็นของข้านะ	
VO_GILA_BOSS_25h_Male_Dwarf_EventPlayTrapper_01	เฮอะ! ของแบบนี้[b]มันเป็นศิลปะ!	
VO_GILA_BOSS_25h_Male_Dwarf_EventTokiAbility_01	บอกแล้วไง[b]ว่าอย่าตุกติก เจ้าโนม!	
VO_GILA_BOSS_25h_Male_Dwarf_HeroPower_01	เดินระวังด้วยล่ะ	
VO_GILA_BOSS_25h_Male_Dwarf_HeroPower_02	ย่องเข้าไว้ ระวังนะ	
VO_GILA_BOSS_25h_Male_Dwarf_HeroPower_03	ข้าดักไว้หมดแล้ว	
VO_GILA_BOSS_25h_Male_Dwarf_HeroPower_04	ไม่มีที่ไหนปลอดภัย	
VO_GILA_BOSS_25h_Male_Dwarf_Intro_01	เจ้ามีค่าหัวสูงลิบเลย	
VO_GILA_BOSS_25h_Male_Dwarf_IntroDarius_01	พอมีปืนก็[b]วางท่าใหญ่เลยนะ โครวลีย์	
VO_GILA_BOSS_25h_Male_Dwarf_IntroShaw_01	ข้าไม่เหมือนเจ้า ชอว์ ข้าเลือกอยู่ฝ่ายที่ชนะ	
VO_GILA_BOSS_25h_Male_Dwarf_IntroTess_02	เจ้าอยู่ในรายชื่อ[b]ของข้า เกรย์เมน ส่วนพ่อเจ้า[b]ก็เป็นรายถัดไป!	
VO_GILA_BOSS_25h_Male_Dwarf_IntroToki_01	อย่าคิดใช้ลูกตุกติก[b]ของเจ้าเลย โนม!	
VO_GILA_BOSS_26h_Male_Tauren_Death_01	โนม... ของข้า...	
VO_GILA_BOSS_26h_Male_Tauren_DeathToki_01	สมน้ำหน้า!	
VO_GILA_BOSS_26h_Male_Tauren_DefeatPlayer_01	เจ้าตัวใหญ่ไป ข้าจับใส่กระเป๋า[b]ไม่ได้หรอก	
VO_GILA_BOSS_26h_Male_Tauren_DefeatPlayerToki_01	ไม่มีอะไรเทียบได้กับ[b]การครอบครอง[b]โนมหายาก	
VO_GILA_BOSS_26h_Male_Tauren_EmoteResponse_01	ไม่แบ่งให้หรอก!	
VO_GILA_BOSS_26h_Male_Tauren_EmoteResponseToki_01	อืม... เจอตัว[b]พูดมากอีกแล้ว…	
VO_GILA_BOSS_26h_Male_Tauren_EventBurgle_01	ได้โนมมาบ้างไหม	
VO_GILA_BOSS_26h_Male_Tauren_EventBurgle_03	ในถุงนั่นใช่โนมหรือเปล่า	
VO_GILA_BOSS_26h_Male_Tauren_EventPlayClockworkAssistant_01	ของเลียนแบบ[b]คุณภาพต่ำ 	
VO_GILA_BOSS_26h_Male_Tauren_EventPlayGattlingGunner_01	เจ้าไปหามา[b]จากไหนน่ะ	
VO_GILA_BOSS_26h_Male_Tauren_EventPlaysClockwork_02	รุ่นเก่า เดี๋ยวนี้หายากแล้ว	
VO_GILA_BOSS_26h_Male_Tauren_EventPlaysGnome_01	ข้ามีตัวนึงเหมือนกัน! เก็บไว้ไหนแล้วนะ...	
VO_GILA_BOSS_26h_Male_Tauren_EventPlaysGnome_02	ตัวนั้นหายากมาก!	
VO_GILA_BOSS_26h_Male_Tauren_EventPlaysGnome_05	เจ้ามีรสนิยมดีจริงๆ	
VO_GILA_BOSS_26h_Male_Tauren_EventPlaysGnome_06	ข้าจะเพิ่มเจ้าตัวนั้น[b]เข้าคอลเลกชัน	
VO_GILA_BOSS_26h_Male_Tauren_EventPlaysLeper_01	ตัวนั้นน่าหยะแหยง	
VO_GILA_BOSS_26h_Male_Tauren_EventPlaysMillhouse_02	เจ้าตัวนี้พูดไม่หยุดเลย!	
VO_GILA_BOSS_26h_Male_Tauren_EventPlaysThermaplugg_02	สุดยอดความคุ้มค่า!	
VO_GILA_BOSS_26h_Male_Tauren_EventSackOfGnomes_01	ข้าลืมไปแล้ว[b]ว่าเก็บอะไรไว้	
VO_GILA_BOSS_26h_Male_Tauren_EventSackOfGnomes_03	ข้ามีโนมนับไม่ถ้วน!	
VO_GILA_BOSS_26h_Male_Tauren_EventSackOfGnomes_04	ในนี้มีอะไรนะ	
VO_GILA_BOSS_26h_Male_Tauren_EventSackOfGnomes_05	นี่คือพวกของเหลือ	
VO_GILA_BOSS_26h_Male_Tauren_EventSilence_03	เงียบหน่อย…	
VO_GILA_BOSS_26h_Male_Tauren_Intro_02	เจ้าจะมาแย่ง[b]โนมของข้าเหรอ	
VO_GILA_BOSS_26h_Male_Tauren_IntroToki_02	โอ้ มีมาให้สะสม[b]อีกตัวแล้ว...	
VO_GILA_BOSS_27h_Male_Construct_Death_02	เรา... หนีมาได้แล้ว!	
VO_GILA_BOSS_27h_Male_Construct_DefeatPlayer_01	เจ้า... ไม่ใช่[b]เป้าหมายของข้า	
VO_GILA_BOSS_27h_Male_Construct_EmoteResponse_01	ขอโทษที บางครั้ง[b]ข้าเผลอส่งเสียง[b]โดยไม่รู้ตัว	
VO_GILA_BOSS_27h_Male_Construct_EventPlayDrBoom_02	ด็อกเตอร์บูม?! อย่าพาข้ากลับไป[b]ที่แล็บเลยนะ!	
VO_GILA_BOSS_27h_Male_Construct_EventPlaySparePart_01	ห้องแล็บมี[b]ชิ้นส่วนร่างกาย… เต็มไปหมด...	
VO_GILA_BOSS_27h_Male_Construct_EventPlayUnstablePortal_01	ห้องแล็บ… ในเนเธอร์สตอร์ม...	
VO_GILA_BOSS_27h_Male_Construct_HeroPowerBeast_02	…สัตว์ร้ายในตัวข้า…	
VO_GILA_BOSS_27h_Male_Construct_HeroPowerDemon_01	…มืดมิดเหลือเกิน…	
VO_GILA_BOSS_27h_Male_Construct_HeroPowerDragon_01	…เป็นสิ่งมีชีวิต[b]ที่วิเศษมาก…	
VO_GILA_BOSS_27h_Male_Construct_HeroPowerGeneric_01	…อีกตัวแล้ว…	
VO_GILA_BOSS_27h_Male_Construct_HeroPowerMech_02	…หัวใจไขลาน!	
VO_GILA_BOSS_27h_Male_Construct_HeroPowerMurloc_01	…ปลาอีกแล้ว…	
VO_GILA_BOSS_27h_Male_Construct_HeroPowerPirate_01	...ยาร์?	
VO_GILA_BOSS_27h_Male_Construct_Intro_01	สวัสดีตอนตาย	
VO_GILA_BOSS_29h_Female_Satyr_DefeatPlayer_01	ป่าแห่งนี้[b]มีท่วงทำนอง[b]ของมันเอง	
VO_GILA_BOSS_29h_Female_Satyr_EmoteResponse_01	รุกหนักจังเลยนะ	
VO_GILA_BOSS_29h_Female_Satyr_EventPlaysEnchantingTune_01	เพลงของข้า[b]โดนใจเจ้าไหม	
VO_GILA_BOSS_29h_Female_Satyr_EventPlaysEnchantingTune_02	เราเป็นเพื่อนกัน[b]ไม่ดีกว่าเหรอ	
VO_GILA_BOSS_29h_Female_Satyr_EventPlaysEnchantingTune_03	มานั่งใกล้ๆ สิ! ข้าไม่กัดหรอก	
VO_GILA_BOSS_29h_Female_Satyr_EventPlaysOldMilitiaHorn_01	ประสานเสียงเหรอ	
VO_GILA_BOSS_29h_Female_Satyr_EventPlaysSmallMinion_01	เจ้าน่ารักจัง	
VO_GILA_BOSS_29h_Female_Satyr_EventPlaysSmallMinion_02	เจ้าน่ารักเหมือน[b]ข้าเลย! งั้น...	
VO_GILA_BOSS_29h_Female_Satyr_EventPlaysSmallMinion_03	มาให้ข้ากินซะดีๆ!	
VO_GILA_BOSS_29h_Female_Satyr_HeroPower_01	มากับข้าสิ เจ้าตัวเล็ก	
VO_GILA_BOSS_29h_Female_Satyr_HeroPower_02	หนึ่ง สอง สาม! ตามข้ามา!	
VO_GILA_BOSS_29h_Female_Satyr_HeroPower_03	ทางนี้! มาเร็ว	
VO_GILA_BOSS_29h_Female_Satyr_HeroPower_04	ตามเสียงเพลง[b]ของข้ามาเลย	
VO_GILA_BOSS_29h_Female_Satyr_HeroPower_05	ข้าจะดูแล[b]พวกเจ้าเอง! สบายใจได้	
VO_GILA_BOSS_29h_Female_Satyr_Intro_01	ในที่สุดก็มี[b]ผู้ชมสักที!	
VO_GILA_BOSS_30h_Female_Gnome_DefeatPlayer_01	อาหารฟรีไม่มี[b]หรอกตัวเอง	
VO_GILA_BOSS_30h_Female_Gnome_EmoteResponse_01	สายไปแล้วจ้ะ	
VO_GILA_BOSS_30h_Female_Gnome_EventBloodMagic_01	อ่อนแอ ปวกเปียก	
VO_GILA_BOSS_30h_Female_Gnome_EventBloodMagic_02	ลองกัดดูสิ	
VO_GILA_BOSS_30h_Female_Gnome_EventBloodMagic_04	ทา-ดา!	
VO_GILA_BOSS_30h_Female_Gnome_EventBloodMagic_05	ทุกสิ่งเท่าเทียม[b]ภายใต้เวทมนตร์[b]ของข้า	
VO_GILA_BOSS_30h_Female_Gnome_EventBloodMagic_06	อร่อยไหมจ๊ะ	
VO_GILA_BOSS_30h_Female_Gnome_Intro_01	ลองชิมหน่อยไหม หืม	
VO_GILA_BOSS_31h_Male_Treant_Death_01	<ตาย>	
VO_GILA_BOSS_31h_Male_Treant_DefeatPlayer_01	ทุกสิ่งเล็ก[b]กระจิดริด[b]เมื่อเทียบกับต้นไม้	
VO_GILA_BOSS_31h_Male_Treant_Emote Response_01	ถ้าต้นไม้[b]ล้มทับเจ้าในป่า เจ้าจะยัง[b]ส่งเสียงอยู่ไหม	
VO_GILA_BOSS_31h_Male_Treant_HeroPower_01	แยกตัวออกไป	
VO_GILA_BOSS_31h_Male_Treant_HeroPower_02	แตกหน่อ	
VO_GILA_BOSS_31h_Male_Treant_HeroPower_03	ไปเลย เจ้าตัวน้อย	
VO_GILA_BOSS_31h_Male_Treant_HeroPower_05	ส่วนหนึ่งของข้า	
VO_GILA_BOSS_31h_Male_Treant_Intro_01	ไปจากที่นี่ซะ	
VO_GILA_BOSS_32h_Female_Sprite_Death_01	ไม่สนุกเลย!	
VO_GILA_BOSS_32h_Female_Sprite_DefeatPlayer_01	เร็วเข้า เล่นกันอีกสิ! โอ๊ะ... เล่นแรงไปหน่อย	
VO_GILA_BOSS_32h_Female_Sprite_EmoteResponse_01	ได้ ได้ เอาไว้[b]เล่นเกมนั้นทีหลัง!	
VO_GILA_BOSS_32h_Female_Sprite_EventPlaysAoEBuff_01	เจ้าเล่นเกมนี้เก่งนะ!	
VO_GILA_BOSS_32h_Female_Sprite_EventPlaysAoEBuff_02	เจ้าเคยเล่นเกมนี้[b]มาก่อนแน่เลย	
VO_GILA_BOSS_32h_Female_Sprite_EventPlaysBigMinion_01	โว้ว!! โกงกันนี่นา!	
VO_GILA_BOSS_32h_Female_Sprite_EventPlaysBigMinion_02	ว้าว!	
VO_GILA_BOSS_32h_Female_Sprite_HeroPower_01	โตเร็วๆ! เร็วอีก!	
VO_GILA_BOSS_32h_Female_Sprite_HeroPower_02	รีบโตสิ! เร็วเข้า!	
VO_GILA_BOSS_32h_Female_Sprite_HeroPower_03	โต โต โตขึ้นไป!	
VO_GILA_BOSS_32h_Female_Sprite_HeroPower_04	เฮะเฮะ ข้าใกล้ชนะแล้วล่ะ!	
VO_GILA_BOSS_32h_Female_Sprite_Intro_01	เล่นเกมกันไหม	
VO_GILA_BOSS_33h_Male_Mech_Attack_01	เข้าโจมตี	
VO_GILA_BOSS_33h_Male_Mech_Death_01	ระบบข้อมูลผิดพลาด...	
VO_GILA_BOSS_33h_Male_Mech_DefeatPlayer_01	ผิดพลาด ไม่มีเป้าหมายแล้ว ออกลาดตระเวนต่อ	
VO_GILA_BOSS_33h_Male_Mech_EmoteResponse_01	ยินดีที่ได้ข้องเกี่ยว	
VO_GILA_BOSS_33h_Male_Mech_EventPlayHarvestGolem_01	คำเตือน: เป้าหมายไม่มีวิญญาณ	
VO_GILA_BOSS_33h_Male_Mech_EventWeaponKill_01	ฟาดฟัน	
VO_GILA_BOSS_33h_Male_Mech_EventWeaponKill_02	อัพเกรด	
VO_GILA_BOSS_33h_Male_Mech_EventWeaponKill_03	กำจัดเป้าหมาย	
VO_GILA_BOSS_33h_Male_Mech_HeroPower_01	เก็บเกี่ยว	
VO_GILA_BOSS_33h_Male_Mech_HeroPower_02	เชื้อเพลิง	
VO_GILA_BOSS_33h_Male_Mech_HeroPower_03	เติมพลัง	
VO_GILA_BOSS_33h_Male_Mech_HeroPower_04	รีไซเคิล	
VO_GILA_BOSS_33h_Male_Mech_Intro_01	เริ่มการเก็บเกี่ยวได้	
VO_GILA_BOSS_34h_Male_Demon_DefeatPlayer_01	วิญญาณเจ้า... ช่างทรงพลัง ข้ากินได้[b]ทั้งสัปดาห์เลย!	
VO_GILA_BOSS_34h_Male_Demon_EmoteResponse_01	หวังว่าวิญญาณเจ้า[b]จะพูดน้อยกว่านี้นะ	
VO_GILA_BOSS_34h_Male_Demon_HeroPower_01	อาหารเลิศรส	
VO_GILA_BOSS_34h_Male_Demon_HeroPower_02	น่าอร่อยจัง	
VO_GILA_BOSS_34h_Male_Demon_HeroPower_03	เจ้าหน้าซีดนิดหน่อยนะ	
VO_GILA_BOSS_34h_Male_Demon_HeroPower_04	เดี๋ยวข้าช่วย[b]แบ่งเบาภาระเอง	
VO_GILA_BOSS_34h_Male_Demon_HeroPower_05	วิญญาณมีไว้ก็หนักเปล่าๆ	
VO_GILA_BOSS_34h_Male_Demon_Intro_01	ไม่ช้าเจ้าจะกลายเป็น[b]ร่างกลวงเปล่า	
VO_GILA_BOSS_35h_Male_Beast_DefeatPlayer	<เสียงร้อง>	
VO_GILA_BOSS_35h_Male_Beast_EmoteResponse	<เสียงร้อง>	
VO_GILA_BOSS_35h_Male_Beast_Intro	<เสียงร้อง>	
VO_GILA_BOSS_36h_Female_Human_Death_01	อ๊บอ๊บ!	
VO_GILA_BOSS_36h_Female_Human_DefeatPlayer_01	เจ้าไม่ใช่[b]เจ้าชายของข้า!	
VO_GILA_BOSS_36h_Female_Human_Emote Response_01	หยุดพูดแล้วมา[b]จูบกันเถอะ เธอจ๋า!	
VO_GILA_BOSS_36h_Female_Human_EventHex_01	<อ้าปากค้าง> อุ๊ย! หล่อจังเลย!	
VO_GILA_BOSS_36h_Female_Human_EventHex_02	ข้าเข้าใจ[b]ความรู้สึกนี้ดี	
VO_GILA_BOSS_36h_Female_Human_HeroPower_01	จุ๊บ!	
VO_GILA_BOSS_36h_Female_Human_HeroPower_02	<เสียงจูบยาวนาน>	
VO_GILA_BOSS_36h_Female_Human_HeroPower_03	จุ๊บ!	
VO_GILA_BOSS_36h_Female_Human_Intro_01	โอย เอาอีกแล้ว	
VO_GILA_BOSS_37h_Male_Murloc_DefeatPlayer_01	...	
VO_GILA_BOSS_37h_Male_Murloc_EmoteResponse_01	…!	
VO_GILA_BOSS_37h_Male_Murloc_EventPlayMurlocHolmes_02	…? …!	
VO_GILA_BOSS_37h_Male_Murloc_EventPlayPlague_01	…!	
VO_GILA_BOSS_37h_Male_Murloc_EventPlayPlague_02	…!	
VO_GILA_BOSS_37h_Male_Murloc_EventPlayPlague_07	…!	
VO_GILA_BOSS_37h_Male_Murloc_HeroPower_01	…	
VO_GILA_BOSS_37h_Male_Murloc_HeroPower_02	…	
VO_GILA_BOSS_37h_Male_Murloc_HeroPower_03	…!	
VO_GILA_BOSS_37h_Male_Murloc_HeroPower_04	…	
VO_GILA_BOSS_37h_Male_Murloc_Intro_01	…	
VO_GILA_BOSS_38h_Male_Goblin_Death_01	นกอีกแล้ว!	
VO_GILA_BOSS_38h_Male_Goblin_DefeatPlayer_01	อีการ้องว่า กา!	
VO_GILA_BOSS_38h_Male_Goblin_EmoteResponse_01	เรียกแบบนั้น[b]นกที่ไหนจะมา!	
VO_GILA_BOSS_38h_Male_Goblin_EventBirdDead_01	เจ้า... เจ้าคนใจยักษ์!	
VO_GILA_BOSS_38h_Male_Goblin_EventBirdDead_02	มันไปทำอะไร[b]ให้เจ้าน่ะ!	
VO_GILA_BOSS_38h_Male_Goblin_EventBirdDead_03	มันเป็นแค่[b]นกเองนะ!	
VO_GILA_BOSS_38h_Male_Goblin_EventPlayBird_01	บินสู่อิสรภาพ!	
VO_GILA_BOSS_38h_Male_Goblin_EventPlayBird_02	นกจ๋ามาเร็ว!	
VO_GILA_BOSS_38h_Male_Goblin_EventPlayBird_03	นกน้อยของข้า 	
VO_GILA_BOSS_38h_Male_Goblin_EventPlayBird_04	ข้าอยากเป็น[b]นกเหลือเกิน	
VO_GILA_BOSS_38h_Male_Goblin_EventPlayerPlayBird_01	ตัวนี้น่ารักจัง	
VO_GILA_BOSS_38h_Male_Goblin_EventPlayerPlayBird_02	นี่คือการต่อสู้[b]ระหว่างนก	
VO_GILA_BOSS_38h_Male_Goblin_EventPlayNestingRoc_01	ข้า... ไม่ได้จะ[b]เรียกตัวนั้นนะ	
VO_GILA_BOSS_38h_Male_Goblin_EventPlayNestingRoc_02	เอ่อ… ใกล้เคียงอยู่	
VO_GILA_BOSS_38h_Male_Goblin_HeroPower_01	กา! กา!	
VO_GILA_BOSS_38h_Male_Goblin_HeroPower_02	กา... แค่กๆ... อั่ก	
VO_GILA_BOSS_38h_Male_Goblin_HeroPower_03	กา กา กา!	
VO_GILA_BOSS_38h_Male_Goblin_Intro_01	ข้าอยากเห็น[b]ทุกคนบินได้!	
VO_GILA_BOSS_40h_Female_Treant_Death_01	ล้มแล้ว...	
VO_GILA_BOSS_40h_Female_Treant_DefeatPlayer_01	นี่แค่รายแรกเท่านั้น การเก็บเกี่ยวเริ่มแล้ว	
VO_GILA_BOSS_40h_Female_Treant_EmoteResponse_01	ฉับ ฉับ	
VO_GILA_BOSS_40h_Female_Treant_EventPlaysAxe_01	กี่ต้นแล้วที่จากไป[b]ก่อนวัยอันควร	
VO_GILA_BOSS_40h_Female_Treant_EventPlaysAxe_02	เผ่าพันธุ์ข้าจะต้อง[b]ทรมานอีกแค่ไหน	
VO_GILA_BOSS_40h_Female_Treant_EventPlaysWoodsmansAxe_01	น่ารังเกียจ 	
VO_GILA_BOSS_40h_Female_Treant_HeroPower_01	ป่าจะทำลายพวกมัน 	
VO_GILA_BOSS_40h_Female_Treant_HeroPower_02	ป่าแห่งนี้มีชีวิต	
VO_GILA_BOSS_40h_Female_Treant_HeroPower_03	มาเถอะ ถึงเวลาแล้ว	
VO_GILA_BOSS_40h_Female_Treant_HeroPower_04	เจ้าจะรู้ซึ้งถึง[b]ความแค้นของเรา	
VO_GILA_BOSS_40h_Female_Treant_Intro_01	พวกเจ้าจะต้องชดใช้	
VO_GILA_BOSS_41h_Female_HumanGhost_Death_01	ที่รัก...	
VO_GILA_BOSS_41h_Female_HumanGhost_DefeatPlayer_01	ไม่มีใครแยก[b]เราจากกันได้	
VO_GILA_BOSS_41h_Female_HumanGhost_EmoteResponse_01	อย่ายุ่งกับเรา	
VO_GILA_BOSS_41h_Female_HumanGhost_EventFatigue_01	ที่รัก เจ้าหาย[b]ไปไหนน่ะ	
VO_GILA_BOSS_41h_Female_HumanGhost_EventFatigue_02	ข้าไม่รู้สึกถึงเขาแล้ว...	
VO_GILA_BOSS_41h_Female_HumanGhost_EventFatigueDeath_01	เราเป็น... อิสระแล้วเหรอ ขอบคุณ!	
VO_GILA_BOSS_41h_Female_HumanGhost_EventPlayRin_01	นางจะปลดปล่อย[b]เราได้ไหม	
VO_GILA_BOSS_41h_Female_HumanGhost_EventShuffle_01	เจ้าเข้าใจเรา... ใช่ไหม	
VO_GILA_BOSS_41h_Female_HumanGhost_EventShuffle_02	อยู่ด้วยกัน... ตลอดไป	
VO_GILA_BOSS_41h_Female_HumanGhost_EventShuffle_03	เจ้าเหมือนเราเลย	
VO_GILA_BOSS_41h_Female_HumanGhost_HeroPower_01	ข้าไม่ยอม[b]ปล่อยวางหรอก	
VO_GILA_BOSS_41h_Female_HumanGhost_HeroPower_02	กลับมาหาข้าก่อน!	
VO_GILA_BOSS_41h_Female_HumanGhost_HeroPower_03	อย่าไปนะ...	
VO_GILA_BOSS_41h_Female_HumanGhost_HeroPower_04	ข้าจะดูแลเจ้าให้ดี	
VO_GILA_BOSS_41h_Female_HumanGhost_Intro_01	อีกไม่นานเราจะได้[b]กลับมาอยู่ด้วยกัน ที่รัก	
VO_GILA_BOSS_41h_Male_NightElf_Death_01	ไม่…	
VO_GILA_BOSS_41h_Male_NightElf_DefeatPlayer_01	วิทช์วู้ดไม่ต้องการเจ้า	
VO_GILA_BOSS_41h_Male_NightElf_EmoteResponse_02	เจ้าโน้มน้าว[b]ข้าไม่ได้หรอก	
VO_GILA_BOSS_41h_Male_NightElf_EventHack_01	สับไม่เลี้ยง!	
VO_GILA_BOSS_41h_Male_NightElf_EventHack_02	กรรมตามสนอง	
VO_GILA_BOSS_41h_Male_NightElf_EventHack_03	ออก... ไป... จาก... ป่า... แห่งนี้!	
VO_GILA_BOSS_41h_Male_NightElf_HeroPower_01	ธรรมชาติเลือก[b]ผู้อยู่รอด!	
VO_GILA_BOSS_41h_Male_NightElf_HeroPower_02	เถาวัลย์พันเกี่ยวเลี้ยวลด	
VO_GILA_BOSS_41h_Male_NightElf_HeroPower_03	ทดสอบฝีมือหน่อย!	
VO_GILA_BOSS_41h_Male_NightElf_HeroPower_04	ไหนจัดการซิ	
VO_GILA_BOSS_41h_Male_NightElf_Intro_01	กลับไป ผู้บุกรุก	
VO_GILA_BOSS_42h_Male_Ogre_DefeatPlayer_01	เจ้าไม่เห็นหรอก[b]ว่าโดนอะไร ข้าก็เหมือนกัน	
VO_GILA_BOSS_42h_Male_Ogre_EmoteResponse_01	พูดต่อสิ ข้าจะได้[b]หาตัวเจ้าเจอ!	
VO_GILA_BOSS_42h_Male_Ogre_EventHeroPowerEnemy_01	โดนแล้ว! 	
VO_GILA_BOSS_42h_Male_Ogre_EventHeroPowerEnemy_02	ทุบ!	
VO_GILA_BOSS_42h_Male_Ogre_EventHeroPowerEnemy_03	ข้าไม่เคยพลาด!	
VO_GILA_BOSS_42h_Male_Ogre_EventHeroPowerFriendly_01	พลาดแล้ว	
VO_GILA_BOSS_42h_Male_Ogre_EventHeroPowerFriendly_02	เสียงใครคอหักน่ะ	
VO_GILA_BOSS_42h_Male_Ogre_Intro_01	นั่นใคร ข้าได้กลิ่นเจ้านะ!	
VO_GILA_BOSS_43h_Male_HumanGhost_DefeatPlayer_01	ขุดหลุมอีกแล้ว	
VO_GILA_BOSS_43h_Male_HumanGhost_EmoteResponse_01	ไปซะ	
VO_GILA_BOSS_43h_Male_HumanGhost_EventPlaysDeathrattle_01	เสียงกระดูกกระทบกัน	
VO_GILA_BOSS_43h_Male_HumanGhost_EventPlaysDeathrattle_02	คนตายมี[b]เรื่องอยากบอก	
VO_GILA_BOSS_43h_Male_HumanGhost_EventPlaysDeathrattle_03	เราไม่ต่างกันเลย	
VO_GILA_BOSS_43h_Male_HumanGhost_EventPlaysDeathrattle_04	ลงหลุมเถอะ พักผ่อน	
VO_GILA_BOSS_43h_Male_HumanGhost_EventPlaysDeathrattle_05	ต้องขุดอีกหลุมให้มัน	
VO_GILA_BOSS_43h_Male_HumanGhost_EventPlayStrokeOfMidnight_01	ไม้ได้ยินเสียง[b]ระฆังมาตั้งนานแล้ว	
VO_GILA_BOSS_43h_Male_HumanGhost_Intro_01	ออกมาทำอะไร[b]ดึกดื่นป่านนี้	
VO_GILA_BOSS_44h_Male_Troll_Death_01	<ตาย>	
VO_GILA_BOSS_44h_Male_Troll_DefeatPlayer_02	ถ้าไม่รักษาสุขภาพ[b]ก็จะเป็นอย่างนี้แหละ!	
VO_GILA_BOSS_44h_Male_Troll_EmoteResponse_01	เชื่อหมอแล้วดีเอง	
VO_GILA_BOSS_44h_Male_Troll_EventHeals_01	อา...	
VO_GILA_BOSS_44h_Male_Troll_EventHeals_02	ของเขาดีจริงๆ…	
VO_GILA_BOSS_44h_Male_Troll_EventHeals_04	ฮ่าฮ่าฮ่า อืมมม...	
VO_GILA_BOSS_44h_Male_Troll_EventPlayerHeals_03	เอ๊ะ! เจ้าทำผิดวิธีแล้ว	
VO_GILA_BOSS_44h_Male_Troll_EventPlayerHeals_04	เดี๋ยวข้าจัดการให้เอง	
VO_GILA_BOSS_44h_Male_Troll_EventPlaysBandages_01	เจ้าใช้ของ[b]คุณภาพเลยนะ!	
VO_GILA_BOSS_44h_Male_Troll_HeroPower_01	เจ็บเหมือน[b]มดกัดนิดเดียว	
VO_GILA_BOSS_44h_Male_Troll_HeroPower_02	กลัวเข็มเหรอ	
VO_GILA_BOSS_44h_Male_Troll_HeroPower_03	แป๊บเดียวเอง ไม่เจ็บหรอก คิดว่านะ	
VO_GILA_BOSS_44h_Male_Troll_HeroPower_04	วูดูที่ไหน ข้ามีใบอนุญาต	
VO_GILA_BOSS_44h_Male_Troll_HeroPower_05	รู้สึกดีใช่ไหมล่ะ	
VO_GILA_BOSS_44h_Male_Troll_HeroPower_06	เจ็บนิดนึงนะ	
VO_GILA_BOSS_44h_Male_Troll_Intro_01	มาเลย! นั่งสิ บอกหมอหน่อย[b]ว่าเจ็บตรงไหน	
VO_GILA_BOSS_45h_Female_Human_Death_02	<ตาย>	
VO_GILA_BOSS_45h_Female_Human_DefeatPlayer_01	ถ้าเจ้าเข้าร่วมกับเรา คงไปได้ไกลน่าดู	
VO_GILA_BOSS_45h_Female_Human_EmoteResponse_01	มาคุยกันดีกว่า หาอะไรดื่มไปด้วย 	
VO_GILA_BOSS_45h_Female_Human_EventDrawsExtraCards_01	นั่นแหละ ดื่มเลย	
VO_GILA_BOSS_45h_Female_Human_EventDrawsExtraCards_02	รสชาติเป็นไง	
VO_GILA_BOSS_45h_Female_Human_EventDrawsExtraCards_03	ดื่มเยอะๆ เอาเลย	
VO_GILA_BOSS_45h_Female_Human_EventFirstDamage_01	หมายความว่า[b]เจ้าไม่สนใจเหรอ	
VO_GILA_BOSS_45h_Female_Human_EventPlayHallowedWater_01	น้ำมนต์เหรอ แหวะ ไม่เคยชอบ[b]รสชาติมันเลย	
VO_GILA_BOSS_45h_Female_Human_EventPlaysAcolyte_01	โอ้… ข้าชอบเขานะ 	
VO_GILA_BOSS_45h_Female_Human_EventPlaysHoarder_01	ไว้ค่อยดื่มส่งท้าย[b]ให้เขาแล้วกัน	
VO_GILA_BOSS_45h_Female_Human_EventPlaysNovice_01	สาวกคนใหม่[b]มาถึงแล้ว ดื่มให้นางหน่อย!	
VO_GILA_BOSS_45h_Female_Human_Intro_01	วางอาวุธของ[b]เจ้าลงเถอะ เข้าร่วมกับเรา 	
VO_GILA_BOSS_46h_Male_Worgen_DefeatPlayer_01	ผู้เข้มแข็ง[b]เท่านั้นที่อยู่รอด	
VO_GILA_BOSS_46h_Male_Worgen_EmoteResponse_01	ได้กลิ่นนั่นไหม ความกลัวไงล่ะ	
VO_GILA_BOSS_46h_Male_Worgen_EventPlayBloodMoon_01	<เสียงหอน>	
VO_GILA_BOSS_46h_Male_Worgen_EventPlaysWorgen_01	น่าสมเพช	
VO_GILA_BOSS_46h_Male_Worgen_EventPlaysWorgen_03	อ่อนแอ	
VO_GILA_BOSS_46h_Male_Worgen_EventPlaysWorgen_06	เจ้ามันกระจอก	
VO_GILA_BOSS_46h_Male_Worgen_EventPlayTrapper_02	ปลดปล่อย[b]ความโกรธออกมาสิ!	
VO_GILA_BOSS_46h_Male_Worgen_Intro_01	ยังกล้าตาม[b]ล่าข้าอีกรึ	
VO_GILA_BOSS_47h_Male_Monster_Death_01	หมดเวลา... ข้าไปแล้ว!	
VO_GILA_BOSS_47h_Male_Monster_DefeatPlayer_01	กัดกินฮีโร่แต่ละครั้ง ป่าก็ยิ่งทรงพลัง	
VO_GILA_BOSS_47h_Male_Monster_EmoteResponse_01	มันพูดได้! มันส่งเสียง! อ่อนแอไม่เป็นท่า จนต้องอ้อนวอนผู้ไล่ล่า!	
VO_GILA_BOSS_47h_Male_Monster_HeroPower_01	ปัญหามาสองเท่า!	
VO_GILA_BOSS_47h_Male_Monster_HeroPower_02	ชดใช้ชดใช้ ไม่ใช่แค่หนึ่ง แต่ถึงสองครั้ง	
VO_GILA_BOSS_47h_Male_Monster_HeroPower_03	เพื่อนใหม่ ทักทาย ลากไส้ วนไป	
VO_GILA_BOSS_47h_Male_Monster_IntroALT_01	ชัดเดอร์ว็อก[b]อยากบอกว่า[b]มันเอาจริงไม่มีหลอก	
VO_GILA_BOSS_48h_Female_Gnome_Death_01	มันจะเป็นผลเสีย[b]กับเจ้ามากกว่าข้า!	
VO_GILA_BOSS_48h_Female_Gnome_DefeatPlayer_01	จัดการตัวข้า[b]ได้ซะที เดี๋ยวนะ มันขัดแย้งกัน[b]ไม่ใช่เหรอ	
VO_GILA_BOSS_48h_Female_Gnome_EmoteResponse_01	รู้อยู่แล้วว่าข้า[b]ต้องพูดแบบนั้น 	
VO_GILA_BOSS_48h_Female_Gnome_EventAlt_01	ไม่! เราจะ[b]เริ่มกันใหม่อีกครั้ง	
VO_GILA_BOSS_48h_Female_Gnome_EventAlt_02	ข้าว่ามันเป็น[b]อย่างนี้มากกว่า!	
VO_GILA_BOSS_48h_Female_Gnome_EventAlt_03	หยุด! ย้อนเวลา[b]กลับไปซะ	
VO_GILA_BOSS_48h_Female_Gnome_EventPlayerAltTime_01	ครั้งแรกของเจ้าสินะ	
VO_GILA_BOSS_48h_Female_Gnome_EventPlayerAltTime_02	ว้าว เราทำมิติเวลา[b]สับสนขนาดหนักเลย	
VO_GILA_BOSS_48h_Female_Gnome_EventPlayerTimeWarp_01	มันชักจะวุ่นวาย[b]ไปกันใหญ่แล้ว	
VO_GILA_BOSS_48h_Female_Gnome_EventPlayerTimeWarp_02	เตือนตัวเอง: เลี่ยงการต่อสู้ครั้งนี้	
VO_GILA_BOSS_48h_Female_Gnome_EventPlayerTimeWarpToki_01	เดี๋ยวนะ เจ้าต้องยัง[b]ไม่รู้จักทักษะนี้สิ!	
VO_GILA_BOSS_48h_Female_Gnome_EventPlayerTimeWarpToki_02	ข้าจำตอนนี้ได้[b]จากที่ข้า[b]ย้อนเวลาครั้งก่อน!	
VO_GILA_BOSS_48h_Female_Gnome_EventTimeWarp_01	เดี๋ยวอีกไม่กี่ปี[b]เจ้าก็เข้าใจเอง	
VO_GILA_BOSS_48h_Female_Gnome_EventTimeWarp_02	ข้าใช้เวลา[b]ทำความเข้าใจ[b]อยู่ตั้งนาน	
VO_GILA_BOSS_48h_Female_Gnome_EventTurn2_01	ข้าต้องหยุดตัวข้า! ก่อนทุกอย่าง[b]จะสายเกินแก้!	
VO_GILA_BOSS_48h_Female_Gnome_EventTurn4_01	เจ้าไม่มีทางชนะหรอก! ข้ารู้จักลูกเล่น[b]ของตัวเองดี!	
VO_GILA_BOSS_48h_Female_Gnome_EventTurn6_01	สิ่งที่เจ้าทำจะทำให้เรา[b]ทั้งคู่ต้องเสียใจ ยกเว้นข้าจะ[b]หยุดเจ้าได้! 	
VO_GILA_BOSS_48h_Female_Gnome_HeroPower_01	ต้องเร่งเครื่องหน่อยแล้ว!	
VO_GILA_BOSS_48h_Female_Gnome_HeroPower_02	ติ๊กต่อกติ๊กต่อก!	
VO_GILA_BOSS_48h_Female_Gnome_HeroPower_03	รีบจัดการให้จบดีกว่า	
VO_GILA_BOSS_48h_Female_Gnome_Intro_01	อ้าว นี่เป็นครั้งแรก[b]ที่เราเจอกันอีกแล้ว!	
VO_GILA_BOSS_48h_Female_Gnome_Intro_02	ตัวข้าอีกแล้วเหรอ เราสู้กันมา[b]สองครั้งแล้วนะ 	
VO_GILA_BOSS_48h_Female_Gnome_Intro_03	เราสู้กันมา[b]สามครั้งแล้ว ยอมแพ้ซะที!	
VO_GILA_BOSS_48h_Female_Gnome_Intro_04	เสนอหน้า[b]กลับมาอีกแล้ว! หยุดซะที!	
VO_GILA_BOSS_48h_Female_Gnome_Intro_05	เราจะต้องสู้กัน[b]อย่างนี้อีกสักกี่ครั้ง	
VO_GILA_BOSS_48h_Female_Gnome_PlayerHeroPower_01	นี่ข้านึกยังไงถึงได้[b]ทำแบบนั้นนะ	
VO_GILA_BOSS_48h_Female_Gnome_PlayerHeroPower_02	ข้าเคยคิดว่า[b]ตัวเองฉลาดนะ	
VO_GILA_BOSS_48h_Female_Gnome_PlayerHeroPower_03	เอาอีกแล้ว!	
VO_GILA_BOSS_48h_Female_Gnome_PlayerHeroPower_04	ข้าเริ่มหงุดหงิด[b]ตัวเองแล้ว	
VO_GILA_BOSS_49h_Female_Undead_Death_01	หัวใจ... เน่าๆ...	
VO_GILA_BOSS_49h_Female_Undead_DefeatPlayer_01	เจ้าน่าจะเข้าร่วม[b]กับเราแต่แรก 	
VO_GILA_BOSS_49h_Female_Undead_EmoteResponse_01	เข้าร่วมกับเราสิ เรามีจับฉลาก[b]ทุกวันศุกร์นะ 	
VO_GILA_BOSS_49h_Female_Undead_EventFaithfulDies_01	ข้ายังต้องใช้มันนะ!	
VO_GILA_BOSS_49h_Female_Undead_EventFaithfulDies_02	พวกเก่งๆ ทำไมล้างสมองยากจัง	
VO_GILA_BOSS_49h_Female_Undead_EventFaithfulDies_03	ข้าจะไม่ลืมเจ้าเลย... ไม่ว่าเจ้าจะชื่ออะไร	
VO_GILA_BOSS_49h_Female_Undead_EventPact_01	มาเป็นพวกเรา...	
VO_GILA_BOSS_49h_Female_Undead_EventPact_02	ได้สมาชิกใหม่อีกแล้ว!	
VO_GILA_BOSS_49h_Female_Undead_EventPact_03	มาหาข้าสิ อย่างนั้นแหละ...	
VO_GILA_BOSS_49h_Female_Undead_EventPact_05	ลัทธิของข้าเติบโต!	
VO_GILA_BOSS_49h_Female_Undead_EventPlayBird_01	หนามพีซบลูมและ\nเรดแบนด์ใส่ลงมา เพิ่มปีกลูกนกฮูก\nและขากิ้งก่า	
VO_GILA_BOSS_49h_Female_Undead_EventPlayCauldron_01	สิ่งวิปริต ผิดธรรมดา และชั่วร้าย เปลวไฟลุกโชน ในหม้อเดือดเป็นไอ	
VO_GILA_BOSS_49h_Female_Undead_EventPlayDragon_01	เกล็ดมังกร เขี้ยวหมาป่า รากเอิร์ธรูท คนจนกว่าจะเข้าท่า	
VO_GILA_BOSS_49h_Female_Undead_EventPlayFaithful_01	มาเถิด สาวกของข้า 	
VO_GILA_BOSS_49h_Female_Undead_EventPlayFaithful_02	ก้าวออกมา สาวกผู้ซื่อสัตย์...	
VO_GILA_BOSS_49h_Female_Undead_EventPlayFaithful_03	จงมอบชีวิตให้ข้า	
VO_GILA_BOSS_49h_Female_Undead_EventPlayFaithful_04	สาวกผู้ภักดี!	
VO_GILA_BOSS_49h_Female_Undead_EventPlayFaithful_05	จงรับใช้ข้า[b]เป็นครั้งสุดท้าย!	
VO_GILA_BOSS_49h_Female_Undead_EventPlayHex_01	ลูกตาตัวนิวต์และ[b]นิ้วเท้าของกบ ขนค้างคาวและ[b]ไอหมอกใส่ให้ครบ	
VO_GILA_BOSS_49h_Female_Undead_EventPlaySnake_01	เนื้องูพิษกระหายเลือด ใส่ลงในหม้อตั้งไฟให้เดือด	
VO_GILA_BOSS_49h_Female_Undead_EventPlayTreant_01	ผสมท่อนไม้ผุพัง ช่วยเสริมมนตร์[b]เพิ่มความขลัง	
VO_GILA_BOSS_49h_Female_Undead_EventTurn02_01	ถ้าเจ้าเห็น[b]พลังของนางนะ ชอว์ เจ้าจะหมอบ[b]เป็นหมาเลย	
VO_GILA_BOSS_49h_Female_Undead_Intro_02	เจ้าตามจนเจอเรา หรือเราล่อเจ้ามากันแน่นะ	
VO_GILA_BOSS_50h_Male_Spirit_DefeatPlayer_01	ตายย่อมดีกว่าถูกลืม…	
VO_GILA_BOSS_50h_Male_Spirit_EmoteResponse_01	พักหายใจก่อน…	
VO_GILA_BOSS_50h_Male_Spirit_EventPlaysEcho_01	เยี่ยม...	
VO_GILA_BOSS_50h_Male_Spirit_EventPlaysEcho_02	นั่นแหละ...	
VO_GILA_BOSS_50h_Male_Spirit_EventPlaysEcho_03	เอาอีก…!	
VO_GILA_BOSS_50h_Male_Spirit_EventPlaysEcho_04	หึหึหึฮ่าฮ่าฮ่า	
VO_GILA_BOSS_50h_Male_Spirit_Intro_01	หมอกเรียกหาเจ้า...	
VO_GILA_BOSS_51h_Male_Undead_Death_01	<ตาย>	
VO_GILA_BOSS_51h_Male_Undead_DefeatPlayer_01	โอ้ววว! เจ้าคงไม่ต้อง[b]ใช้เงินอีกแล้ว	
VO_GILA_BOSS_51h_Male_Undead_EmoteResponse_01	หุบปากไปเลย	
VO_GILA_BOSS_51h_Male_Undead_EventPlayCoinPouch_01	เร็วเข้า ส่งมาให้ข้า	
VO_GILA_BOSS_51h_Male_Undead_EventPlayMinion_01	เฮ้ย! ทำแบบนั้น[b]ต้องเสียภาษีนะ	
VO_GILA_BOSS_51h_Male_Undead_EventPlayMinion_03	มีค่าใช้จ่ายนะ	
VO_GILA_BOSS_51h_Male_Undead_EventPlayMinion_04	อีกเดี๋ยวเจ้า[b]จะต้องชดใช้	
VO_GILA_BOSS_51h_Male_Undead_HeroPower_01	มีน้อยข้าก็เอา	
VO_GILA_BOSS_51h_Male_Undead_HeroPower_02	ติดหนี้ก็ต้องจ่าย	
VO_GILA_BOSS_51h_Male_Undead_HeroPower_03	แค่เศษเงินเอง	
VO_GILA_BOSS_51h_Male_Undead_HeroPower_04	ส่งเงินมาให้หมด	
VO_GILA_BOSS_51h_Male_Undead_Intro_01	เจ้าท่าทางเหมือน[b]คนที่ติดเงินข้าเลย	
VO_GILA_BOSS_52h_Male_Human_DefeatPlayerALT_02	ข้าไม่กลับไป[b]เข้าคุกแน่! ไม่มีทาง!	
VO_GILA_BOSS_52h_Male_Human_EmoteResponse_02	ในนี้มีแต่ควันกับ[b]ขี้เถ้าทั้งนั้นเลย	
VO_GILA_BOSS_52h_Male_Human_EventPlayRoyalGift_02	อู้ว สมบัติ! ขอข้า[b]ลองจับดูบ้างได้ไหม	
VO_GILA_BOSS_52h_Male_Human_EventPlayStealth_02	สองมาตรฐานนี่นา!	
VO_GILA_BOSS_52h_Male_Human_EventPlayStealth_03	พอข้าซ่อนตัวบ้างก็หา[b]ว่าเป็นขโมยเชียวนะ	
VO_GILA_BOSS_52h_Male_Human_EventTransform_01	ข้าเริ่มหมด[b]ความอดทนแล้ว	
VO_GILA_BOSS_52h_Male_Human_HeroPower_01	ไม่เห็นหรอก!	
VO_GILA_BOSS_52h_Male_Human_HeroPower_02	ข้าไม่ได้ย่องเบานะ สาบานได้!	
VO_GILA_BOSS_52h_Male_Human_HeroPower_03	แค่ปรับตัวตาม[b]สภาพแวดล้อมน่ะ	
VO_GILA_BOSS_52h_Male_Human_HeroPower_04	แค่คราบเขม่าเอง	
VO_GILA_BOSS_52h_Male_Human_HeroPower_05	เพิ่มพลัง!	
VO_GILA_BOSS_52h_Male_Human_IntroALT_02	ตีนแมวเหรอ! ข้าเนี่ยนะ! ไม่ใช่หรอก...	
VO_GILA_BOSS_52h2_Male_Worgen_EmoteResponse_02	ดูสิว่าเจ้าทำให้ข้า[b]กลายเป็นอะไร!	
VO_GILA_BOSS_52h2_Male_Worgen_HeroPower_01	<เสียงหอน>	
VO_GILA_BOSS_52h2_Male_Worgen_HeroPower_02	เล่นมันเลย!	
VO_GILA_BOSS_52h2_Male_Worgen_HeroPower_03	นี่แหละสัตว์ร้าย[b]ในตัวข้า!	
VO_GILA_BOSS_54h_Male_Golem_DefeatPlayer_01	บิดงอแตกหัก ละเอียดแหลกเละ	
VO_GILA_BOSS_54h_Male_Golem_EmoteResponse_01	พูดมาเลย ข้าทนได้	
VO_GILA_BOSS_54h_Male_Golem_HeroPower_01	ทุกสิ่งเป็นของป่า	
VO_GILA_BOSS_54h_Male_Golem_HeroPower_02	วิทช์วู้ดแผ่ขยาย	
VO_GILA_BOSS_54h_Male_Golem_HeroPower_03	ทำลายผืนดิน แพร่เมล็ดพันธุ์	
VO_GILA_BOSS_54h_Male_Golem_HeroPower_04	พลังของฮากาธา[b]ช่วยให้เราแกร่งขึ้น	
VO_GILA_BOSS_54h_Male_Golem_HeroPower_05	ตามบัญชาฮากาธา	
VO_GILA_BOSS_54h_Male_Golem_Intro_01	หินกลิ้งไม่มี[b]ตะไคร่เกาะ	
VO_GILA_BOSS_55h_Female_NightElf_Death_01	แล้วใครจะช่วย[b]พวกเขาล่ะ	
VO_GILA_BOSS_55h_Female_NightElf_DefeatPlayer_01	ชู่ว เงียบก่อน ข้าจะส่งวิญญาณ[b]เจ้าให้พ้นอันตราย...	
VO_GILA_BOSS_55h_Female_NightElf_EmoteResponse_01	จุ๊ จุ๊ จุ๊! เดี๋ยว[b]พวกวิสพ์ได้ยินนะ	
VO_GILA_BOSS_55h_Female_NightElf_EventAssimilation_01	ทุกสิ่งของเจ้า[b]จะเป็นของเรา	
VO_GILA_BOSS_55h_Female_NightElf_EventAssimilation_02	ร่างของมัน ยึดมาเลย!	
VO_GILA_BOSS_55h_Female_NightElf_EventAssimilation_03	โอกาสของเรามาแล้ว!	
VO_GILA_BOSS_55h_Female_NightElf_EventKillsWisp_02	ไม่!	
VO_GILA_BOSS_55h_Female_NightElf_EventKillsWisp_03	หยุด!	
VO_GILA_BOSS_55h_Female_NightElf_EventKillsWisp_04	ลูกข้า!	
VO_GILA_BOSS_55h_Female_NightElf_EventPlayCartographer_01	นักทำแผนที่! นางต้องรู้จัก[b]ทางออกแน่	
VO_GILA_BOSS_55h_Female_NightElf_EventPlayCompass_01	นั่นอาจช่วยเรา[b]หาทางออกได้	
VO_GILA_BOSS_55h_Female_NightElf_HeroPower_01	มาเถอะ เด็กๆ	
VO_GILA_BOSS_55h_Female_NightElf_HeroPower_02	อ้าว อยู่นี่เอง	
VO_GILA_BOSS_55h_Female_NightElf_HeroPower_03	ออกมา ออกมา...	
VO_GILA_BOSS_55h_Female_NightElf_Intro_01	คำสาปของ[b]ฮากาธากลืนกิน[b]ทุกสิ่ง ข้าต้อง[b]ช่วยเหลือลูกๆ!	
VO_GILA_BOSS_56h_Male_Elemental_DefeatPlayer_01	ทำไมหน้าเศร้า[b]อย่างนั้นล่ะ เอ้อ ช่างเถอะ 	
VO_GILA_BOSS_56h_Male_Elemental_EmoteResponse_01	ข้าก็คิดเหมือนเจ้าเป๊ะเลย	
VO_GILA_BOSS_56h_Male_Elemental_EventTransformFace_02	อา หน้ากากแสนสวย	
VO_GILA_BOSS_56h_Male_Elemental_HeroPower_01	หน้ากากเปลี่ยน หน้าเปลี่ยน	
VO_GILA_BOSS_56h_Male_Elemental_HeroPower_02	หน้าเปลี่ยน นิสัยเปลี่ยน	
VO_GILA_BOSS_56h_Male_Elemental_HeroPower_03	นิสัยเปลี่ยน ชีวิตเปลี่ยน	
VO_GILA_BOSS_56h_Male_Elemental_HeroPower_05	เปลี่ยนแปลงเสมอ แตกต่างเสมอ	
VO_GILA_BOSS_56h_Male_Elemental_HeroPower_07	ทุกคนคือเรา เราคือทุกคน	
VO_GILA_BOSS_56h_Male_Elemental_HeroPower_09	เจ้าจำได้ไหม[b]ว่าตัวเองเป็นใคร	
VO_GILA_BOSS_56h_Male_Elemental_HeroPower_10	ใส่หน้ากากกันดีกว่า	
VO_GILA_BOSS_56h_Male_Elemental_IntroALT_02	เจ้ากับข้า เราไม่ต่างกันเลย	
VO_GILA_BOSS_57h_Male_Undead_DefeatPlayer_01	เดี๋ยวเจ้าก็ฟื้น อีกไม่นาน 	
VO_GILA_BOSS_57h_Male_Undead_EmoteResponse_01	ข้าจะบอก[b]นายหญิงว่า[b]เจ้าฝากความ[b]ปรารถนาดีมาให้	
VO_GILA_BOSS_57h_Male_Undead_EventDesecrate_01	ขอให้มีโรคภัยไข้เจ็บ	
VO_GILA_BOSS_57h_Male_Undead_EventDesecrate_02	เตรียมหลุมศพไว้ได้เลย	
VO_GILA_BOSS_57h_Male_Undead_EventDesecrate_03	มันติดต่อได้นะ	
VO_GILA_BOSS_57h_Male_Undead_EventDesecrate_04	เดี๋ยวเจ้าก็ได้ไป[b]อยู่กับพวกมัน	
VO_GILA_BOSS_57h_Male_Undead_EventPlayHolyBook_01	ตำรานั่นช่วย[b]เจ้าไม่ได้หรอก!	
VO_GILA_BOSS_57h_Male_Undead_EventShallowGraves_01	ลุกขึ้น!	
VO_GILA_BOSS_57h_Male_Undead_EventShallowGraves_02	กลับมา!	
VO_GILA_BOSS_57h_Male_Undead_EventShallowGraves_03	นายหญิงเรียกแล้ว!	
VO_GILA_BOSS_57h_Male_Undead_HeroPower_01	ขุดศพ	
VO_GILA_BOSS_57h_Male_Undead_HeroPower_02	ทำลายซาก	
VO_GILA_BOSS_57h_Male_Undead_HeroPower_03	สูดควันเข้าไป	
VO_GILA_BOSS_57h_Male_Undead_HeroPower_04	โรคร้ายระบาด	
VO_GILA_BOSS_57h_Male_Undead_Intro_01	ยินดีต้อนรับ! มาดูสิว่าข้า[b]ขุดเจออะไร	
VO_GILA_BOSS_58h_Male_Giant_Death_01	<ตาย>	
VO_GILA_BOSS_58h_Male_Giant_DefeatPlayer_01	เมืองนี้น่าอยู่ และน่าเหยียบ!	
VO_GILA_BOSS_58h_Male_Giant_DefeatPlayer_02	พร้อมย่ำราตรีแล้ว!	
VO_GILA_BOSS_58h_Male_Giant_EmoteResponse_01	ข้าจะเหยียบเจ้า!	
VO_GILA_BOSS_58h_Male_Giant_EventBigWeapon_01	ชอบทุบเหมือนกันเหรอ	
VO_GILA_BOSS_58h_Male_Giant_EventMinionReturn_01	เจอตัวแล้ว!	
VO_GILA_BOSS_58h_Male_Giant_EventMinionReturn_02	เจ้ากลับมาแล้ว!	
VO_GILA_BOSS_58h_Male_Giant_EventMinionReturn_03	เจอกันอีกแล้ว	
VO_GILA_BOSS_58h_Male_Giant_HeroPower_01	หนีเร็ว!	
VO_GILA_BOSS_58h_Male_Giant_HeroPower_02	เอ่อ...บู!	
VO_GILA_BOSS_58h_Male_Giant_HeroPower_03	ไปซ่อนอยู่ไหนกันหมด!	
VO_GILA_BOSS_58h_Male_Giant_HeroPower_04	ฟี-ไฟ-โฟ-กรัม	
VO_GILA_BOSS_58h_Male_Giant_HeroPower_05	หนีไปเถอะ ข้าจะตามหา... ไม่เจอ!	
VO_GILA_BOSS_58h_Male_Giant_Intro_01	เย้ ทุบ!	
VO_GILA_BOSS_59h_Male_Undead_DefeatPlayer_01	สุดท้าย เจ้าก็ไม่ต่างอะไร[b]กับหมาข้างถนน	
VO_GILA_BOSS_59h_Male_Undead_DefeatPlayer_02	ลาก่อน สหายเก่า	
VO_GILA_BOSS_59h_Male_Undead_DefeatPlayer_03	นี่เหรอนักฆ่า[b]ที่จะมาเอาชีวิตข้า ตลกสิ้นดี	
VO_GILA_BOSS_59h_Male_Undead_EmoteResponse_01	เอาปืนใหญ่มา[b]ใช้ดวลปืนเหรอ ขี้ขลาดสิ้นดี	
VO_GILA_BOSS_59h_Male_Undead_EventDeadlyShot_01	เข้าเป้า!	
VO_GILA_BOSS_59h_Male_Undead_EventDeadlyShot_02	อะไร นี้เขาเรียกการุณยฆาต	
VO_GILA_BOSS_59h_Male_Undead_EventQuickShot_01	ลูกเล่นของข้า[b]ยังไม่หมดแค่นี้หรอก	
VO_GILA_BOSS_59h_Male_Undead_EventQuickShot_02	ชักปืน!	
VO_GILA_BOSS_59h_Male_Undead_EventTurn02_01	ข้านี่แหละที่บอกให้[b]เกรย์เมนขังลืมเจ้า โครวลีย์	
VO_GILA_BOSS_59h_Male_Undead_HeroPowerKills_01	ชวนให้ข้า[b]คิดถึงอดีตจริงๆ	
VO_GILA_BOSS_59h_Male_Undead_HeroPowerKills_02	เกือบลืมไปแล้ว[b]ว่ามันรู้สึกดีแค่ไหน!	
VO_GILA_BOSS_59h_Male_Undead_HeroPowerKills_03	ฮ่าฮ่าฮ่าฮ่า	
VO_GILA_BOSS_59h_Male_Undead_HeroPowerKills_04	ฮ่าฮ่าฮ่า! เห็นโลก[b]ลุกเป็นไฟ[b]แล้วสุขใจจริงๆ	
VO_GILA_BOSS_59h_Male_Undead_HeroPowerKills_05	ถ้าข้าทำแบบนี้[b]กับวอร์เก้นทุกตัว[b]ได้ก็คงดี	
VO_GILA_BOSS_59h_Male_Undead_Intro_01	การเดินทาง[b]ของเจ้าจบลง[b]พร้อมความทรมาน!	
VO_GILA_BOSS_59h_Male_Undead_IntroCrowley_01	เจ้าไม่มีสิทธิ์[b]พูดถึงความภักดี โครวลีย์ 	
VO_GILA_BOSS_60h_Male_HumanGhost_Death_02	คลื่นซัด... ออกทะเล...	
VO_GILA_BOSS_60h_Male_HumanGhost_DefeatPlayer_01	ขอต้อนรับขึ้นเรือ ตลอดกาล!	
VO_GILA_BOSS_60h_Male_HumanGhost_EmoteResponseTess_01	เจ้าน่าจะหัด[b]เชื่อเรื่องผีบ้างนะ แม่สาวน้อย	
VO_GILA_BOSS_60h_Male_HumanGhost_EventBigWeapon_01	ทั้งสวยทั้งคม	
VO_GILA_BOSS_60h_Male_HumanGhost_EventBigWeapon_02	สวยจริงๆ เลยเชียว	
VO_GILA_BOSS_60h_Male_HumanGhost_EventBigWeapon_03	เคยเห็นดาบ[b]เล่มไหนสวย[b]ขนาดนี้ไหม	
VO_GILA_BOSS_60h_Male_HumanGhost_EventPlayerKingsblade_01	อะไรกัน... มีมากกว่า[b]หนึ่งงั้นเรอะ	
VO_GILA_BOSS_60h_Male_HumanGhost_EventPlayKingsblade_01	ข้าท่องไปทั่วโลก[b]เพื่อตามหามัน	
VO_GILA_BOSS_60h_Male_HumanGhost_EventPlayKingsblade_02	มันกลับมา[b]หาข้าเสมอ	
VO_GILA_BOSS_60h_Male_HumanGhost_EventPlayKragg_02	ทิ้งทะเลไปหา[b]ท้องฟ้าเรอะ งี่เง่าที่สุด	
VO_GILA_BOSS_60h_Male_HumanGhost_EventPlayPatches_02	แพทเชส! เสียตาไป[b]หลายดวงนะเพื่อน!	
VO_GILA_BOSS_60h_Male_HumanGhost_EventPlayTuskarrRaider_01	เดี๋ยวนี้ใครๆ ก็เป็นโจรสลัดได้	
VO_GILA_BOSS_60h_Male_HumanGhost_EventTurn2_01	ข้าจะแก้แค้น\nด้วยการจับเจ้า\nมาเป็นลูกเรือนี่แหละ	
VO_GILA_BOSS_60h_Male_HumanGhost_HeroPower_01	ดาบข้าขับขาน และข้าร้องตอบ!	
VO_GILA_BOSS_60h_Male_HumanGhost_HeroPower_07	ร้องกลบเสียงคลื่นไปเลย!	
VO_GILA_BOSS_60h_Male_HumanGhost_IntroTess_01	เฮ้ย! นี่มันลูกสาวราชา[b]ที่เล่นงานเรานี่หว่า 	
VO_GILA_BOSS_61h_Female_Orc_DefeatPlayer_01	ข้าเป็นหนึ่งเดียวกับป่า และข้าไม่มีวันตาย	
VO_GILA_BOSS_61h_Female_Orc_EmoteResponse_01	มองเงาสะท้อน[b]ของเจ้าสิ นั่นแหละคือ[b]ผู้นำจุดจบมาสู่เจ้า	
VO_GILA_BOSS_61h_Female_Orc_EmoteResponseCrowley_01	เจ้าทำอะไรผิด[b]ถึงต้องชดใช้ โครวลีย์	
VO_GILA_BOSS_61h_Female_Orc_EmoteResponseShaw_01	เห่าอยู่นั่นแหละ หมาเจ้าก็น่ารำคาญพอกัน	
VO_GILA_BOSS_61h_Female_Orc_EmoteResponseTess_01	พ่อแม่เจ้าเคย[b]รักลูกคนไหนบ้างไหม	
VO_GILA_BOSS_61h_Female_Orc_EmoteResponseToki_01	เจ้าหนีโนมแนปเปอร์[b]มาได้ยังไง	
VO_GILA_BOSS_61h_Female_Orc_EventCannonKill_01	ขอสาปแช่ง[b]ไอ้ปืนใหญ่บ้านั่น!	
VO_GILA_BOSS_61h_Female_Orc_EventCannonKill_02	เจ้าส่งเสียงดัง ไม่ฉลาดเลย	
VO_GILA_BOSS_61h_Female_Orc_EventCannonKill_03	เหล็กย่อมมีวันสลาย ไม่ต่างจากเนื้อหนัง	
VO_GILA_BOSS_61h_Female_Orc_EventCannonKill_04	เห่าดังเหลือเกินนะ เจ้าหมา	
VO_GILA_BOSS_61h_Female_Orc_EventCrowleyHagathaLow_01	ข้าไม่มีวันตาย ตราบใดที่ป่ายังอยู่...	
VO_GILA_BOSS_61h_Female_Orc_EventCrowleyLow_01	ข้าจะฝังเจ้า[b]ไปพร้อมปืนใหญ่เลย โครวลีย์	
VO_GILA_BOSS_61h_Female_Orc_EventCrowleyTurn2_01	เจ้าละทิ้งดินแดนแห่งนี้! ข้ากอบกู้มันกลับมา!	
VO_GILA_BOSS_61h_Female_Orc_EventCrowleyTurn4_01	เจ้ามันเป็นพวกนอกคอก แม้แต่ในหมู่พวกเจ้าเอง	
VO_GILA_BOSS_61h_Female_Orc_EventShawHoundKill_01	หมาเลว	
VO_GILA_BOSS_61h_Female_Orc_EventShawHoundKill_02	ไอ้หมาบ้า	
VO_GILA_BOSS_61h_Female_Orc_EventShawLow_01	คำสาปแห่งวิทช์วู้ด[b]จะพรากชีวิตเจ้า	
VO_GILA_BOSS_61h_Female_Orc_EventShawTurn2_01	สิ่งมีชีวิตทั้งหมด[b]ในป่าจะเป็นของข้า…	
VO_GILA_BOSS_61h_Female_Orc_EventShawTurn2_02	ทันทีที่พวกมันได้[b]ลิ้มรสพลังของข้า	
VO_GILA_BOSS_61h_Female_Orc_EventShawTurn4_01	วิญญาณมืดนับไม่ถ้วน[b]เรียงแถวรอเล่นงานเจ้า 	
VO_GILA_BOSS_61h_Female_Orc_EventSummonCrowskin_01	ลัทธิของข้าไม่มีวันตาย	
VO_GILA_BOSS_61h_Female_Orc_EventSummonGodfrey_01	ก็อดเฟรย์ วิญญาณแห่งป่า[b]เรียกเจ้ากลับมา...	
VO_GILA_BOSS_61h_Female_Orc_EventTessHagathaLow_01	ข้านี่แหละคือป่า	
VO_GILA_BOSS_61h_Female_Orc_EventTessLow_01	ซากศพของเจ้า[b]จะเป็นอาหาร[b]ของป่าแห่งนี้	
VO_GILA_BOSS_61h_Female_Orc_EventTessScavenges_01	ไม่มีอะไรช่วยเจ้าได้หรอก	
VO_GILA_BOSS_61h_Female_Orc_EventTessScavenges_02	ขุดหาไปเถอะ องค์หญิง	
VO_GILA_BOSS_61h_Female_Orc_EventTessScavenges_03	คุ้ยกองขยะอยู่เหรอ	
VO_GILA_BOSS_61h_Female_Orc_EventTessScavenges_04	พุ่มไม้ใบหญ้า[b]ล้วนไม่ต้อนรับเจ้า	
VO_GILA_BOSS_61h_Female_Orc_EventTessTurn2_01	ป่าแห่งนี้จะ[b]กลืนกิน[b]เมืองของเจ้า 	
VO_GILA_BOSS_61h_Female_Orc_EventTessTurn4_01	ดินแดนนี้ตายไปแล้ว! ข้ามอบชีวิตใหม่ให้มัน มันเป็นของข้า	
VO_GILA_BOSS_61h_Female_Orc_EventTokiHagathaLow_01	วิญญาณของป่านี้[b]จะปกป้องข้า...	
VO_GILA_BOSS_61h_Female_Orc_EventTokiHeroPower_01	...เกิดอะไรขึ้น	
VO_GILA_BOSS_61h_Female_Orc_EventTokiHeroPower_03	ย่ามใจเกินไปแล้ว	
VO_GILA_BOSS_61h_Female_Orc_EventTokiHeroPower_04	วิญญาณรู้ว่า[b]เจ้าทำอะไร 	
VO_GILA_BOSS_61h_Female_Orc_EventTokiHeroPower_05	สักวันลูกเล่น[b]ของเจ้าจะย้อนกลับ[b]มาทำร้ายเจ้า	
VO_GILA_BOSS_61h_Female_Orc_EventTokiLow_01	เจ้าหมดทางสู้แล้ว เจ้าโนม 	
VO_GILA_BOSS_61h_Female_Orc_EventTokiTurn2_01	เจ้าก็เป็นอสูรกาย[b]ไม่ต่างจากข้า เจ้าโนม	
VO_GILA_BOSS_61h_Female_Orc_EventTokiTurn4_01	เจ้าคิดว่าข้าไม่เห็น\nเครื่องจักรของเจ้า\nแต่ข้าเห็นทุกอย่าง 	
VO_GILA_BOSS_61h_Female_Orc_Intro_01	ข้าคือหัวใจ[b]ของป่าแห่งนี้	
VO_GILA_BOSS_61h_Female_Orc_IntroCrowley_01	ที่นี่คงเงียบสงบมาก[b]หลังจากทำลาย[b]ปืนใหญ่นั่นได้	
VO_GILA_BOSS_61h_Female_Orc_IntroShaw_01	ข้าจะควบคุม[b]หมาให้ขย้ำคอ[b]นายของมัน	
VO_GILA_BOSS_61h_Female_Orc_IntroTess_01	กลับไปซะ "องค์หญิง" บอกพ่อเจ้าด้วย[b]ว่าสิ้นหวังแล้ว	
VO_GILA_BOSS_61h_Female_Orc_IntroToki_01	เจ้าเปลี่ยนแปลง[b]โชคชะตาได้[b]แต่ต้นไม้และ[b]ดวงดาวไม่มีวันลืม	
VO_GILA_BOSS_62h_GustaveTheGutRipper_Emote	<เสียงคำราม>	
VO_GILA_BOSS_62h_GustaveTheGutRipper_Intro	<เสียงคำราม>	
VO_GILA_BOSS_62h_GustaveTheGutRipper_PlayerDefeat	<เสียงคำราม>	
VO_GILA_BOSS_63h_Female_Harpy_Death_01	ไข่... ของข้า...	
VO_GILA_BOSS_63h_Female_Harpy_DefeatPlayer_01	พี่น้องข้า! เก็บซากมันมา[b]ที่รังของข้าด้วย	
VO_GILA_BOSS_63h_Female_Harpy_EmoteResponse_01	คุยกันตอนนี้ก็\nไม่ทำให้ความสัมพันธ์\nของเราดีขึ้นหรอก 	
VO_GILA_BOSS_63h_Female_Harpy_HeroPower_01	ของข้า!	
VO_GILA_BOSS_63h_Female_Harpy_HeroPower_02	เวทมนตร์ของเจ้า[b]มีแต่จะทำให้ป่ามืดมน	
VO_GILA_BOSS_63h_Female_Harpy_HeroPower_03	เจ้าโง่ ข้ามีแต่จะแข็งแกร่งขึ้น 	
VO_GILA_BOSS_63h_Female_Harpy_Intro_01	หยุดเดี๋ยวนี้ ฮากาธาสั่งห้ามเจ้า!	
VO_GILA_BOSS_64h_Male_Goblin_Death_01	เดี๋ยวสิ!	
VO_GILA_BOSS_64h_Male_Goblin_DefeatPlayer_01	ขอบคุณ ขอบคุณ! มาคุยเรื่อง[b]ค่าจ้างกันดีกว่า...	
VO_GILA_BOSS_64h_Male_Goblin_EmoteResponse_01	ข้าชอบให้ผู้ชม[b]มีส่วนร่วมจริงๆ เลย	
VO_GILA_BOSS_64h_Male_Goblin_EvenPlayCursedCurio_01	สวยมาก! ไปหามาจากไหนน่ะ	
VO_GILA_BOSS_64h_Male_Goblin_EventMCTech_01	โว้ว นั่นมันลูกเล่น[b]ของข้านะ!	
VO_GILA_BOSS_64h_Male_Goblin_EventMindControl_01	คิดจะข่มข้างั้นเหรอ	
VO_GILA_BOSS_64h_Male_Goblin_HeroPowerHandBig_01	เจ้าเริ่มรู้สึกง่วงแล้ว	
VO_GILA_BOSS_64h_Male_Goblin_HeroPowerHandBig_03	เปลือกตาเจ้าหนักมาก จนแทบลืมตาไม่ขึ้น!	
VO_GILA_BOSS_64h_Male_Goblin_HeroPowerHandEmpty_01	Zzzz... Zzzz...	
VO_GILA_BOSS_64h_Male_Goblin_HeroPowerHandMedium_01	มองตาข้าสิ	
VO_GILA_BOSS_64h_Male_Goblin_HeroPowerHandMedium_02	มองตามนาฬิกา... เดี๋ยวนะ... ในหนังสือบอกว่ายังไงต่อ	
VO_GILA_BOSS_64h_Male_Goblin_HeroPowerHandMedium_03	มองมันแกว่งนะ ซ้าย-ขวา ซ้าย-ขวา!	
VO_GILA_BOSS_64h_Male_Goblin_HeroPowerHandSmall_01	เมื่อกี้ข้าทำอะไรอยู่นะ	
VO_GILA_BOSS_64h_Male_Goblin_HeroPowerHandSmall_02	เจ้าจะรู้สึก... ง่วงนอน	
VO_GILA_BOSS_64h_Male_Goblin_Intro_01	โอ้! อาสาสมัครเหรอ 	
VO_GILA_BOSS_66h_Female_Undead_DefeatPlayer_01	…	
VO_GILA_BOSS_66h_Female_Undead_EmoteResponse_02	…	
VO_GILA_BOSS_66h_Female_Undead_EventPlayHorn_02	…	
VO_GILA_BOSS_66h_Female_Undead_HeroPower_01	…	
VO_GILA_BOSS_66h_Female_Undead_HeroPower_02	…	
VO_GILA_BOSS_66h_Female_Undead_HeroPower_03	…	
VO_GILA_BOSS_66h_Female_Undead_Intro_01	…	
VO_GILA_BOSS_67h_Male_Undead_DefeatPlayer_01	ชีวิตไม่ต่างอะไร[b]จากสนามแข่งหนู	
VO_GILA_BOSS_67h_Male_Undead_EmoteResponse_01	เลิกส่งเสียงจี๊ดๆ ได้แล้ว!	
VO_GILA_BOSS_67h_Male_Undead_EventPlayRat_01	พวกมันน่ารักใช่ไหมล่ะ ยิ่งอยู่ในชามสตูว์ยิ่งน่ารัก	
VO_GILA_BOSS_67h_Male_Undead_EventPlayRat_02	กระจ้อยร่อยเหลือเกิน เหมือนเจ้าเลย	
VO_GILA_BOSS_67h_Male_Undead_EventPlayRat_03	ระวังนะ รอยพวกนั้น[b]ไม่ใช่รอยจูบหรอก	
VO_GILA_BOSS_67h_Male_Undead_EventPlayRatTrap_01	กล่องกับแท่งไม้เหรอ ไม่เนียนเลย!	
VO_GILA_BOSS_67h_Male_Undead_Intro_01	จับได้แล้ว! จมูกข้าไวต่อกลิ่นหนู[b]นะจะบอกให้	
VO_GILA_BOSS_68h_Male_Undead_DefeatPlayer_01	เจ้าทนได้นานมาก! นี่จะเป็นกรณีศึกษาที่ดีแน่	
VO_GILA_BOSS_68h_Male_Undead_EmoteResponse_01	เจ้ารู้หรือเปล่าว่า[b]โรคระบาดน่ะ[b]สร้างยากแค่ไหน	
VO_GILA_BOSS_68h_Male_Undead_EventPlayPoison_01	นำหน้าข้าไปแล้ว	
VO_GILA_BOSS_68h_Male_Undead_EventPlayPoison_02	โอ้ พิษ!	
VO_GILA_BOSS_68h_Male_Undead_EventPlayPoison_03	ข้าชอบวิธีคิดของเจ้า	
VO_GILA_BOSS_68h_Male_Undead_EventPlayPoison_04	ขอยืมได้ไหม แค่เดี๋ยวเดียวเอง	
VO_GILA_BOSS_68h_Male_Undead_Intro_01	ลากศพออกมา! ข้าต้องใช้	
VO_HeadlessHorseman_Male_Human_HallowsEve_01	ข้าอยู่ตรงนี้ เจ้าร่างกายไม่รักดี!	
VO_HeadlessHorseman_Male_Human_HallowsEve_02	สุนัขน่าชังคือตัวเจ้า! จงเตรียมตัวถูกไฟเผา!	
VO_HeadlessHorseman_Male_Human_HallowsEve_04	ท้องฟ้ามืดมิด[b]เพลิงเผาเป็นจุล[b]ทุกสิ่งไร้ค่าเมื่อ[b]กงล้อแห่งชะตาหมุน	
VO_HeadlessHorseman_Male_Human_HallowsEve_07	เพลิงข้ามอดหมด[b]ไม่เหลือฤทธิ์![b]ข้าจะส่งเจ้าสู่นรกมืดมิด!	
VO_HeadlessHorseman_Male_Human_HallowsEve_08	หากเจ้าปรารถนา[b]ให้ข้าหลั่งโลหิต[b]ต้องจัดการหัวข้า[b]ถึงจะสิ้นชีวิต!	
VO_HeadlessHorseman_Male_Human_HallowsEve_10	ฮ่าฮ่าฮ่าฮ่าฮ่า อ๊าฮ่าฮ่าาาาา!	
VO_HeadlessHorseman_Male_Human_HallowsEve_11	อ๊าาาฮ่าฮ่าฮ่า ฮ่าฮ่าฮ่า!	
VO_HeadlessHorseman_Male_Human_HallowsEve_12	เตรียมตัวให้พร้อมระฆัง[b]ดังเป็นสัญญาณ จงให้เ[b]ด็ก คนป่วย และคนชราเข้าบ้าน!	
VO_HeadlessHorseman_Male_Human_HallowsEve_13	พวกเจ้าทุกคนต้อง[b]ชดใช้อย่างถ้วนหน้า[b]จงคุกเข่าอ้อนวอน[b]รับการพิพากษา!	
VO_HeadlessHorseman_Male_Human_HallowsEve_17	ฮ่าฮ่าฮ่าฮ่าฮ่าฮ่า....	
VO_HRW_DEBUG_01	1	
VO_HRW_DEBUG_02	2	
VO_HRW_DEBUG_03	3	
VO_HRW_DEBUG_04	4	
VO_HRW_DEBUG_05	5	
VO_HRW_TEST_00	ข้าจะปลดปล่อยเจ้าทั้งคู่จากคำสาปร่างเนื้อเอง!	
VO_HRW_TEST_01	Well done! You've defeated the boss together.\n\nBoth players win!	
VO_HRW_TEST_02	ร่วมมือกันปราบเจ้าแห่งเฟือง เมคาซ็อดเพื่อคว้าชัยชนะ!	
VO_HRW_TEST_ABILITY_00	Damaging a hero.	
VO_HRW_TEST_ABILITY_01	Destroying highest attack minion.	
VO_HRW_TEST_ABILITY_02	Throwing 3 bombs.	
VO_HRW_TEST_ABILITY_03	Damaging both players	
VO_HRW_TEST_ABILITY_04	Emergency! Release Coolant!	
VO_HRW_TEST_ABILITY_05	เร่งความเร็วระบบ!	
VO_HRW_TEST_ABILITY_06	เขาเลิกอ่านหนังสือกันแล้ว ลอร์วอล์คเกอร์ โช!	
VO_HRW_TEST_ABILITY_98	Target board full. Clearing target board.	
VO_ICC_841_Female_Sanlayn_Death_02	แต่เราเข้ากันได้ดีจะตายไป!   	
VO_ICC01_Jaina_Female_Human_DrawsRager_01	นี่ล้อกันเล่นหรือเปล่า!?	
VO_ICC01_Jaina_Female_Human_JainaDKIntro_05	ข้าได้ยินเสียงกระซิบ... ของคนตาย	
VO_ICC01_Jaina_Female_Human_PostDeath_02	เราต้อง... ไม่ยอม...	
VO_ICC01_LichKing_Male_Human_EmoteResponse_01	เสียงอ้อนวอนของเจ้า\nส่งไปไม่ถึงหรอก	
VO_ICC01_LichKing_Male_Human_EndOfTurn2_01	ฮ่าฮ่าฮ่า – นี่แหละเทิร์นแรกของข้า!	
VO_ICC01_LichKing_Male_Human_EndOfTurn2_02	นี่ข้ายังไม่ได้ใช้\nเด็คสายบุกเลยด้วยซ้ำ 	
VO_ICC01_LichKing_Male_Human_Idle_01	เอาเลย จบเทิร์นสิ ข้าจะได้จบชีวิตเจ้า!	
VO_ICC01_LichKing_Male_Human_Intro_01	เลือกการ์ดให้ดีๆ\nนี่แหละคือเทิร์นสุดท้ายของเจ้า	
VO_ICC01_LichKing_Male_Human_JainaDKIntro_01	จงลุกขึ้น เมจ งานของเจ้ายังไม่เสร็จสิ้น 	
VO_ICC01_LichKing_Male_Human_JainaDKIntro_02	จงรับใช้ข้า คนเป็นจะต้องหวาดผวา และคนตายจะต้องเชื่อฟัง	
VO_ICC01_LichKing_Male_Human_JainaDKIntro_03	ศัตรูจะกลัวเจ้าเสียยิ่งกว่ากลัวความตาย...	
VO_ICC01_LichKing_Male_Human_JainaDKintro_06	เอาล่ะ ผู้กล้า[b]กำจัดเจ้าคนไร้ค่า[b]นี่ให้พ้นหน้าข้าซะ	
VO_ICC01_LichKing_Male_Human_PlaysFrostmourne_01	อันดับของเจ้าจะต้องตกฮวบ	
VO_ICC01_LichKing_Male_Human_Turn1_01	ข้าได้การ์ดดีจริงๆ…	
VO_ICC01_LichKing_Male_Human_Turn11_01	ข้าจะมอบ[b]กองทัพอันเดดของข้า[b]ให้เจ้าบัญชาการ	
VO_ICC01_LichKing_Male_Human_Turn13_01	ทรมานพวกมัน	
VO_ICC01_LichKing_Male_Human_Turn15_01	เมตตาคือความอ่อนแอ	
VO_ICC01_LichKing_Male_Human_Turn2_02	นี่คือพลังของข้า	
VO_ICC01_LichKing_Male_Human_Turn4_01	ไม่มีใครช่วยเจ้าได้	
VO_ICC01_LichKing_Male_Human_Turn4_02	พลังของข้าคือที่สุด	
VO_ICC01_LichKing_Male_Human_Turn5_01	ไม่มีใครต่อต้านข้าได้	
VO_ICC01_LichKing_Male_Human_Turn5_02	จงมารับใช้ข้า 	
VO_ICC01_Tirion_Male_Human_AFKay_01	สนใจหน่อย! 	
VO_ICC01_Tirion_Male_Human_EmoteResponse_02	ข้าไม่รู้จักเจ้าอีกต่อไปแล้ว!	
VO_ICC01_Tirion_Male_Human_EndOfTurn4_01	ช้าก่อน ผู้กล้า! 	
VO_ICC01_Tirion_Male_Human_EndOfTurn4_02	ข้าเชื่อว่าเบื้องบนจะมอบพลังอันยิ่งใหญ่ให้เจ้าในยามคับขัน	
VO_ICC01_Tirion_Male_Human_EndOfTurn4_03	จงเชื่อว่าเบื้องบนจะมอบ[b]พลังอันยิ่งใหญ่ให้เจ้า[b]ในยามคับขัน	
VO_ICC01_Tirion_Male_Human_Flavor01_01	ข้าคงต้องหานักผจญภัย\nที่ได้เรื่องได้ราวกว่านี้…	
VO_ICC01_Tirion_Male_Human_Flavor02_01	เจน่า เจ้ากลายเป็นอสูรร้ายไปแล้ว!	
VO_ICC01_Tirion_Male_Human_Flavor03_01	ลิชคิงจะต้องชดใช้ต่อความโหดเหี้ยมนี้! 	
VO_ICC01_Tirion_Male_Human_JainaDKintro_05	นี่มันอะไรกัน? เจ้ากลายเป็นตัวอะไร!?	
VO_ICC01_Tirion_Male_Human_PauseDeath_02	อยู่เฉยๆ!	
VO_ICC01_Tirion_Male_Human_PostDeath_01	ผู้กล้า จิตใจเจ้าเป็นของเจ้า จงต่อต้านเสียงเรียกของลิชคิง! 	
VO_ICC01_Tirion_Male_Human_TerribleTank_01	ดึงความสนใจมันไว้สิ	
VO_ICC01_Tirion_Male_Human_Turn2_01	อย่ากลัวเลย ผู้กล้า! เรากำลังไปช่วย	
VO_ICC01_Tirion_Male_Human_Turn3_01	เราใกล้ถึงแล้ว! สถานการณ์เป็นไงบ้าง? ไหวไหม?	
VO_ICC01_Tirion_Male_Human_Turn6_01	ผู้กล้า เราใกล้จะพร้อม-	
VO_ICC01_Tirion_Male_Human_Turn6_02	อะไรกัน!?	
VO_ICC01_Tirion_Male_Human_Turn8_01	นี่คือเหล่านักผจญภัย\nที่เก่งกาจที่สุดในอาเซรอธ!	
VO_ICC04_LichKing_Male_Human_BreathNoMinion_01	ไม่มีมินเนี่ยนให้ซินดราโกซา\nแช่แข็งเลยเหรอ[b]เย็นชาจริงๆ	
VO_ICC04_LichKing_Male_Human_Lose_01	ซากศพแช่แข็งของเจ้าจะเป็นเครื่องเตือนใจคนอื่นๆ...	
VO_ICC04_LichKing_Male_Human_Turn5_01	เจ้าอาจสงสัยว่า[b]"ข้าจะกำจัดก้อนน้ำแข็ง[b]ได้ยังไง"	
VO_ICC04_LichKing_Male_Human_Turn5_02	คำตอบคือ: ไม่มีทาง!	
VO_ICC04_LichKing_Male_Human_Win_02	ข้าจะทำลายเด็คนี้ไม่ให้เหลือซาก! 	
VO_ICC04_Sindragosa_Female_Dragon_Bounce_01	เอามันกลับมา!	
VO_ICC04_Sindragosa_Female_Dragon_BreathNoRoomLeft_01	เจ้าไม่มีมินเนี่ยนเป็นเกราะกำบังแล้ว	
VO_ICC04_Sindragosa_Female_Dragon_Death_01	แฮรรรรรร่!	
VO_ICC04_Sindragosa_Female_Dragon_EmoteResponse_01	ข้าเบื่อจะเล่นเกมแล้ว!	
VO_ICC04_Sindragosa_Female_Dragon_Intro_01	เจ้าโง่เขลามากที่มาถึงที่นี่!	
VO_ICC04_Sindragosa_Female_Dragon_LichKing_01	ข้าถูกทรยศ!	
VO_ICC04_Sindragosa_Female_Dragon_Malygos_01	มาลิกอส... ที่รักของข้า!	
VO_ICC04_Sindragosa_Female_Dragon_PlayerPlaysMinion_02	เลือกเหยื่อของเจ้าดีๆ ล่ะ ไอเย็นมรณะจะสังหารพวกเจ้าทุกคน 	
VO_ICC04_Sindragosa_Female_Dragon_SecondBreath_01	จงรับรู้พลังและความสิ้นหวังไร้ขอบเขตของนายท่าน	
VO_ICC04_Sindragosa_Female_Dragon_Sindragosa_01	เวทมนตร์น่ารังเกียจทรยศเราแล้ว!	
VO_ICC04_Sindragosa_Female_Dragon_Sindragosa_02	เวทมนตร์น่ารังเกียจทรยศเราแล้ว!	
VO_ICC04_Sindragosa_Female_Dragon_TransformDK_01	ข้ารับใช้นายเพียงหนึ่งเดียว!	
VO_ICC04_Sindragosa_Female_Dragon_UnchainedMagic_02	เวทมนตร์น่ารังเกียจ[b]จะทรยศเจ้า!	
VO_ICC04_Sindragosa_Female_Dragon_UnchainedMagic_04	จงเจ็บปวด!	
VO_ICC05_Lanathel_Female_Sanlayn_BiteOoze_01	โอย กล้ากินของแบบนั้นด้วยเหรอ	
VO_ICC05_Lanathel_Female_Sanlayn_BitePoisonous_01	กินเสร็จแล้วคายพิษทิ้งด้วยล่ะ	
VO_ICC05_Lanathel_Female_Sanlayn_BiteReminder_01	ลืมอะไรไปหรือเปล่า? ความหิวโหยแผดเผาเจ้าอยู่นะ!	
VO_ICC05_Lanathel_Female_Sanlayn_BiteReminderAcolyte_01	อย่าลังเลสิ ดื่มเข้าไป! ดื่มเลือดมินเนี่ยนหลับเลย!	
VO_ICC05_Lanathel_Female_Sanlayn_BiteShell_01	ระวังฟันหักนะ	
VO_ICC05_Lanathel_Female_Sanlayn_BiteSpikes_01	กัดไปคงเจ็บปากน่าดู	
VO_ICC05_Lanathel_Female_Sanlayn_BloodEssence_01	ท่าทางเจ้าจะมีเพื่อนเยอะไปแล้ว	
VO_ICC05_Lanathel_Female_Sanlayn_BloodEssence_02	ไม่นึกว่าจะเจออะไรอย่างนี้ใช่มั้ย	
VO_ICC05_Lanathel_Female_Sanlayn_BloodEssence_03	มาสนุกกันหน่อยดีมั้ย หืม?	
VO_ICC05_Lanathel_Female_Sanlayn_BloodPrince_01	คนทรยศ! ถอดเขี้ยวเล็บของเจ้าเดี๋ยวนี้!	
VO_ICC05_Lanathel_Female_Sanlayn_BossBite_01	ดูสิว่าข้าหิวแค่ไหน!	
VO_ICC05_Lanathel_Female_Sanlayn_EmoteResponse_01	นี่เจ้า… จีบข้ารึเปล่า?	
VO_ICC05_Lanathel_Female_Sanlayn_Intro_01	เจ้าเลือกได้… ไม่ฉลาด… เอาซะเลย	
VO_ICC05_Lanathel_Female_Sanlayn_LichKing_01	เจ้า...!	
VO_ICC05_Lanathel_Female_Sanlayn_PlayerBiteAcolyte_01	โอ้ ความย้อนแย้งอันแสนหวาน! 	
VO_ICC05_Lanathel_Female_Sanlayn_PlayerBloodBite_01	เจ้ามาช้าไป ข้าแพ้ไปแล้ว!	
VO_ICC05_Lanathel_Female_Sanlayn_TransformDK_01	เจ้าไม่ทำให้ข้าผิดหวังเลย	
VO_ICC05_Lanathel_Female_Sanlayn_Turn3_01	ดื่มเลือดมินเนี่ยนของข้าดูสิ	
VO_ICC05_Lanathel_Female_Sanlayn_Turn3_02	ทั้งไม่ขัดขืน... ทั้งอร่อย... แถมมีซอสให้จิ้มด้วย! 	
VO_ICC05_Lanathel_Female_Sanlayn_Wounded_01	เจ้ามีปัญญาทำได้แค่นี้เหรอ	
VO_ICC05_LichKing_Male_Human_BossBite_02	อา คมเขี้ยวแห่งซัน'เลย์น	
VO_ICC05_LichKing_Male_Human_BossBite_03	ควบคุมความหิวให้ดี เจ้าต้องดื่มเลือดทุกเทิร์น!	
VO_ICC05_LichKing_Male_Human_LichKing_02	ระวังบอสดุ	
VO_ICC05_LichKing_Male_Human_Lose_01	เจ้าไม่กล้าดูดเลือดมินเนี่ยนของตัวเองเหรอ ที่นี่ไอซ์คราวน์นะ ไม่ใช่อนุบาลหมีน้อย! 	
VO_ICC05_LichKing_Male_Human_Win_01	ลานา'เธล... เจ้าโชคดีมากที่ระดับนี้แพ้แล้วไม่เสียดาว	
VO_ICC06_LichKing_Male_Human_LichKing_02	อย่าถือสาเลยนะ แมโรว์การ์ 	
VO_ICC06_LichKing_Male_Human_Win_01	ข้าต้องสร้างปีศาจกระดูกตัวใหม่แล้ว สีทองน่าจะดี	
VO_ICC06_Marrowgar_Male_BoneWraith_Alexstraza_01	มันเลียข้า มังกรนั่นเลียข้า!	
VO_ICC06_Marrowgar_Male_BoneWraith_AncientOne_01	ข้าไม่เสียใจ!	
VO_ICC06_Marrowgar_Male_BoneWraith_AuchenaiSoulpriest_01	ฮ่าฮ่า ข้าได้นักบวชวิญญาณมาแล้ว ไม่ เดี๋ยว ไปซะ! ชิ่วๆ!	
VO_ICC06_Marrowgar_Male_BoneWraith_BigHeal_01	ความตายคือนิรันดร์ ไม่จบไม่สิ้น…	
VO_ICC06_Marrowgar_Male_BoneWraith_Bonespike_01	ทางรอดทางเดียวคือความตาย!	
VO_ICC06_Marrowgar_Male_BoneWraith_Bonespike_02	เจ้าจะต้องรับใช้นายท่าน	
VO_ICC06_Marrowgar_Male_BoneWraith_Bonespike_03	อ้อมกอดของข้า\nเฉือนเนื้อตัดกระดูก	
VO_ICC06_Marrowgar_Male_BoneWraith_Bonespike_04	ถึงเวลาสังหารแล้ว	
VO_ICC06_Marrowgar_Male_BoneWraith_Bonespike_05	ร้ายกาจมาก ดีงามมาก!	
VO_ICC06_Marrowgar_Male_BoneWraith_BonespikePlayerHit_01	โทสะของนายท่านไหลผ่านร่างข้า!!	
VO_ICC06_Marrowgar_Male_BoneWraith_BonespikeStolen_01	เจ้า… ขโมยกระดูก!	
VO_ICC06_Marrowgar_Male_BoneWraith_Bonestorm_01	โบนสตอร์ม!	
VO_ICC06_Marrowgar_Male_BoneWraith_Bonestorm_02	โบนนสตอร์ม!	
VO_ICC06_Marrowgar_Male_BoneWraith_Bonestorm_03	โบนนสตออร์ม!	
VO_ICC06_Marrowgar_Male_BoneWraith_Bonestorm_04	โบนสตอร์ม!	
VO_ICC06_Marrowgar_Male_BoneWraith_Bonestorm_05	โบนนสตออร์ม!	
VO_ICC06_Marrowgar_Male_BoneWraith_BonestormFast_01	โบนสตอร์ม	
VO_ICC06_Marrowgar_Male_BoneWraith_Death_01	เถ้าคืนสู่เถ้า…	
VO_ICC06_Marrowgar_Male_BoneWraith_DKTransform_01	ใช่แล้ว ยอมรับชะตากรรมซะ – ตอบรับเสียงเรียกของนายท่าน!	
VO_ICC06_Marrowgar_Male_BoneWraith_EmoteResponse_01	เจ้าโง่ ข้าไม่มีหู!	
VO_ICC06_Marrowgar_Male_BoneWraith_Idle_01	อืมมมม…	
VO_ICC06_Marrowgar_Male_BoneWraith_Intro_01	ห้ามใครรุกล้ำที่พำนัก\nของนายท่าน! 	
VO_ICC06_Marrowgar_Male_BoneWraith_LichKing_01	…นายท่าน?	
VO_ICC06_Marrowgar_Male_BoneWraith_Skeleton_01	ว่าไงเพื่อนกระดูกของข้า?	
VO_ICC07_LichKing_Male_Human_LichKing_02	ข้าชอบคุม[b]ลูกน้องด้วยตัวเอง	
VO_ICC07_LichKing_Male_Human_Lose_01	พิวทริไซด์ เด็คของเจ้าสกปรกมาก ข้าประเมินเจ้าต่ำไป	
VO_ICC07_LichKing_Male_Human_Win_02	พิวทริไซด์ น่าสมเพชจริงๆ เจ้าควรไปอยู่ในเด็คฮันเตอร์ ไม่ใช่ที่ซิทาเดลของข้า	
VO_ICC07_Putricide_Male_Undead_Aviana_01	ศาสตร์ของเจ้าดีกว่าของข้าซะอีก!	
VO_ICC07_Putricide_Male_Undead_CloakedHuntress_01	นี่มันออกจะเกินไปหน่อยนะ 	
VO_ICC07_Putricide_Male_Undead_Death_01	ข่าวร้าย ทุกคน…	
VO_ICC07_Putricide_Male_Undead_EaglehornBow_01	ขอให้ข้าบ้างได้ไหม	
VO_ICC07_Putricide_Male_Undead_EaterOfSecrets_01	ไม่! ความลับของข้า! งานทั้งชีวิตของข้า!	
VO_ICC07_Putricide_Male_Undead_EmoteResponse_01	นิสัยไม่ดีเลยนะ	
VO_ICC07_Putricide_Male_Undead_EquipWeapon_01	โอ้โห	
VO_ICC07_Putricide_Male_Undead_EquipWeapon_02	ข้ามีของแบบนี้ด้วยเหรอเนี่ย	
VO_ICC07_Putricide_Male_Undead_EquipWeapon_03	อืม ใช้ได้	
VO_ICC07_Putricide_Male_Undead_EquipWeapon_04	มาได้ยังไงน่ะ	
VO_ICC07_Putricide_Male_Undead_EquipWeapon_05	ร้ายกาจมาก ดีงามมาก!	
VO_ICC07_Putricide_Male_Undead_EtherealArcanist_01	อย่าไว้ใจผู้ไร้รูป ขนาดหน้าตายังไม่เคยเห็นด้วยซ้ำ!	
VO_ICC07_Putricide_Male_Undead_FestergutDeath_01	โธ่ เฟสเตอร์กัต เจ้าเป็นตัวโปรดของข้าเลยนะ... รองจากร็อตเฟซ	
VO_ICC07_Putricide_Male_Undead_Intro_02	ข่าวดีทุกคน! ข้าซ่อมท่อสไลม์พิษเสร็จแล้ว	
VO_ICC07_Putricide_Male_Undead_LichKing_01	โอ้ ไม่นึกเลยว่าจะเจอท่านที่นี่	
VO_ICC07_Putricide_Male_Undead_MysteriousChallenger_01	ไม่มีใครลึกลับกว่าข้าอีกแล้ว!	
VO_ICC07_Putricide_Male_Undead_Ooze_01	เอื๊อก เมือก!	
VO_ICC07_Putricide_Male_Undead_PhaseTransition_01	รยางค์! โอ้โห\nพวกมันมีความคิดเป็นของตัวเองด้วยนะเนี่ย	
VO_ICC07_Putricide_Male_Undead_PhaseTransition_03	อืมม น่าสนใจ	
VO_ICC07_Putricide_Male_Undead_Putricide_02	หา? นั่นมันข้าไม่ใช่เหรอ!	
VO_ICC07_Putricide_Male_Undead_Putricide_03	ข่าวดี...ตัวข้า!	
VO_ICC07_Putricide_Male_Undead_Putricide_04	ข่าวดีที่ไหนกันเล่า เจ้าตัวปลอมรยางค์ยุ่บยั่บ! 	
VO_ICC07_Putricide_Male_Undead_Rotface_01	ร็อตเฟซ! ทำไมทำแบบนี้!?	
VO_ICC07_Putricide_Male_Undead_RotfaceDeath_01	ไม่นะร็อตเฟซ! เขาไปทำอะไรให้เจ้าหรือไง!?	
VO_ICC07_Putricide_Male_Undead_Scientist_01	นี่เจ้าดึงตัวลูกน้องข้าไปเหรอ	
VO_ICC07_Putricide_Male_Undead_Slime_01	ข่าวดีทุกคน! สไลม์ไหลตามปกติแล้ว!	
VO_ICC07_Putricide_Male_Undead_TentaclesForArms_01	อาวุธเจ้าดูดีมีสไตล์จัง	
VO_ICC07_Putricide_Male_Undead_TransformDK_01	ว้าก? เจ้าจัดทรงผมใหม่เหรอ?	
VO_ICC07_Rotface_Male_Abomination_Rotface_02	ร็อตเฟซปวดท้อง	
VO_ICC08_Anduin_Male_Human_Muted_02	<เสียงอู้อี้>	
VO_ICC08_Anduin_Male_Human_Muted_03	<เสียงอู้อี้>	
VO_ICC08_Anduin_Male_Human_Muted_06	<เสียงอู้อี้>	
VO_ICC08_Anduin_Male_Human_Muted_07	<เสียงอู้อี้>	
VO_ICC08_Anduin_Male_Human_Muted_11	<เสียงอู้อี้>	
VO_ICC08_Anduin_Male_Human_Muted_13	<เสียงอู้อี้>	
VO_ICC08_Anduin_Male_Human_WinA_01	ต้องมีใครสักคนเป็น…	
VO_ICC08_Anduin_Male_Human_WinB_01	ลิชคิง...	
VO_ICC08_Garrosh_Male_Orc_WinA_01	ต้องมีใครสักคนเป็น…	
VO_ICC08_Garrosh_Male_Orc_WinB_01	ลิชคิง...	
VO_ICC08_Guldan_Male_Orc_WinA_01	ต้องมีใครสักคนเป็น…	
VO_ICC08_Guldan_Male_Orc_WinB_01	ลิชคิง...	
VO_ICC08_Jaina_Female_Human_WinA_01	ต้องมีใครสักคนเป็น…	
VO_ICC08_Jaina_Female_Human_WinB_01	ลิชคิง...	
VO_ICC08_LichKing_Male_Human_Archmage Antonidas_01	ข้ากำจัดเจ้ามาครั้งนึงแล้ว ตาแก่ ครั้งนี้ก็เหมือนกัน	
VO_ICC08_LichKing_Male_Human_Arfas_01	หมาดื้อ!	
VO_ICC08_LichKing_Male_Human_Bolvar_01	การทรมานเจ้านี่[b]มันช่างยากเย็น	
VO_ICC08_LichKing_Male_Human_Death_01	ข้าเห็น…\nแต่ความมืดมิด[b]อยู่ตรงหน้า…	
VO_ICC08_LichKing_Male_Human_DeathPunisher_01	ง่าย เล่นง่ายไปแล้ว 	
VO_ICC08_LichKing_Male_Human_EmoteResponse_01	ไม่มีใครสั่งข้าได้!	
VO_ICC08_LichKing_Male_Human_EndOfTurn4_01	ไม่มีการ์ดใดขัดขวางชัยชนะ\nอันแน่นอนของข้าได้	
VO_ICC08_LichKing_Male_Human_Frostmourne_01	ฟรอสต์มอร์นหิวโหย...	
VO_ICC08_LichKing_Male_Human_Frostmourne_02	ฟรอสต์มอร์นหิวโหย... อยากกินอะไรมั้ย?	
VO_ICC08_LichKing_Male_Human_Frostmourne_07	จงดูพลังของฟรอสต์มอร์น	
VO_ICC08_LichKing_Male_Human_GenericStart_03	ข้าจะทำลายเด็คของเจ้าก่อน แล้วตามด้วย… วิญญาณเจ้า	
VO_ICC08_LichKing_Male_Human_Horsemen_01	ถ้าข้ารวบรวมครบสี่เมื่อไหร่ เจ้าจะต้องอายจนแทรกแผ่นดินหนีแน่	
VO_ICC08_LichKing_Male_Human_Hunter_01	ฮันเตอร์ผู้โดดเดี่ยว ถ้าไม่มีสัตว์เลี้ยง อย่างเจ้าจะทำอะไรข้าได้	
VO_ICC08_LichKing_Male_Human_Illidan_01	บัลลังก์เยือกแข็งเป็นของข้า เจ้าปีศาจ ถอยไป	
VO_ICC08_LichKing_Male_Human_IndestructableWeapon_01	น่าสมเพชเหลือเกิน	
VO_ICC08_LichKing_Male_Human_Intro_01	ความทรมาน[b]ของเจ้าจะเป็นตำนาน[b]แต่ไม่ใช่อันดับของเจ้า	
VO_ICC08_LichKing_Male_Human_Intro_02	สุดท้าย ทุกสิ่งต้องรับใช้ข้า	
VO_ICC08_LichKing_Male_Human_Intro_03	เจ้าเรียกกองการ์ด\nน่าสมเพชนั่นว่าเด็คเหรอ?	
VO_ICC08_LichKing_Male_Human_Intro_04	ข้าคือจุดเริ่มต้นและจุดจบ – ข้าคือเมต้าใหม่	
VO_ICC08_LichKing_Male_Human_Intro_06	คิดว่าข้าจะปรานีเจ้างั้นเหรอ	
VO_ICC08_LichKing_Male_Human_Intro_07	นั่นเหรอเด็คของเจ้า[b]เหมือนมันร้องขอ[b]ความช่วยเหลืออยู่เลย	
VO_ICC08_LichKing_Male_Human_Intro_08	เสียงร้องโหยหวนของเจ้า[b]จะเป็นเครื่องยืนยันถึง[b]ฝีมือระดับตำนานของข้า 	
VO_ICC08_LichKing_Male_Human_Intro_09	แน่ใจเหรอว่าเจ้า\nทำเพื่อความถูกต้อง...	
VO_ICC08_LichKing_Male_Human_Kelthuzad_01	เคล’ธูซาด! เจ้ามาอยู่ผิดการผจญภัยแล้ว!	
VO_ICC08_LichKing_Male_Human_Lanathel_01	ไม่แปลกใจเลยที่เจ้าหักหลังข้า ลานา'เธล	
VO_ICC08_LichKing_Male_Human_LichKing_01	ว่าไง พ่อรูปหล่อ...	
VO_ICC08_LichKing_Male_Human_LichKing_02	ข้าดูดีมาก	
VO_ICC08_LichKing_Male_Human_LichKingMuted_01	เดี๋ยวก่อน เจ้าจะ-	
VO_ICC08_LichKing_Male_Human_LichKingMutedResponse_01	<เสียงอู้อี้>	
VO_ICC08_LichKing_Male_Human_LichKingMutedResponse_02	<เสียงอู้อี้>	
VO_ICC08_LichKing_Male_Human_LichKingMutedResponse_03	<เสียงอู้อี้>	
VO_ICC08_LichKing_Male_Human_LichKingMutedResponse_04	<เสียงอู้อี้>	
VO_ICC08_LichKing_Male_Human_LilLich_01	ข้า … ข้ารักเขา	
VO_ICC08_LichKing_Male_Human_Lose_03	จงรับใช้ข้าในความมืด…	
VO_ICC08_LichKing_Male_Human_Mage_01	เมจ![b]ข้าคือผู้ควบคุมไอเย็นมรณะ[b]แต่เพียงผู้เดียว!	
VO_ICC08_LichKing_Male_Human_MageSpellReflect_01	ผ่าน QA มาได้ยังไง?	
VO_ICC08_LichKing_Male_Human_MageSpellReflect_02	บ้าที่สุด! ใครเทสต์การผจญภัยนี้กัน?	
VO_ICC08_LichKing_Male_Human_Mograine_01	โมเกรน! ตอนนี้ข้าไม่รู้แล้วว่า\nเจ้าเป็นคนดี\nหรือคนเลวกันแน่	
VO_ICC08_LichKing_Male_Human_MutedResponse_01	เงียบซะ!	
VO_ICC08_LichKing_Male_Human_MutedResponse_02	ชู่ว!	
VO_ICC08_LichKing_Male_Human_MutedResponse_03	ชู่วววว!!	
VO_ICC08_LichKing_Male_Human_MutedResponse_04	หุบปาก	
VO_ICC08_LichKing_Male_Human_MutedResponse_05	เอาล่ะ หุบปาก	
VO_ICC08_LichKing_Male_Human_MutedResponse_06	เงียบ	
VO_ICC08_LichKing_Male_Human_Paladin_01	ที่นี่แสงสว่างปกป้องเจ้าไม่ได้ พาลาดิน ไม่มีอะไรปกป้องเจ้าได้...	
VO_ICC08_LichKing_Male_Human_Phase03_01	จงเผชิญจุดจบแสนเศร้า	
VO_ICC08_LichKing_Male_Human_PhaseTransition_02	มีใครเนิร์ฟอาวุธข้างั้นเหรอ 	
VO_ICC08_LichKing_Male_Human_PowerReplace_01	อย่าคิดว่าจะลบล้างพลังของข้าได้ง่ายๆ	
VO_ICC08_LichKing_Male_Human_Priest_01	หุบปากซะ พรีสต์![b]แสงสว่างไม่ได้ยินเสียง[b]อ้อนวอนของเจ้าหรอก	
VO_ICC08_LichKing_Male_Human_Putricide_01	ข้าไม่เคยชอบหน้าเจ้าเลย	
VO_ICC08_LichKing_Male_Human_Rogue_01	ออกมาจากเงามืดเดี๋ยวนี้[b]โร้ก เจ้าจะทำอะไรได้[b]ถ้าไม่มีลูกไม้พวกนั้น	
VO_ICC08_LichKing_Male_Human_Shaman_01	มินเนี่ยนของเจ้ากลัวหัวหดต่อหน้าข้า ชาแมน!	
VO_ICC08_LichKing_Male_Human_Sindragosa_01	นางเป็นตัวปิดเกมของข้า! เอาคืนมานะ!	
VO_ICC08_LichKing_Male_Human_Sylvanas_01	เจ้าทำกับข้าไว้ขนาดนั้น ข้าไม่มีวันปล่อยให้เจ้าตายอย่างสงบแน่ 	
VO_ICC08_LichKing_Male_Human_Tirion_01	ข้าจะปล่อยให้เจ้ารอดจนได้เห็นจุดจบ\nฟอร์ดริง	
VO_ICC08_LichKing_Male_Human_TransformDK_01	นั่นแหละ… ยอมรับพลังใหม่ของเจ้า… ข้าเป็นฝ่ายชนะแล้ว…	
VO_ICC08_LichKing_Male_Human_Turn6_01	นั่นเป็นเทิร์นที่น่าสมเพชที่สุดของเจ้า แต่มันก็แทบทุกเทิร์นนั่นแหละ	
VO_ICC08_LichKing_Male_Human_Turn6_03	เจ้าเล่นการ์ดได้แย่พอๆ[b]กับที่พ่อข้าปกครอง[b]อาณาจักรเลย 	
VO_ICC08_LichKing_Male_Human_Turn6_04	ตอนสับการ์ดเจ้าไม่รู้สึก\nสมเพชตัวเองบ้างเหรอ	
VO_ICC08_LichKing_Male_Human_Turn6_05	การ์ดแต่ละใบที่เจ้าเล่น\nจะส่งเจ้าสู่ขุมนรกอย่างช้าๆ	
VO_ICC08_LichKing_Male_Human_Turn6_06	เจ้าไม่มีทางหลีกหนีจุดจบได้\nและไม่มีอีโมทไหนสื่อถึง\nความอับอายของเจ้าได้	
VO_ICC08_LichKing_Male_Human_Turn6_07	ใครสร้างเด็คนั้นให้เจ้าน่ะ 	
VO_ICC08_LichKing_Male_Human_Turn6_08	เจ้าพวกนั้นคิดว่าเจ้า\nจะมาสู้กับฮ็อกเกอร์เหรอ	
VO_ICC08_LichKing_Male_Human_Warlock_01	วอร์ล็อค ลดมือน่าสมเพชของเจ้าลง\nไม่ช้าเหล่าปีศาจใต้บัญชาเจ้า[b]จะหันมารับใช้ข้า	
VO_ICC08_LichKing_Male_Human_Warrior_01	วอริเออร์ เจ้าจะเป็นเดธไนท์\nที่ยอดเยี่ยมหลังจากข้าสยบเจ้าได้	
VO_ICC08_LichKing_Male_Human_Wounded_01	ความหวังสูญสิ้น…	
VO_ICC08_LichKing_Male_Human_Wounded_02	เป็นไปไม่ได้… เป็นไปไม่ได้!	
VO_ICC08_LichKing_Male_Human_YoungArthas_01	นี่มันอะไร? เอาความขัดแย้งในใจข้ามาตีความใหม่ให้อลังการขึ้นงั้นเหรอ	
VO_ICC08_Malfurion_Male_NightElf_WinA_01	ต้องมีใครสักคนเป็น…	
VO_ICC08_Malfurion_Male_NightElf_WinB_01	ลิชคิง!	
VO_ICC08_Rexxar_Male_Orc_WinA_01	ต้องมีใครสักคนเป็น…	
VO_ICC08_Rexxar_Male_Orc_WinB_01	ลิชคิง!	
VO_ICC08_Thrall_Male_Orc_WinA_01	ต้องมีใครสักคนเป็น…	
VO_ICC08_Thrall_Male_Orc_WinB_01	ลิชคิง!	
VO_ICC08_Tirion_Male_Human_Win_01	เจ้าทำสำเร็จแล้ว ผู้กล้า!	
VO_ICC08_Tirion_Male_Human_Win_02	แต่หากไม่มีใครคอยปกครอง เหล่าสเคิร์จไร้นายจะเป็นอันตรายต่อโลกนี้ยิ่งกว่าเดิม	
VO_ICC08_Uther_Male_Human_WinA_01	ต้องมีใครสักคนเป็น…	
VO_ICC08_Uther_Male_Human_WinB_01	ลิชคิง!	
VO_ICC08_Valeera_Female_Human_WinA_01	ต้องมีใครสักคนเป็น…	
VO_ICC08_Valeera_Female_Human_WinB_01	ลิชคิง!	
VO_ICC09_LichKing_Male_Human_LichKing_02	ไม่ต้องห่วง ข้าโจมตีเจ้าไม่ได้หรอก	
VO_ICC09_LichKing_Male_Human_Lose_01	คิดเหรอว่าอาวุธกระจอกแบบนั้นจะเอาชนะได้	
VO_ICC09_LichKing_Male_Human_Win_01	นั่นการ์ดตำนานใบโปรดของข้านะ! สงสัยต้องย่อยแล้วไปสร้างใบอื่นที่ดีกว่า	
VO_ICC09_Saurfang_Male_Orc_AttackedByPlayer_01	ลองดูสิ!	
VO_ICC09_Saurfang_Male_Orc_AttacksPlayer_01	นี่คือพลังอำนาจแห่งสเคิร์จ!	
VO_ICC09_Saurfang_Male_Orc_AttacksPlayer_02	ข้าคือความตาย!	
VO_ICC09_Saurfang_Male_Orc_AttacksPlayer_03	ลิชคิงปกครองทุกสิ่ง	
VO_ICC09_Saurfang_Male_Orc_AttacksPlayer_04	สู้! ตาย! ชะตาเจ้าขาดแล้ว	
VO_ICC09_Saurfang_Male_Orc_BloodBeast_01	ขย้ำมัน สมุนของข้า!	
VO_ICC09_Saurfang_Male_Orc_BloodBeast_02	จงกลืนกินพวกมัน...	
VO_ICC09_Saurfang_Male_Orc_BloodBeast_03	ข้าทรงพลังขึ้นเรื่อยๆ	
VO_ICC09_Saurfang_Male_Orc_BloodBeast_04	กายข้าเต็มไปด้วยโทสะ!	
VO_ICC09_Saurfang_Male_Orc_BloodBeastStolen_01	เอาไปเถอะ กลิ่นมันจะติดเสื้อผ้าเจ้าไปตลอดแน่	
VO_ICC09_Saurfang_Male_Orc_CursedBlade_01	ความคิดใครเนี่ย?	
VO_ICC09_Saurfang_Male_Orc_Death_01	ข้าเป็น… อิสระแล้ว…	
VO_ICC09_Saurfang_Male_Orc_DKTransform_01	ในที่สุดก็เจอศัตรูที่คู่ควร!	
VO_ICC09_Saurfang_Male_Orc_Doomerang_01	อืม... ข้าต้องหามาใช้บ้างแล้ว...	
VO_ICC09_Saurfang_Male_Orc_EmoteResponse_01	เจ้าคนขี้ขลาด	
VO_ICC09_Saurfang_Male_Orc_EquipWeapon_01	ด้วยอำนาจแห่งลิชคิง!	
VO_ICC09_Saurfang_Male_Orc_EquipWeapon_02	ยอดเยี่ยมมาก	
VO_ICC09_Saurfang_Male_Orc_Intro_01	จงมาเผชิญหน้า\nกับอำนาจแห่งสเคิร์จ!	
VO_ICC09_Saurfang_Male_Orc_LichKing_01	ท่านมาทำอะไรที่นี่?	
VO_ICC09_Saurfang_Male_Orc_WeaponDestroyed_01	อ๊าาร์!	
VO_ICC10_Deathwhisper_Female_Lich_DamageByValithria_01	อ๊าก..	
VO_ICC10_Deathwhisper_Female_Lich_Death_01	ไม่จริง….!	
VO_ICC10_Deathwhisper_Female_Lich_DKTransform_01	อ้า!เจ้าก็ได้รับพลังของ[b]นายท่านเหมือนกัน…	
VO_ICC10_Deathwhisper_Female_Lich_EmoteResponse_01	เจ้าขู่ข้าเหรอ	
VO_ICC10_Deathwhisper_Female_Lich_Equality_01	ความคิดเจ้ามันไม่เข้าท่าเอาซะเลย	
VO_ICC10_Deathwhisper_Female_Lich_HeroPower_01	คนเป็นช่างอ่อนแอเหลือเกิน...	
VO_ICC10_Deathwhisper_Female_Lich_HeroPower_02	กายเนื้อของเจ้าคือคำสาป…	
VO_ICC10_Deathwhisper_Female_Lich_HeroPower_03	ไม่ว่าเจ้าจะทำอะไรมันก็ไร้ประโยชน์	
VO_ICC10_Deathwhisper_Female_Lich_HeroPower_04	ความมืดครอบงำเจ้า…	
VO_ICC10_Deathwhisper_Female_Lich_HeroPowerInitial_01	ความตายเรียกหาเจ้า...	
VO_ICC10_Deathwhisper_Female_Lich_Intro_01	ใครบังอาจรบกวนข้า งานของข้ายังไม่เสร็จนะ	
VO_ICC10_Deathwhisper_Female_Lich_LichKing_01	นายท่าน ข...ขอร้องล่ะ ข้าจะรีบฆ่าพวกมันให้เร็วที่สุด!	
VO_ICC10_Deathwhisper_Female_Lich_PlayerPlaysEnrage_01	มินเนี่ยนของเจ้าคงอยากโดนลงโทษสินะ!	
VO_ICC10_Deathwhisper_Female_Lich_StoneskinGargoyle_01	หา? ไม่เห็นรู้เลยว่าเล่นการ์ดอิสระในนี้ได้ด้วย!	
VO_ICC10_Deathwhisper_Female_Lich_ValithriaBlessedChampion_01	เอามือไปห่างๆ เลย พาลาดิน!	
VO_ICC10_Deathwhisper_Female_Lich_ValithriaDivineShield_01	เลิกยุ่งกับมังกรซะที!	
VO_ICC10_Deathwhisper_Female_Lich_ValithriaResurrect_01	ข้าไม่อยากเล่นเกมนี้อีกแล้ว	
VO_ICC10_Deathwhisper_Female_Lich_ValithriaTaunt_01	แค่นี้ข้าก็เกลียด\nมังกรนั่นจะตายอยู่แล้ว	
VO_ICC10_Deathwhisper_Female_Lich_ValithriaWindfury_01	น่ารังเกียจ	
VO_ICC10_LichKing_Male_Human_DamageByValithria_02	มังกรนั่นจะทำลายทุกสิ่ง\nที่เราสร้างมา! จัดการมัน\nเดธวิสเปอร์!	
VO_ICC10_LichKing_Male_Human_Lose_01	อีกที คราวนี้เดี๋ยวฮีลให้!	
VO_ICC10_LichKing_Male_Human_Turn2_01	เดธวิสเปอร์![b]ข้าสั่งให้เจ้าจัดการมังกรนั่น	
VO_ICC10_LichKing_Male_Human_Turn2_02	เจ้าเป็นผู้นำลัทธิมรณะ\nที่ใช้เวลาสิ้นเปลืองมาก	
VO_ICC10_LichKing_Male_Human_Win_01	เด็คเจ้าทำให้ข้าผิดหวัง เดธวิสเปอร์ จงดีใจเถอะที่มันจบอย่างรวดเร็ว	
VO_ICC10_LichKing_Male_Human_Wounded_01	เลิกเล่นแล้วจัดการให้จบสักที\nเดธวิสเปอร์	
VO_ICC10_LichKing_Male_Human_Wounded_02	ทำไมไม่เอาระเบิดมนตรา\nใส่เด็คมาด้วย!?	
VO_ICCA08_033_Male_HumanGhost_Flavor_01	…ช่วยเราที…	
VO_ICCA08_033_Male_HumanGhost_Flavor_02	…ปลดปล่อยเรา…	
VO_ICCA08_033_Male_HumanGhost_Flavor_03	...ไม่มีทางหนีรอด...	
VO_ICCA08_033_Male_HumanGhost_Flavor_04	…ข้าจำได้ว่ามี…	
VO_ICCA08_033_Male_HumanGhost_Flavor_05	...ชู่ว!	
VO_ICCA10_001_Female_GreenDragon_Healed_01	พลังข้า… กลับมาแล้ว! 	
VO_ICCA10_001_Female_GreenDragon_Start_01	ช่วยด้วย ผู้กล้า! ข้าต้องไม่... ยอมแพ้	
VO_Illhoof_Male_Demon_IlhoofKilrek_01	จงออกมา คิล'เร็ค เราจะทำพิธีกรรมให้สมบูรณ์กัน!	
VO_Illhoof_Male_Demon_IllhoofDeath_02	ไม่! อีกแค่นิดเดียว! ซาร์การ์...	
VO_Illhoof_Male_Demon_IllhoofEmoteResponse_01	ข้าจะเอาวิญญาณเจ้า\nมาบูชายัญ!	
VO_Illhoof_Male_Demon_IllhoofOpen_01	อ้า มาได้เวลาพอดี!	
VO_Illhoof_Male_Demon_IllhoofSummonImps_01	ผู้เร้นกายในความมืด จงปรากฏตัว  จงตอบรับเสียงเรียกของข้า!!	
VO_Illhoof_Male_Demon_IllhoofSummoningPortal_01	เรียกประตูมิติโดยไม่ต้อง\nทำพิธีกรรมเรอะ? ง่ายกว่าของข้าเยอะเลย…	
VO_Illhoof_Male_Demon_IllhoofTurn1_01	เริ่มพิธีได้เลย!	
VO_Illhoof_Male_Demon_IllhoofWounded_01	สัตว์เลี้ยงของข้า จงมารวมตัวกัน มาทำพิธีกรรมให้เสร็จสมบูรณ์!	
VO_INNKEEPER_Male_Dwarf_HSNewYearBrawl_02	ปีแห่งเรเวนมันก็…[b]ออกจะน่ากลัว[b]กว่าปีอื่นๆ	
VO_INNKEEPER_Male_Dwarf_HSNewYearBrawl_03	ดูสิ! ท่าทางทูต[b]ของปีแห่งเรเวน[b]จะมาถึงแล้วนะ!	
VO_INNKEEPER_Male_Dwarf_HSNewYearBrawl_05	ทุกสิ่งจะถูกปกคลุม[b]ด้วยความมืดใน[b]ปีแห่งเรเวน	
VO_INNKEEPER_Male_Dwarf_HSNewYearBrawl_08	สัตว์ร้ายในเงามืด[b]แข็งแกร่งกว่าที่เคย...	
VO_INNKEEPER_Male_Dwarf_HSNewYearBrawl_09	สิ่งมีชีวิตแห่งความมืด[b]ออกเพ่นพ่าน...	
VO_INNKEEPER_Male_Dwarf_HSNewYearBrawl_10	ปีศาจแห่งหนองน้ำ[b]คืบคลานเข้าใกล้...	
VO_Jaraxxus_Male_Demon_FinalMalchezaarJaraxxus_01	เจ้าชายหน้าโง่ ฝึกร้องคาราโอเกะ\nแบบจาแร็กซ์ซัสสิ!	
VO_Jaraxxus_Male_Demon_FinalMalchezaarJaraxxus_02	เหล่าพวกเรา...\n Explorer’s League\nเราคือความห้าวหาญ\nของนักสำรวจ	
VO_Julianne_Female_Human_JulianneDeath_01	โรมิวโล! ข้าขอดื่มให้ท่าน…	
VO_Julianne_Female_Human_JulianneEmoteResponse_01	ท่านกัดหัวแม่มือใส่เราหรือ?	
VO_Julianne_Female_Human_JulianneFeignDeath_03	แล้วกลับฟื้นตื่นนิทรา…	
VO_Julianne_Female_Human_JulianneHeroPower_01	มาเถิด ราตรีแสนหวาน จงคืนโรมิวโลให้ข้า ณ บัดนี้!	
VO_Julianne_Female_Human_JulianneOpen_01	เจ้าคือปีศาจร้ายตนใดกัน?	
VO_KAR03_MOROES_MALE_HUMAN_CHESS_TURN_1	อ้า ข้าจำได้แล้ว ตัวหมากจะโจมตีโดยอัตโนมัติเมื่อจบเทิร์นของคุณ	
VO_KAR03_MOROES_MALE_HUMAN_CHESS_TURN_3	ถ้าตัวหมากอยู่ระหว่างศัตรูสองตัว มันก็จะโจมตีศัตรูทั้งสองตัว!	
VO_KAR03_MOROES_MALE_HUMAN_CHESS_TURN_5	การวางตำแหน่งอย่างเหมาะสมคือกุญแจสู่ชัยชนะ  พยายามโจมตีศัตรูทั้งสองในคราวเดียว!	
VO_KARA_04_01_Female_Human_CroneHuffer_01	โอ้ ฮัฟเฟอร์ ข้ารู้สึกว่าเราไม่ได้อยู่ใน\nเวสต์ฟอลอีกต่อไปแล้ว…	
VO_KARA_04_01_Female_Human_CroneLionTigerBear_02	โอ้! สิงโตและมังกรและหมี! โอ้ไม่!	
VO_KARA_04_01_Female_Human_CroneTurn1_01	ไม่นะ อย่าให้นางทำร้ายข้านะ!	
VO_KARA_04_01_Female_Human_CroneTurn3_01	คล้องแขนกันไว้นะ! เราแกร่งที่สุดเมื่ออยู่ด้วยกัน!	
VO_KARA_06_01_Male_Human_JulianneDeadlyPoison_02	อ้า ยาพิษ!	
VO_KARA_06_01_Male_Human_JulianneTurn1_01	เจ้าบังอาจยั่วยุข้าหรือ? จงเตรียมรับมือเถิด!	
VO_KT_ANTI_CHEESE1_65	นี่มัน Naxxramas ระดับฮีโร่นะ! ข้าไม่ยอมให้เจ้าใช้ลูกไม้สั่วๆ แบบนั้นแน่!	
VO_KT_ANTI_CHEESE2_66	ผู้ทำนายหายนะรึ... คิดว่าตัวเองคงฉลาดมากสินะ	
VO_KT_ANTI_CHEESE3_67	เสมอภาคงั้นรึ?! อย่าหวังเลย!	
VO_KT_ANUB2_43	ไม่!!! ข้าหมายถึง.... ช่างมันเถอะ เจ้าไม่มีวันเอาชนะนางแมงมุมได้แน่	
VO_KT_BARON2_64	เขตทหารทำให้ข้าผิดหวังจนได้! สมัยนี้นี่จะหาลูกน้องดีๆ มันยากเย็นซะจริง	
VO_KT_FAERLINA2_45	เฟร์ลิน่าไม่สำคัญอะไรหรอก ราชินีแมงมุมจะจัดการเจ้าได้สบายๆ	
VO_KT_GLUTH2_73	ข้าถามพวกซอมบี้ว่าอยากกินสมองของเจ้ามั้ย พวกมันตอบว่า "ข้าไม่กินอาหารขยะ"	
VO_KT_GLUTH2_ALT_74	ข้ามั่นใจว่าถ้าแพ้กลูธเนี่ยเจ้าจะปลดล็อคความสำเร็จด้วยนะ	
VO_KT_GLUTH3_75	ฮ่าฮ่าฮ่า ความสำเร็จบ้าบออะไรไม่มีหรอกเฟ้ย!	
VO_KT_GLUTH4_76	ไม่นะ! แล้วทีนี้ใครจะกินซากซอมบี้ให้ข้าล่ะ	
VO_KT_GLUTH5_77	การล่าสังหารคืองานโปรดของเข้า ไม่สิ การทำให้เจ้าหนาวจนถึงกระดูกต่างหาก	
VO_KT_GLUTH6_78	เก่งมาก เจ้าหนู! แสนรู้จริงๆ!	
VO_KT_GOTHIK2_62	ทำไมกอธิคถึงไม่กลับมาเป็นวิญญาณกอธิคล่ะ ปัดโธ่เอ๊ย!	
VO_KT_GROBBULUS2_71	สงสัยต้องกลับไปออกแบบใหม่แล้วมั้ง...	
VO_KT_HEIGAN2_55	ข้าโกรธจนเดือดไปหมดแล้ว เดือดปุดๆ	
VO_KT_LOATHEB2_57	เจ้าเอาแต่ฆ่าลูกน้องของข้าอยู่นั่นแหละ หยุดเลยนะ! ข้าขอสั่งให้เจ้าหยุดเดี๋ยวนี้!	
VO_KT_MAEXXNA2_47	พิษของนางจะทำให้เจ้าตายโดย "แทบจะ" ไม่เจ็บปวดเลย	
VO_KT_MAEXXNA3_48	ยักษ์ทะเลงั้นรึ?? เมเอ็กซ์น่า การ์ดใบนั้นไม่อยู่ในรายชื่อการ์ดที่ข้าอนุมัติ!	
VO_KT_MAEXXNA4_49	เป็นไปไม่ได้! มันยังไม่จบแค่นี้หรอก เจ้ากระจอก!	
VO_KT_MAEXXNA6_51	เจ้ารู้มั้ยว่าเราเรียกผู้เล่นที่มีมินเนี่ยนติดอยู่ในใยแมงมุมว่าอะไร ซวยแล้วไงล่ะ!	
VO_KT_NOTH2_53	น็อธผู้น่าสงสาร เขาทำให้ข้าน็อตหลุดซะแล้ว	
VO_KT_PATCHWERK2_69	อสูรสงครามของข้า! ข้าน่าจะใช้ผู้เล่นที่เก่งกว่านี้มาเย็บนะ...	
VO_KT_RAZUVIOUS2_59	แล้วทีนี้ใครจะฝึกเดธไนท์ให้ข้าล่ะ! ข้าทำเองไม่ได้หรอกนะ! งานข้ายุ่งจะตาย	
VO_KT_SAPPHIRON2_84	ดูเจ้าโนมตัวจิ๋วนั่นสิ ครั้งหนึ่งมันก็เคยเป็นผู้บุกรุกเหมือนเจ้านั่นแหละ	
VO_KT_SAPPHIRON3_85	เลิกซ่อนตัวอยู่หลังก้อนน้ำแข็งได้แล้ว!	
VO_KT_SAPPHIRON4_ALT_87	แซปฟิรอน เริ่มดำเนินแผน: "หนาวจนถึงกระดูก"	
VO_KT_SAPPHIRON5_88	มังกรของข้า! ข้าเกลียดเจ้า	
VO_KT_THADDIUS2_81	ผู้บุกรุก! นี่คือฟางเส้นสุดท้ายแล้ว!	
VO_LichKing_Male_Human_Brawl_01	ทุกสิ่งในโรงเตี๊ยมนี้\nต้องถูกกำจัด	
VO_LichKing_Male_Human_Brawl_03	จะขนพวกโง่มากี่คนก็ตามใจ ข้าไม่มีวันแพ้	
VO_LichKing_Male_Human_Brawl_05	จงสิ้นหวังกับพลังชีวิตล้นเหลือของข้า	
VO_LichKing_Male_Human_ExpansionIntro_02	ไอซ์คราวน์! มาเพื่อแสวงหาพลังมืด อยู่ต่อ... เพราะตายแล้วไปไหนไม่ได้	
VO_LichKing_Male_Human_FinaleFirstVictory_01	ไม่จริง… ไม่จริง… เจ้าว่าเราแข่งกันสักเก้าเกมดีไหม?	
VO_LichKing_Male_Human_FinaleLock_01	เจ้าไม่มีวันเอาชนะข้าได้! อย่างน้อยก็ระหว่างที่วิงนี้ยังล็อคอยู่	
VO_LichKing_Male_Human_FinaleUnlock_03	ข้าควรต้องวางฟรอสต์มอร์นแล้วคุกเข่าขอความเมตตาใช่ไหม สปอยล์นะ: ไม่มีทาง	
VO_LichKing_Male_Human_LowerCitadelUnlock_01	ไอซ์คราวน์ซิทาเดล! ศูนย์รวมมินเนี่ยนสุดชั่วร้ายของข้า ไม่ได้สร้างด้วยผงเวท… สร้างด้วยความเกลียดชัง	
VO_LichKing_Male_Human_PrologueBossCoin_01	มาเลย ผู้กล้า! ข้าจะสังหารแล้วสลายร่างเจ้าให้เป็นผงเวทมนตร์!	
VO_LichKing_Male_Human_PrologueBossCoin_02	ข้าสร้างเจ้าปีศาจกระดูกสยองขวัญนี่ขึ้นมา\nจากเศษซากการ์ดซ้ำของข้า 	
VO_LichKing_Male_Human_PrologueBossCoin_03	เดธบริงเกอร์เซาร์แฟงเป็นมินเนี่ยนระดับตำนานตัวแรกของข้า ข้าสร้างการผจญภัยนี้เพื่อเขาเลย	
VO_LichKing_Male_Human_PrologueBossCoin_04	นี่คือเลดี้เดธวิสเปอร์ ก่อนที่นางจะโดนเนิร์ฟ!	
VO_LichKing_Male_Human_PrologueBossCoin_05	โปรเฟสเซอร์พิวทริไซด์เป็นตัวช่วยจั่วการ์ดของข้า แต่จั่วทีไรก็ได้แต่ลม ข้าไม่ชอบหน้าเขาเลย	
VO_LichKing_Male_Human_PrologueBossCoin_07	ลานา’เธล!! มีรอยฟันอยู่บนการ์ดข้า! บอกแล้วไงว่าให้เก็บพวกมันไว้ในผ้าคลุม! 	
VO_LichKing_Male_Human_PrologueBossCoin_08	ซินดราโกซาคือตัวปิดเกมของข้า! อย่ามายุ่ง! ข้าไม่ยกให้หรอก!	
VO_LichKing_Male_Human_PrologueBossCoin_09	เจ้าจะต้องขอความเมตตาจากข้า เจ้าจะกดปุ่ม "ยอมแพ้" และข้าจะไม่อนุญาต	
VO_LichKing_Male_Human_PrologueBossCoin_11	ดูมือของเจ้าสิ ผู้กล้า ดูว่าเจ้าเปลี่ยนไปยังไง เจ้ากับข้า เราต่างกันตรงไหน 	
VO_LichKing_Male_Human_PrologueBossCoin_12	ข้าเปรียบดั่งราชสีห์ในฝูงแกะ... แต่พวกมันไม่กลัวข้าเลย	
VO_LichKing_Male_Human_ResponseAnubaArak_01	อานุบอารัค จงรับใช้ข้า!	
VO_LichKing_Male_Human_ResponseMalganis_01	ข้าต้องทำลายเจ้าอีกกี่ครั้ง มัลกานิส?	
VO_LichKing_Male_Human_UpperReachesLock_01	คิดใช้พลังของข้าย้อนทำร้ายข้าเหรอ รอก่อนเถอะ ข้าจะเปิดเน็ตหาเด็คที่จะแผ่ความมืดปกคลุมโลกนี้ไปตลอดกาล	
VO_LichKing_Male_Human_UpperReachesUnlock_01	คิดใช้พลังของข้าย้อนทำร้ายข้าเหรอ รู้หรือเปล่าว่าข้าไปถึงระดับตำนานกี่ครั้ง?	
VO_LOE_01_DEATH_2	ออร์ซิส! แก้แค้นให้ข้าด้วย!	
VO_LOE_01_RESPONSE	จงหวาดกลัวโทสะแห่งดวงตะวัน!	
VO_LOE_01_STAFF	ฮ่าฮ่า! ของข้า!	
VO_LOE_01_STAFF_2	เจ้าจะต้องโดนแผดเผา! 	
VO_LOE_01_STAFF_2_RENO	เจ้าควรจะเก็บคทาอันนั้นไว้ให้ดีนะ มันมีค่ามาก	
VO_LOE_01_START	ข้าไร้เทียมทาน!	
VO_LOE_01_WIN	ฮ่าฮ่า! ข้าได้คทามาแล้ว อยากให้แฮริสันเห็นข้าตอนนี้จริงๆ! 	
VO_LOE_01_WIN_2	เอาคทานั่นมาเร็ว!	
VO_LOE_01_WIN_2_ALT_2	ปกติแล้วพื้นมันสั่นขนาดนั้นเลยเหรอ	
VO_LOE_01_WOUNDED	ข้าต้อนเขาจนมุมแล้ว! เจ้าจัดการได้เลย!	
VO_LOE_02_DEATH	กลับเข้าตะเกียงอีกแล้ว ม่ายยยยยย...	
VO_LOE_02_INTRO	คทาแห่งตะวันเป็นของข้า!	
VO_LOE_02_MORE_WISHES	ว้าว ไม่อยากเชื่อเลยว่ามันจะได้ผล	
VO_LOE_02_PHAERIX_STAFF_RECOVER	เจ้าไม่มีวันเข้าใจ อำนาจแห่งคทาหรอก!	
VO_LOE_02_RESPONSE	พลังแห่งจักรวาลอัศจรรย์!	
VO_LOE_02_START	เป็นอิสระสักที! รางวัลของเจ้าคือ[b]ความตายแบบฉับพลัน!	
VO_LOE_02_START2	นักผจญภัย! ข้าคือรีโน่ แจ็คสัน นักโบราณคดี นักสำรวจ และนักล่าสมบัติชื่อก้องโลก 	
VO_LOE_02_START3	แล้วก็อยู่ไม่สุขเหมือนลิงด้วย	
VO_LOE_02_TURN_10	ลองนึกดูสิ นักผจญภัย คทาแห่งตะวันเชียวนะ! ถ้าเอาไปขายคงรวยเละแน่!	
VO_LOE_02_TURN_6	ข้าเคยเล่าเรื่องตอนที่ข้า แฝงตัวเข้าไปอยู่ท่ามกลาง ฝูงออเกอร์แห่งไดร์มอลหรือยัง	
VO_LOE_02_TURN_6_2	แล้วตอนที่ข้าแอบย่อง\nเข้าไปในลานชุมนุมแบล็คร็อค\nเพื่อเอา…	
VO_LOE_02_WIN	เดินหน้าต่อเลย! คทาอยู่ในห้องโถงข้างหน้านี่แล้ว!	
VO_LOE_02_WISH	ดีจริงๆ ที่เขายังมีแก่ใจจะมอบพรให้ ถึงจะพยายามฆ่าเราอยู่ก็เถอะ	
VO_LOE_03_RESPONSE	เร็วเข้า!	
VO_LOE_03_TURN_1	เพดานกำลังถล่ม สัตว์ประหลาดก็เต็มไปหมดเลย! เร็วเข้า!	
VO_LOE_03_TURN_10	เกือบถึงแล้ว! ข้าเห็นดวงอาทิตย์แล้ว!	
VO_LOE_03_TURN_2	เฮ้ เฮ้! สระน้ำเรืองแสงนี่ ลองไปดูกันหน่อยไหม	
VO_LOE_03_TURN_2_2	ไม่มีเวลาแล้ว!	
VO_LOE_03_TURN_3	อืมม…ขวาหรือซ้ายดี? 	
VO_LOE_03_TURN_3_BOULDER	หินก้อนใหญ่มาก! หลบเร็ว!	
VO_LOE_03_TURN_3_WARNING	โอเค...มันสั่นแรงขึ้นเรื่อยๆแล้ว\nข้าพนันว่าเทิร์นหน้า เพดานคงพังลงมาทั้งแถบแน่!	
VO_LOE_03_TURN_4	เฮ้ เฮ้! กับดักหนาม!	
VO_LOE_03_TURN_4_BAD	โฮะ โฮะ โฮ่! ท่าทางไม่น่าสนุกเอาซะเลย	
VO_LOE_03_TURN_4_GOOD	เฮ้ เจ๋งนี่! ข้ามมาแบบนุ่มนวลพอๆ กับข้าเลย	
VO_LOE_03_TURN_4_NEITHER	โอเค...เจ้ากำลังคลานฝ่าดงหนาม ช่วยรีบหน่อยสิ!	
VO_LOE_03_TURN_5	รูปปั้นสวยดีนะ โอ้โห ทับทิมเม็ดนั้นแวววาวดีจัง...	
VO_LOE_03_TURN_5_4	โอ๊ะโอ ท่าทางเขาไม่ค่อยแฮปปี้เลย ข้าว่าเขาอยากได้อัญมณีคืนนะ	
VO_LOE_03_TURN_6	ระวัง! เพดานถล่มลงมาแล้ว!	
VO_LOE_03_TURN_6_2	เกือบไปแล้ว! ดีนะที่ข้าช่วยเจ้าไว้ทัน ไม่เป็นไร ไม่ต้องขอบคุณหรอก	
VO_LOE_03_TURN_7	ในนี้มืดมาก แต่ข้ามั่นใจว่ามันจะพาเรา ออกไปข้างนอกได้เร็วขึ้น ไปกันเถอะ!	
VO_LOE_03_TURN_7_2	แผนที่ของข้าบอกไว้แค่ว่า "อย่าไปทางนี้"	
VO_LOE_03_TURN_8	ฟู่ว! เริ่มรู้สึกร้อนแล้ว รีบกันหน่อยดีกว่า!	
VO_LOE_03_TURN_9	โอย ทำไมต้องเจอแมลงทุกทีเลย	
VO_LOE_03_WIN	สำเร็จแล้ว! ข้าไม่เคยนึกเลยว่าจะดีใจที่ได้เห็นทะเลทรายแห่งนี้อีก! พูดถึงทะเลทราย ข้าชักจะหิวน้ำซะแล้วสิ!	
VO_LOE_04_RESPONSE	ทร็อกก์ทุบคนโง่!	
VO_LOE_04_SCARVASH_TURN_2	ทร็อกก์ไม่โง่! ทร็อกก์จะทำให้เจ้าโง่!	
VO_LOE_04_START	อุลดามานของทร็อกก์เท่านั้น!	
VO_LOE_04_WIN	พวกมันยังไม่หมดแค่นี้! ทางนี้ ฮีโร่ โดดขึ้นมาบนรถรางเลย!	
VO_LOE_07_RESPONSE	เจ้ายังมีเวลาทำอะไรแบบนั้นอีกเหรอ?	
VO_LOE_07_START	ระวังด้วย พวกมันกำลังไล่ตามมา!	
VO_LOE_07_WIN	ฮ่า ฮ่า! นั่งรถรางและปาระเบิด! สุดยอดแห่งความมันส์เลย!	
VO_LOE_08_ANIMATE_STONE	พสุธาและศิลา จงตื่นขึ้น!	
VO_LOE_08_LANDSLIDE	ข้าจะฝังเจ้าทั้งเป็น!	
VO_LOE_08_RESPONSE	เจ้ามันก็แค่ฝุ่นผง	
VO_LOE_08_START	ผู้ใดบังอาจท้าทาย โทสะแห่งผู้สร้าง!	
VO_LOE_08_WIN	ส่วนหัวเป็นของเราแล้ว! เหลือแค่อีกชิ้นเดียวเท่านั้น!	
VO_LOE_092_Attack_02	ดูซะ!	
VO_LOE_10_NYAH	มรรรกลมรรรกล เนียห์!	
VO_LOE_10_RESPONSE	มรกลมรรกลรมรรกล	
VO_LOE_10_RESPONSE_ALT_read	มิดเดิ้ลฟิน เจ้ามาทำอะไรที่นี่น่ะ?	
VO_LOE_10_START	มรกลมรกลมรกล	
VO_LOE_10_START_2	พูดจาอย่างนี้เหรอ หยาบคายเกินไปแล้ว 	
VO_LOE_10_TURN_2_GIANTFIN	มรรรกล! มรรรกลมรกล!	
VO_LOE_10_TURN1	มรรรกล! มรรกลรรกลมรกล	
VO_LOE_10_WIN	น่าเสียดาย ถ้าได้รับการอบรมที่ดีกว่านี้ เขาจะเป็นคนที่ใช้ได้เลยล่ะ	
VO_LOE_12_NAZJAR_PEARL	เหลือเชื่อเลย ไข่มุกแห่งท้องทะเลงดงามเหนือความคาดหมายจริงๆ	
VO_LOE_12_NAZJAR_TURN_1	ข้าคือคมดาบแห่งอัซชารา เจ้าเป็นใครถึงกล้ามาท้าทายข้า	
VO_LOE_12_NAZJAR_TURN_1_FINLEY	ข้าคือเซอร์ฟินลีย์ เมอร์เกิลตัน เป็นเกียรติอย่างยิ่ง	
VO_LOE_12_NAZJAR_TURN_3_FINLEY	เอลีส คนอื่นๆ เป็นยังไงบ้าง	
VO_LOE_12_NAZJAR_TURN_5	กองทัพแห่งมหาสมุทร จงถาโถมใส่ศัตรูของเรา ดุจดั่งคลื่นแห่งความตาย!	
VO_LOE_12_NAZJAR_TURN_5_FINLEY	ฟังดูน่ากลัวไปหน่อยนะ	
VO_LOE_12_NAZJAR_TURN_7_FINLEY	*เสียงเจ็บปวด* มรกกกล! มรรกลมรรกล!	
VO_LOE_12_NAZJAR_TURN_7_FINLEY_2	ขอโทษที นักผจญภัย บางครั้งข้าอาจจะเผลอลืมตัวไปบ้าง	
VO_LOE_12_RESPONSE	ข้าคือผู้ครอบครองอำนาจแห่งไข่มุก!	
VO_LOE_12_START	อำนาจแห่งเกลียวคลื่น จะถาโถมเข้าใส่เจ้า!	
VO_LOE_12_WIN	ไชโย! ไข่มุกเป็นของเราแล้ว! ตามข้าไปที่ห้องโถงแห่งนักสำรวจสิ เราจะประกอบสมบัติที่ได้มาเข้าด้วยกัน!	
VO_LOE_13_RESPONSE	*คำราม*	
VO_LOE_13_START_2	*คำราม*	
VO_LOE_13_TURN_1	ไม้เท้านั่นต้องคำสาป! มันเรียกผู้ไร้รูปผ่านเกราะ ป้องกันของเราเข้ามา เขากำลังจะขโมยทุกอย่างไป!	
VO_LOE_13_TURN_1_2	ไม่ทุกอย่างหรอก แค่ของดีๆ เท่านั้นแหละ	
VO_LOE_13_TURN_5	อู้ววว นี่ใช่แหวนตราของ อาร์ธัสจริงเหรอเนี่ย แถมอยู่ในสภาพดีมากด้วย	
VO_LOE_13_TURN_5_2	รีโน่ แบรนน์ ซ่อนวัตถุโบราณเร็ว!	
VO_LOE_13_TURN_9	เขากำลังปลุกกองทัพขึ้นมา! เอลีส หยุดเขาไว้!	
VO_LOE_13_TURN_9_2	เทลแซ็กซัส นาลอร์! ไม้เท้ามีพลังมากเกินไป แต่ข้าพอจะถ่วงเวลาเขาได้!	
VO_LOE_13_WIN	เราจะช่วยดูแลห้องจัดแสดงเอง นักสำรวจ เจ้ารีบตามราฟามไปเถอะ!	
VO_LOE_14_RESPONSE	แกร๊ง	
VO_LOE_14_START	นั่นเกราะของโลธาร์นี่! ข้าล้วงอึมังกรในแบล็คร็อค\nอยู่เป็นเดือนเชียวนะ\nกว่าจะได้มา	
VO_LOE_14_TURN_13	แบรนน์ เขากำลังปลุกหนังสือ ในห้องสมุดขึ้นมา! ข้าจะ จัดการกับค้อนบินในห้อง จัดแสดงลอร์เดรอนเอง	
VO_LOE_14_TURN_5	ข้าจัดการดาบมีชีวิต ในโถงฝั่งตะวันออกไปแล้ว เอลีส ให้ข้าช่วยใครดี?	
VO_LOE_14_TURN_5_2	ไปช่วยรีโน่ในห้องเก็บของหลักเลย! บูมบอทล้อมเขาไว้อยู่!	
VO_LOE_14_TURN_9	พวกเจ้าดูยุ่งกันจัง งั้นข้าขอเข็มกลัด แสนสวยอันนี้ไปก็แล้วกัน	
VO_LOE_14_WIN	พิพิธภัณฑ์อยู่ในความควบคุมแล้ว นักสำรวจ ไปจัดการราฟามเลย!	
VO_LOE_15_RESPONSE	การ์ดเจ๋งดีนี่!	
VO_LOE_15_SPARE	นักสำรวจ! เรามีเด็คสำรอง ใช้นี่สิ	
VO_LOE_16_BOOM_BOT	ข้ามีเจ้าพวกนี้เหลืออยู่เพียบเลย จัดการมัน!	
VO_LOE_16_CROWN	เวทมนตร์ของจอมเวทผู้บ้าคลั่ง\nก่อกำเนิดสิ่งนี้ขึ้นมา	
VO_LOE_16_EYE	ตลกดี เจ้านี่ยังอยู่ในกระเป๋าของข้าอีก ข้าให้เจ้ายืมก็แล้วกัน	
VO_LOE_16_FIRST_ITEM	เรากำลังค้นหาของ ที่มีประโยชน์ในพิพิธภัณฑ์ อยากได้อะไรก็บอกมาเลย!	
VO_LOE_16_GOBLET	ข้าเกลียดงู	
VO_LOE_16_GREAVE	ชิ้นส่วนเกราะของโลธาร์ชิ้นนี้ รอดจากการทำลายของเจ้ามาได้	
VO_LOE_16_LOCKET	เหล่าภูตผีแห่งคาราซาน สิงสถิตอยู่ในจี้อันนี้	
VO_LOE_16_PIPE	รับไป! แต่อย่าบอกแบรนน์นะ เขาชอบไปป์อันนี้มาก!	
VO_LOE_16_RAFAAM_DEATH2	ไม่! ข้าไม่มีวันพ่ายแพ้!	
VO_LOE_16_SHARD	เจ้านี่อยูในกล่องที่เขียนไว้ว่า "ห้ามเปิด" งั้นก็...โชคดีนะ!	
VO_LOE_16_SPLINTER	ข้าได้เจ้านี่มาจากแกนหลอมเหลว เมเจอร์โดโมใช้มันแคะฟันมาก่อน	
VO_LOE_16_START_2	ไม้เท้ากำลังชาร์จพลัง ระวังนะ!	
VO_LOE_16_TEAR	นี่คือสมบัติศักดิ์สิทธิ์ ของเหล่าผู้ไร้รูป ดื่มซะสิ!	
VO_LOE_16_TURN_2	ไม้เท้าชาร์จพลังเกือบเต็มแล้ว เตรียมตัวนะ!	
VO_LOE_16_TURN_2_2	ฮ่าฮ่าฮ่า! พลังล้นเหลือ!	
VO_LOE_16_TURN_2_3	ไม้เท้ามีพลังมากเกินไปแล้ว! ลงมือเลย!	
VO_LOE_16_TURN_3	ข้าคือผู้ไร้เทียมทาน! เจ้าไม่มีวันเอาชนะข้าได้!	
VO_LOE_16_TURN_3_2	ไม้เท้ากำลังชาร์จพลังอีกครั้ง โอกาสครั้งต่อไปกำลังจะมา	
VO_LOE_16_TURN_4	ไม้เท้าเกือบจะพร้อมแล้ว เตรียมตัวให้ดี!	
VO_LOE_16_TURN_5	ฮ่าฮ่าฮ่า! พลังล้นเหลือ!	
VO_LOE_16_TURN_5_2	โล่ของเขาหายไปแล้ว! จัดการเลย!	
VO_LOE_16_TURN_6	โล่กลับมาอีกครั้งแล้ว ระวังตัวด้วย!	
VO_LOE_16_VIAL	มันเขียนว่า “เชิญดื่มฟรี” แต่เราเจอมันใน Naxxramas เลยไม่มีใครกล้าลอง	
VO_LOE_ARCHAEDAS_TURN_1_CARTOGRAPHER	ถ้าเขาไม่มัวแต่คิดจะฝัง เจ้าไว้ในหินน่ะนะ	
VO_LOE_GIANTFIN_TIDEHUNTER_2	ไม่ ฟินลีย์! เจ้าไม่เหมือนกับพวกนั้นนะ	
VO_LOE_NAZJAR_TURN_3_CARTOGRAPHER	รีโน่กลับมาแล้วพร้อมกับคทาแห่งตะวัน ส่วนแบรนน์ก็กำลังเดินทางมา	
VO_LOE_SCARVASH_TURN_6_CARTOGRAPHER	ตั้งสมาธิหน่อย แบรนน์!	
VO_LOE_ZINAAR_TURN_10_CARTOGRAPHER_2	เราไม่ได้จะเอาไปขายนะ	
VO_LOE_ZINAAR_TURN_6_CARTOGRAPHER_2	เล่าแล้ว	
VO_LOE_ZINAAR_TURN_6_CARTOGRAPHER_2_ALT	เล่าแล้ว	
VO_LOE10_DEAD_MURLOCS	สูญเสียมากมายเหลือเกิน ช่างน่าเสียดาย	
VO_LOE10_NYAH_FINLEY	โถ โถ อย่าทำตัวเป็นเด็กๆ ไปหน่อยเลย	
VO_LOE10_TIDEHUNTER	ข้าเคยใช้ชีวิตเป็นไทด์ฮันเตอร์ก่อนที่เอลีสจะพบข้า นี่หรือคือสิ่งที่ข้าต้องเป็น?	
VO_LOE10_TURN_2_FINLEY	พี่น้องข้า ร่วมมือกับเราเถอะ! เราไม่จำเป็นต้องสู้กันนะ!	
VO_LOE10_TURN_2_FINLEY_2	ข้าก็คิดไว้แล้วว่ามันต้องเป็นแบบนี้	
VO_LOEA04_BRANN_TURN_1	ครั้งก่อนที่เจอ สการ์วาชเป็นแค่ทร็อกก์ตัวจิ๋ว ตอนนี้เขาตัวใหญ่กว่าเดิม โง่กว่าเดิม แล้วก็น่าเกลียดกว่าเดิม	
VO_LOEA04_BRANN_TURN_6	น่าสนใจมาก รูนมิธริลพวกนี้มีรหัสผู้พิทักษ์อยู่ มันต้องมีมาตั้งแต่ยุคไททันแน่ๆ!	
VO_LOEA07_MINE_ALMOST_DONE	ใกล้ถึงแล้ว! สงสัยจังว่าปุ่มนี้มีไว้ทำอะไร…	
VO_LOEA07_MINE_ARCHAEDAS	เคราแม็กนิ นั่นอาร์เคดาสจริงๆ เหรอเนี่ย??	
VO_LOEA07_MINE_BARREL_FORWARD	เดินหน้าเต็มกำลัง!	
VO_LOEA07_MINE_BOOM	ระเบิดกระเด้ง! โดนซะบ้าง!	
VO_LOEA07_MINE_BOOMZOOKA	ตูม! เดี๋ยวข้าจะจัดให้อีกนัดนึง!	
VO_LOEA07_MINE_DETONATE	เจ้าจะระเบิดเหมืองงั้นเหรอ? บ้าหรือเปล่า!	
VO_LOEA07_MINE_DYNAMITE	ระวังหน่อยสิ! เจ้าทำรางพังไปแถบนึงแล้วนะ!	
VO_LOEA07_MINE_HUNKER_DOWN	หมอบลง!	
VO_LOEA07_MINE_PARROT	บินไปเลย จินนี่!	
VO_LOEA07_MINE_RAMMING	ฮ่าฮ่า! อย่ามาขวางเรา!	
VO_LOEA07_MINE_REPAIRS	แปะกิซซาร์ดกัมอีกนิด ก็ดีเหมือนใหม่แล้ว!	
VO_LOEA07_MINE_SPIKED_DECOY	เฮ้ย พวกทร็อกก์หน้าโง่! แน่จริงก็เข้ามาเลย!	
VO_LOEA08_TURN_1_BRANN	ผู้รับใช้แห่งไททันโบราณ เขาน่าจะเล่าอะไร ให้เราฟังได้เยอะแยะเลย	
VO_LOEA09_1_RESPONSE	อาหารเย็นมาแล้ว!	
VO_LOEA09_1_TURN1	เจ้ากล้าบุกเข้ามา ในนครร้างงั้นรึ?	
VO_LOEA09_FINLEY_DEATH	เดี๋ยวข้าก็ฟื้นตัวแล้ว นักสำรวจ จัดการนากานั่นเลย!	
VO_LOEA09_HERO_POWER	ถึงเวลามื้อเย็นแล้ว! คืนนี้เรามีซุปเมอร์ล็อค!	
VO_LOEA09_HERO_POWER1	สวัสดี นักสำรวจ ดูเหมือนข้าจะมีปัญหานิดหน่อย เจ้าพอจะช่วยสหายคนนี้ได้ไหม	
VO_LOEA09_HERO_POWER2	ข้าอยากจะบอกว่า[b]ในนี้มันมืดมาก!	
VO_LOEA09_HERO_POWER3	โอ ไม่นะ มันเริ่มอุ่นขึ้นแล้วใช่ไหม	
VO_LOEA09_HERO_POWER4	ขอบอกว่าแบบนี้ มันไม่ดีเอาเสียเลย!	
VO_LOEA09_HERO_POWER5	ในนี้ร้อนจริงๆ นะ	
VO_LOEA09_HERO_POWER6	ช่วยข้าซักหน่อย จะขอบคุณอย่างแรง	
VO_LOEA09_QUOTE1	ขอบคุณนะ เพื่อนยาก! เกือบไปแล้วเชียว!	
VO_LOEA09_UNSTABLE	กลับมาลงหม้อเดี๋ยวนี้นะ!	
VO_LOEA09_WIN	ขอขอบคุณจากใจเลย นักสำรวจ ให้ข้านำทางไปหาชิ้นสุดท้ายเลยไหม	
VO_LOEA10_1_MIDDLEFIN	มิดเดิ้ลฟิน เจ้ามาทำอะไรที่นี่น่ะ?	
VO_LOEA15_1_LOSS_11	เด็คของเจ้ามันไม่ได้เรื่อง ถึงเวลาใช้ของข้าแล้ว	
VO_LOEA15_1_LOW_HEALTH_10	ดูเหมือนข้าจะตัดสินใจผิด[b]ที่ใช้เด็คของเจ้า	
VO_LOEA15_1_MAGMA_RAGER_09	แม็กม่าเรจเจอร์?! ใช้การ์ดแบบนี้ด้วยเหรอ?	
VO_LOEA15_1_START_07	ข้าชอบเด็คของเจ้านะ งั้นข้าขอก็แล้วกัน	
VO_LOEA15_1_TURN1_08	โอ้โหเฮะ การ์ดในมือข้าตอนนี้สุดยอดเลย	
VO_LOEA15_1_WIN_12	เด็คของเจ้าเยี่ยมมาก ฮ่าฮ่าฮ่าฮ่าฮ่า!	
VO_LOEA15_GOLDEN	ทั้งเด็คเป็นการ์ด สีทองหมดเลยเหรอ? คอลเลกชันเจ้า สูสีกับของข้าเลยนะ!	
VO_LOEA16_1_CARD_04	ข้ารวบรวมวัตถุโบราณ มาจากโลกนับร้อย!	
VO_LOEA16_1_RESPONSE_03	ใช่! ใช่เลย!	
VO_LOEA16_1_START_01	จงดู พลังสูงสุดของไม้เท้า!	
VO_LOEA16_1_TURN1_02	ข้าไร้เทียมทาน! ข้าคือผู้ครอบครอง อำนาจแห่งไททัน!	
VO_LOOT_329_Male_Elemental_Attack_01	เน่าเปื่อย	
VO_LOOT_329_Male_Elemental_Death_01	<ตาย>	
VO_LOOT_329_Male_Elemental_Play_01	เห็ดราคร่าชีวิต	
VO_LOOT_541_Male_Kobold_BOSS_AFKay_01	จัดการเลย! พุ่งเข้าใส่มนุษย์ก่อนที่นางจะสนใจ!	
VO_LOOT_541_Male_Kobold_BOSS_Blackseed_01	แบล็คซีดแอบเข้าไปในอุโมงค์ลึก กลับมาพร้อมหนวดดุกดิก	
VO_LOOT_541_Male_Kobold_BOSS_Brimstone_01	ชู่วววว! รูปปั้นมีตา ตามันกะพริบได้ ห้ามปลุก!	
VO_LOOT_541_Male_Kobold_BOSS_Candlebeard_01	แคนเดิลเบียร์ดคิดว่าการขุดสมบัติที่ฝังดิน[b]ทำให้โคโบลด์เป็นโจรสลัด 	
VO_LOOT_541_Male_Kobold_BOSS_Chronomancer_01	แม่มดเวลา! เจอกันเป็นครั้งแรกอีกแล้ว!	
VO_LOOT_541_Male_Kobold_BOSS_Everrot_01	ห้ามแตะสปอร์! ให้มินเนี่ยนแตะแทน	
VO_LOOT_541_Male_Kobold_BOSS_Flurgl_01	โคโบลด์ไม่เข้าใจเมอร์ล็อคเลย พวกมันพูดเหมือนพูดเป็นฟังไม่รู้เรื่อง!	
VO_LOOT_541_Male_Kobold_BOSS_GeorgeKarl_01	สองคนนี้หลงทางเป็นวันๆ มาจากในป่า 	
VO_LOOT_541_Male_Kobold_BOSS_Gnosh_01	อุโมงค์นี้ไม่ใช่อุโมงค์! ปากกว้าง! ฟันเต็มปาก!	
VO_LOOT_541_Male_Kobold_BOSS_Graves_01	"นักบวชหลงทางชอบพูดพล่าม "เมตตา-เมตตา" ฆ่ามันเลย!"	
VO_LOOT_541_Male_Kobold_BOSS_Gutmook_01	ทร็อกก์ เฮอะ เงียบปากไว้แล้วให้มินเนี่ยนจัดการดีกว่า	
VO_LOOT_541_Male_Kobold_BOSS_Hamm_01	แฮมม์ขุดอุโมงค์เก่งที่สุด "ขุด" เป็นคำพูดสวยหู	
VO_LOOT_541_Male_Kobold_BOSS_Jeeru_01	โอ้ ไม่ ไม่ ไม่ ไม่ อย่าถูตะเกียง! มันเป็นกับดัก	
VO_LOOT_541_Male_Kobold_BOSS_Lyris_01	เอลฟ์บ้ายิงแสงไม่สนใจใคร! ระวังมนุษย์งูไฟขู่ฟ่อของนางด้วย!	
VO_LOOT_541_Male_Kobold_BOSS_MagmaRager_01	โคโบลด์อุดท่อลาวาแล้ว แต่อยู่ๆ มันก็เปิดเองตลอดเลย	
VO_LOOT_541_Male_Kobold_BOSS_Mothergloop_01	ระวังมาเธอร์กลู๊ป กลู๊ปที่เกิดจากกลู๊ปอื่นรวมตัวกันเป็นกลู๊ป!	
VO_LOOT_541_Male_Kobold_BOSS_Mushhuckster_01	นักค้าเห็ด แมกซ์ มาจากเขตเสื่อมโทรมของดันเจี้ยน	
VO_LOOT_541_Male_Kobold_BOSS_Russell_01	นักกวีร้องเพลงที่ทำให้ทั้งโลกตีแสกหน้ากัน	
VO_LOOT_541_Male_Kobold_BOSS_Seriona_01	มังกรสนธยางี่เง่าทำให้โคโบลด์อ่อนแอ! เอ่อ ยิ่งกว่าเดิม!	
VO_LOOT_541_Male_Kobold_BOSS_Sturmi_01	สเตอร์มิสร้างเพื่อนตัวเล็กจากขี้ผึ้ง! โอ้! นางทำให้ปาร์ตี้โคโบลด์สนุกมาก 	
VO_LOOT_541_Male_Kobold_BOSS_TrappedRoom_01	ชู่ววว... ห้ามแตะ... อะไร... ทั้งนั้น...	
VO_LOOT_541_Male_Kobold_BOSS_TreasureVault_01	สมบัติ! สมบัติอยู่นี่ มาหยิบไปเร็ว!	
VO_LOOT_541_Male_Kobold_BOSS_Troll_01	ดันเจี้ยนที่ดีต้องมีบอสเป็นโทรลล์อย่างน้อยหนึ่งตัว	
VO_LOOT_541_Male_Kobold_BOSS_Whopwhisker_01	วอมป์วิสเกอร์คือโคโบลด์ที่ขี้โมโหที่สุด	
VO_LOOT_541_Male_Kobold_DefeatPlayer_01	สมบัติเยอะแยะเลย! เฮะเฮะ ของข้า ของข้า ของข้า ของข้า ของข้า...	
VO_LOOT_541_Male_Kobold_EmoteResponse_01	เลิกพล่ามซะที	
VO_LOOT_541_Male_Kobold_LOOT_Backpacks_01	กระเป๋าสะพายหลัง! เดี๋ยวนี้สะพายตรงไหนก็ได้แล้ว	
VO_LOOT_541_Male_Kobold_LOOT_Boombox_01	บูมบอกซ์! กล่องบรรจุระเบิดที่ระเบิดระเบ้อที่สุด!	
VO_LOOT_541_Male_Kobold_LOOT_Candle1_01	อย่าเอาเทียนไป!	
VO_LOOT_541_Male_Kobold_LOOT_Candle2_01	ข้าเตือนแล้ว! ข้าเตือนแล้วว่าอย่าเอาไปแต่เจ้าก็ยังเอาไป!!	
VO_LOOT_541_Male_Kobold_LOOT_CapturedFlag_01	พันธมิตรกับชนเผ่าแย่งธงกันเหมือนคนบ้า 	
VO_LOOT_541_Male_Kobold_LOOT_Cube_01	โอ้ กล่องลูกบาศก์บ้าบอ! เมื่อชัยชนะไม่สำคัญอีกต่อไป!	
VO_LOOT_541_Male_Kobold_LOOT_Invisibility_01	เสื้อคลุมล่องหน! ข้าทำหายอยู่เรื่อย! เพราะมันล่องหน	
VO_LOOT_541_Male_Kobold_LOOT_QuelDelar_01	เควล'เดลาร์! ดาบในตำนานที่หักเป็นสองท่อน ข้าไม่ได้ทำนะ	
VO_LOOT_541_Male_Kobold_LOOT_QuelDelarForged_01	สวยจัง! แวววาวจัง! เหมือนดาบจัง!	
VO_LOOT_541_Male_Kobold_LOOT_Wand_01	โคโบลด์ยกให้คทาย่างสดเป็นการ์ดทดสอบฝีมือของจริง	
VO_LOOT_541_Male_Kobold_LOOT_WaxRager_01	แว็กซ์เรจเจอร์เป็นเพื่อนแข็งแกร่ง ห้ามถามว่าทำมาจากอะไร ขี้หู	
VO_LOOT_541_Male_Kobold_TUT_AdventureSelect_01	นี่มันกลิ่นอะไร หนัง? โลหะ? คบไฟ… นักผจญภัย เฮอะ! นักผจญภัย!	
VO_LOOT_541_Male_Kobold_TUT_BossHeroPower_01	มอนสเตอร์แต่ละตัวไม่เหมือนกันเลย แต่ร้ายกาจทุกตัว ลองคลิกดูสิ!	
VO_LOOT_541_Male_Kobold_TUT_BountyBoard_01	หยุด! กลับไปเลย! สมบัติกองใหญ่ของข้า ไม่ใช่ของเจ้า	
VO_LOOT_541_Male_Kobold_TUT_CharacterSelect_01	ใครกันกล้าขโมยสมบัติโคโบลด์ พวกแกว่งดาบ? หรือพวกยิงแสง?	
VO_LOOT_541_Male_Kobold_TUT_Final_Boss_Azari_01	ผู้กลืนกินหลุดออกมาแล้ว! หนีเร็ว! 	
VO_LOOT_541_Male_Kobold_TUT_Final_Boss_Darkness_01	เจ้าต้องระวังความมืด! เพราะอย่างนี้ไงโคโบลด์ถึงสะสมเทียน	
VO_LOOT_541_Male_Kobold_TUT_Final_Boss_KoboldKing_01	เทิร์นข้า แฮะแฮ่! ข้าจะเก็บตกสมบัติทั้งหมดที่เจ้าทำตก!	
VO_LOOT_541_Male_Kobold_TUT_Final_Boss_Vustrasz_01	เจ้าจะขโมยสมบัติมังกรเหรอ อู้ว เขาต้องยัวะมากเลย...	
VO_LOOT_541_Male_Kobold_TUT_Final_Boss_Xol_01	อย่ามองตาโซลนะ! นางมีตาทั่วหน้าบานๆ นั่นเลย 	
VO_LOOT_541_Male_Kobold_TUT_Game1Begin1_01	มอนสเตอร์พวกแรกที่เจอ ตัวเล็กและอ่อนแอ เจ้าก็เหมือนกัน!	
VO_LOOT_541_Male_Kobold_TUT_Game1Begin2_01	กำจัดพวกมัน ชิงสมบัติมา แล้วเจ้าจะแข็งแกร่งขึ้น! 	
VO_LOOT_541_Male_Kobold_TUT_Game1Defeat_01	ไม่เป็นไร ตายซะก่อนจะไม่ได้ตาย 	
VO_LOOT_541_Male_Kobold_TUT_Game1Victory_01	เจ้าชนะ! เก็บสมบัติซะสิ แฮะแฮ่ สมกับเป็นนักผจญภัย	
VO_LOOT_541_Male_Kobold_TUT_Game2Begin1_01	ยิ่งเจ้าเก่งขึ้น มอนสเตอร์ก็เก่งขึ้นด้วย 	
VO_LOOT_541_Male_Kobold_TUT_Game2Begin2_01	ความยืดหยุ่นทางการเงิน[b]คือส่วนสำคัญของ[b]ลัทธิเศรษฐกิจแบบผสม[b]ของอาณาจักรโคโบลด์	
VO_LOOT_541_Male_Kobold_TUT_GeneralDefeat1_01	โชคร้ายหน่อย สำหรับเจ้า ถ้านักผจญภัยตาย ราชาโคโบลด์ก็จะได้สมบัติทั้งหมด!	
VO_LOOT_541_Male_Kobold_TUT_GeneralDefeat2_01	ส่งนักผจญภัยมาอีก! แฮะแฮ่! เอาสมบัติมาอีก สมบัติ สมบัติ สมบัติ...	
VO_LOOT_541_Male_Kobold_TUT_MainBoss1_01	เจ้าจะเจอมอนสเตอร์เยอะแยะในอาณาจักรโคโบลด์ ทุกการต่อสู้จะทำให้เจ้าแกร่งขึ้น! ...หรือไม่ก็ตาย	
VO_LOOT_541_Male_Kobold_TUT_MainBoss3_01	ลงดันเจี้ยนแต่ละครั้งต้องต่อสู้กับมอนสเตอร์แปดตัว! ตามจำนวนนิ้วมือ	
VO_LOOT_541_Male_Kobold_TUT_TreasureSelect1_01	โอ้ สมบัติใหญ่! เลือกได้หนึ่งอย่าง อย่างเดียวนะ เลือกให้ดี	
VO_LOOT_541_Male_Kobold_TUT_TreasureSelect2_01	การ์ดที่เลือกตอนนี้จะไปอยู่ในเด็คดันเจี้ยนของเจ้า	
VO_LOOT_541_Male_Kobold_TUT_TreasureSelect3_01	สร้างเด็คเพื่อกำจัดมอนสเตอร์ เด็คนี้จะอยู่กับเจ้าไปจนตาย!	
VO_LOOT_541_Male_Kobold_TUT_TreasureSelect4_01	สู้ชนะเยอะก็ได้สมบัติเยอะขึ้น! นี่แหละวิถีโคโบลด์!	
VO_LOOT_541_Male_Kobold_TUT_Victory1_01	ไม่จริง! ไม่มีใครเอาสมบัติโคโบลด์ไปได้!	
VO_LOOT_541_Male_Kobold_TUT_Victory2_01	ยิ่งเก้าครั้งยิ่งเป็นไปไม่ได้!	
VO_LOOT_541_Male_Kobold_TUT_VictoryComplete_01	เจ้าทำได้! เจ้ารู้จักดันเจี้ยนดีเหมือนคนสร้างดันเจี้ยนเลย! 	
VO_LOOT_541_Male_Kobold_TUT_VictoryComplete_02	เจ้าทำได้! เจ้าเป็นดันเจี้ยนมาสเตอร์แล้ว! 	
VO_LOOTA_829_Male_Human_Event_01	ข้าขอสาปแช่งตัวข้า ไอ้คนทรยศ!	
VO_LOOTA_BOSS_04h_Female_Kobold_Death_01	<ตาย>	
VO_LOOTA_BOSS_04h_Female_Kobold_DefeatPlayer_01	อยู่นิ่งๆ! รอขี้ผึ้งเย็นก่อน… น่ารัก น่ารัก น่ารักจังเลย…	
VO_LOOTA_BOSS_04h_Female_Kobold_EmoteResponse_01	ข้าทำขี้ผึ้ง ไม่ใช่ขี้ขี้	
VO_LOOTA_BOSS_04h_Female_Kobold_EventWaxOff_01	ขี้ผึ้งหยุด…	
VO_LOOTA_BOSS_04h_Female_Kobold_EventWaxOn_01	ขี้ผึ้งมา!	
VO_LOOTA_BOSS_04h_Female_Kobold_EventWaxRagerPlay_01	โอ้โห… หล่อจัง!	
VO_LOOTA_BOSS_04h_Female_Kobold_EventWaxRagerRespawn_01	โอ มาไม่หยุดเลยใช่มั้ยล่ะ	
VO_LOOTA_BOSS_04h_Female_Kobold_Intro1_01	อ๋อใช่ ขี้ผึ้งมีตา...	
VO_LOOTA_BOSS_04h_Female_Kobold_Intro2_01	ข้าทำของน่ารักๆ อย่างขี้ผึ้งน่ารักๆ	
VO_LOOTA_BOSS_05h_Male_Kobold_Death_01	<ตาย>	
VO_LOOTA_BOSS_05h_Male_Kobold_DefeatPlayer_01	แฮมม์เจ๋งระเบิด! 	
VO_LOOTA_BOSS_05h_Male_Kobold_EmoteResponse_01	อย่าเอาบูม-บูมไป	
VO_LOOTA_BOSS_05h_Male_Kobold_EventBoomBots_01	ดี ดีมาก! ดี ดี ดี!	
VO_LOOTA_BOSS_05h_Male_Kobold_EventMadBomberDeath_01	ไม่ใช่แบบนี้…!	
VO_LOOTA_BOSS_05h_Male_Kobold_HeroPower1_01	ระเบิดมั้ยจ๊ะ ตูม!	
VO_LOOTA_BOSS_05h_Male_Kobold_HeroPower2_01	ฮ่าฮ่าฮ่า	
VO_LOOTA_BOSS_05h_Male_Kobold_HeroPower3_01	ฮ่าฮ่าฮ่าฮ่า	
VO_LOOTA_BOSS_05h_Male_Kobold_Intro_01	ถึงเวลาระเบิดแล้วซี!	
VO_LOOTA_BOSS_06h_Male_Furbolg_Death_01	ลึกลงไปข้างล่าง ยังมีอีก…	
VO_LOOTA_BOSS_06h_Male_Furbolg_DefeatPlayer_01	ข้า... ข้าฆ่ามันเหรอ ข้าทำอะไรลงไป...	
VO_LOOTA_BOSS_06h_Male_Furbolg_EmoteResponse_01	เจ้าก็แค่เสียง… อีกเสียงหนึ่ง…	
VO_LOOTA_BOSS_06h_Male_Furbolg_EventPlayerEvolves_01	เจ้าแปดเปื้อนด้วยความมืด!	
VO_LOOTA_BOSS_06h_Male_Furbolg_HeroPower1_01	มันเรียกข้า…	
VO_LOOTA_BOSS_06h_Male_Furbolg_HeroPower2_01	ถ้ำมันลึกเหลือเกิน	
VO_LOOTA_BOSS_06h_Male_Furbolg_HeroPower3_01	ทุกสิ่งไม่เป็นอย่างที่เห็น...	
VO_LOOTA_BOSS_06h_Male_Furbolg_HeroPower4_01	ใครกันแน่เป็น[b]สัตว์ประหลาด	
VO_LOOTA_BOSS_06h_Male_Furbolg_HeroPower5_01	เจ้าไม่เห็นเงามืด... แต่มันเห็นเจ้า	
VO_LOOTA_BOSS_06h_Male_Furbolg_Intro_01	สิ่งชั่วร้ายชอนไชอยู่ที่นี่…	
VO_LOOTA_BOSS_09h_Female_Furbolg_Death_01	<ตาย>	
VO_LOOTA_BOSS_09h_Female_Furbolg_DefeatPlayer_01	ที่วินเทอร์สปริงเขา[b]ทำกันอย่างนี้แหละ	
VO_LOOTA_BOSS_09h_Female_Furbolg_EmoteResponse_01	เย็นชาจริงๆ	
VO_LOOTA_BOSS_09h_Female_Furbolg_EventFrostMagic1_01	เจ้าก็ใช้พลังไอเย็นด้วยสินะ	
VO_LOOTA_BOSS_09h_Female_Furbolg_EventFrostMagic2_01	<หนาวสั่น>	
VO_LOOTA_BOSS_09h_Female_Furbolg_EventFrostMagic3_01	หนาวมาก!	
VO_LOOTA_BOSS_09h_Female_Furbolg_HeroPower1_01	อยู่นิ่งๆ ซักพักนะ	
VO_LOOTA_BOSS_09h_Female_Furbolg_HeroPower2_01	ไม่เอาน่า อย่าดีกว่า	
VO_LOOTA_BOSS_09h_Female_Furbolg_HeroPower3_01	อยู่เฉยๆ	
VO_LOOTA_BOSS_09h_Female_Furbolg_Intro_01	ข้าบอกพวกโคโบลด์[b]ของเจ้าแล้วไง [b]- อ้าว - ใครกันล่ะเนี่ย	
VO_LOOTA_BOSS_10h_Male_Human_Death_01	มันถูกกำหนดไว้แล้ว...	
VO_LOOTA_BOSS_10h_Male_Human_DefeatPlayer_02	ข้าขอรับสมบัติพวกนี้ ในนามแห่งแสง! และนามข้าเอง	
VO_LOOTA_BOSS_10h_Male_Human_EmoteResponse_01	ขอความเมตตาไป[b]ก็ไร้ประโยชน์	
VO_LOOTA_BOSS_10h_Male_Human_EventOverdraw_01	อย่ามาทำตัวนอร์ธไชร์กับข้า!	
VO_LOOTA_BOSS_10h_Male_Human_HeroPower1_01	จงศรัทธา!	
VO_LOOTA_BOSS_10h_Male_Human_HeroPower2_01	เจ้าหายแล้ว!	
VO_LOOTA_BOSS_10h_Male_Human_HeroPower3_01	จงหันหลังให้ความมืด!	
VO_LOOTA_BOSS_10h_Male_Human_HeroPower4_01	แสงสว่างเมตตาทุกคน	
VO_LOOTA_BOSS_10h_Male_Human_HeroPower5_01	ประเสริฐนัก!	
VO_LOOTA_BOSS_10h_Male_Human_Intro_01	ช้าก่อน! ข้าขอรับ[b]สมบัติพวกนี้[b]ในนามแห่งแสง!	
VO_LOOTA_BOSS_11h_Male_Trogg_Death_01	<ตาย>	
VO_LOOTA_BOSS_11h_Male_Trogg_DefeatPlayer_01	ผู้นำดีต้องชี้ทาง ช่วยทำ และใช้แส้	
VO_LOOTA_BOSS_11h_Male_Trogg_EmoteResponse_01	อย่าพูดด้วยปาก ต้องพูดด้วยแส้!	
VO_LOOTA_BOSS_11h_Male_Trogg_EventEquality_01	เฮ้ย มินเนี่ยนโดนเฆี่ยนมาแล้ว!	
VO_LOOTA_BOSS_11h_Male_Trogg_HeroPower1_01	ไปได้แล้ว!	
VO_LOOTA_BOSS_11h_Male_Trogg_HeroPower2_01	เร็วเข้า!	
VO_LOOTA_BOSS_11h_Male_Trogg_HeroPower3_01	เร็วอีก! 	
VO_LOOTA_BOSS_11h_Male_Trogg_HeroPower4_01	เร่งหน่อย!	
VO_LOOTA_BOSS_11h_Male_Trogg_HeroPower5_01	หวดให้จำ	
VO_LOOTA_BOSS_11h_Male_Trogg_Intro_01	เตรียมเจ็บตัว!	
VO_LOOTA_BOSS_12h_Male_Kobold_CandleAttack1_01	เจ้าทำให้เทียนโกรธมาก!	
VO_LOOTA_BOSS_12h_Male_Kobold_CandleAttack2_01	อย่ายั่วโมโหเทียน!	
VO_LOOTA_BOSS_12h_Male_Kobold_CandleAttack3_01	รัคคานิชู!	
VO_LOOTA_BOSS_12h_Male_Kobold_CandleAttack4_01	เทียนพิฆาต!	
VO_LOOTA_BOSS_12h_Male_Kobold_CandleAttack5_01	เทียนข้าเจ๋งที่สุด!	
VO_LOOTA_BOSS_12h_Male_Kobold_Death_01	อย่า… เอา…	
VO_LOOTA_BOSS_12h_Male_Kobold_Death1_01	ข้าโดนถ่วงน้ำ!	
VO_LOOTA_BOSS_12h_Male_Kobold_Death2_01	โย่โฮ่...โฮ...	
VO_LOOTA_BOSS_12h_Male_Kobold_Death3_01	เรือล่มแล้ว!	
VO_LOOTA_BOSS_12h_Male_Kobold_DefeatPlayer_01	ฮ่า-ฮ่าร์! ผิดแผนใช่มั้ยล่ะเจ้าเซ่อ!	
VO_LOOTA_BOSS_12h_Male_Kobold_DefeatPlayer_02	สมบัติเยอะแยะ! เฮะเฮะ ข้าจะเอาไปอวดราฟาม...	
VO_LOOTA_BOSS_12h_Male_Kobold_EmoteResponse_01	พวกมุดถ้ำไสหัวไปซะ!	
VO_LOOTA_BOSS_12h_Male_Kobold_EventCandleStolen_01	อะไรกัน!? ข้าบอก[b]ข้อห้ามเรื่องเทียน[b]ชัดแล้วนะ!	
VO_LOOTA_BOSS_12h_Male_Kobold_EventChargeBigMinion_01	โอ้ โฮ่ โฮ่!	
VO_LOOTA_BOSS_12h_Male_Kobold_EventFindCandle_01	โอ้ เทียนจ๋า! ชู่ววว อย่าร้องนะ... มาหาข้า มาหาข้า...	
VO_LOOTA_BOSS_12h_Male_Kobold_EventPlayCandle_01	บอกแล้วว่าอย่าเอาไป!	
VO_LOOTA_BOSS_12h_Male_Kobold_EventPlayerPlaysCrab_01	เอามันไปไกลๆ!	
VO_LOOTA_BOSS_12h_Male_Kobold_EventPlayerPlaysPatches_01	ไม่! ข้านี่แหละคุม! ข้า!	
VO_LOOTA_BOSS_12h_Male_Kobold_EventPlayKoboldKing_01	เจ้าโจรกบฏ!!	
VO_LOOTA_BOSS_12h_Male_Kobold_GetTreasure1_01	ข้าก็ได้สมบัติเหมือนกัน!	
VO_LOOTA_BOSS_12h_Male_Kobold_GetTreasure2_01	ของล้ำค่าให้ราชาโคโบลด์...	
VO_LOOTA_BOSS_12h_Male_Kobold_GetTreasure3_01	ข้าได้อะไรน่ะ โอ้! ดีจัง!	
VO_LOOTA_BOSS_12h_Male_Kobold_GetTreasure4_01	อา... สมบัติ! 	
VO_LOOTA_BOSS_12h_Male_Kobold_GetTreasure5_01	ดันเจี้ยนของข้า! สมบัติของข้า!	
VO_LOOTA_BOSS_12h_Male_Kobold_Intro_01	วางสมบัติของเจ้าเดี๋ยวนี้! ข้าจะเอา! ของข้า!	
VO_LOOTA_BOSS_12h_Male_Kobold_Intro1_01	เทียนข้าสว่างวาบ!	
VO_LOOTA_BOSS_12h_Male_Kobold_Intro2_01	หนวดข้ากระตุก!	
VO_LOOTA_BOSS_12h_Male_Kobold_Intro3_01	จอบในมือข้าสั่น!	
VO_LOOTA_BOSS_13h_Female_Undead_Death_01	<ตาย>	
VO_LOOTA_BOSS_13h_Female_Undead_DefeatPlayer_01	ไหนดูซิมีอะไรบ้าง...?[b]นึกยังไงเลือกการ์ด[b]พวกนี้มาเนี่ย	
VO_LOOTA_BOSS_13h_Female_Undead_EmoteResponse_01	เจ้าเพิ่งเคยมาดันเจี้ยนเหรอ แถวนี้เขาไม่ค่อยคุยกันหรอก 	
VO_LOOTA_BOSS_13h_Female_Undead_EventBagOfCoins_01	โอ้โห นักผจญภัยมีฐานะ...	
VO_LOOTA_BOSS_13h_Female_Undead_EventStealQuest_01	หยุดนะ! ขโมย!	
VO_LOOTA_BOSS_13h_Female_Undead_HeroPower_01	ข้างหลังข้า!	
VO_LOOTA_BOSS_13h_Female_Undead_HeroPower1_01	ถอยไป	
VO_LOOTA_BOSS_13h_Female_Undead_HeroPower2_01	เร็วเข้า 	
VO_LOOTA_BOSS_13h_Female_Undead_HeroPower3_01	แวบไปแวบมา…	
VO_LOOTA_BOSS_13h_Female_Undead_HeroPower4_01	อย่าชี้เป้าให้พวกมันสิ	
VO_LOOTA_BOSS_13h_Female_Undead_Intro_01	ส่งสมบัติมา แล้วเจ้าจะตายแบบไม่ทรมาน	
VO_LOOTA_BOSS_15h_Male_Human_Death_01	<ตาย>	
VO_LOOTA_BOSS_15h_Male_Human_DefeatPlayer_01	เอาละ ถ้าเราไปทางนี้ เราน่าจะกลับไปอัน'โกโรได้	
VO_LOOTA_BOSS_15h_Male_Human_EmoteResponse_01	ข้าเคยเจอเจ้าที่[b]อัน'โกโรไม่ใช่เหรอ	
VO_LOOTA_BOSS_15h_Male_Human_Intro_01	ให้ตายเถอะคาร์ล ดูสิว่าเราโผล่มาที่ไหน! 	
VO_LOOTA_BOSS_15h_Male_Human_PartnerDeath_01	สวรรค์ช่วย เจ้าฆ่าคาร์ล!	
VO_LOOTA_BOSS_15h_Male_Human_TaggedIn1_01	หลีกไป ข้าจัดการเอง	
VO_LOOTA_BOSS_15h_Male_Human_TaggedIn2_01	ตลกสิ้นดี เอาการ์ดมาให้ข้า	
VO_LOOTA_BOSS_15h_Male_Human_TaggedIn3_01	ถอยไป ถึงเทิร์นข้าแล้ว!	
VO_LOOTA_BOSS_16h_Male_Troll_Death_01	ข้าต้องพูดกับตัวเองแล้ว!	
VO_LOOTA_BOSS_16h_Male_Troll_DefeatPlayer_01	นี่นี่ ไม่ต้องห่วงนะเจ้าคนตาย อาซูนอยู่เป็นเพื่อนให้เอง 	
VO_LOOTA_BOSS_16h_Male_Troll_EmoteResponse_01	ข้าพูดกับคนตาย แต่เจ้าพูดคนเดียว	
VO_LOOTA_BOSS_16h_Male_Troll_EventPlayerDeathrattle1_01	ฮ่า เฮ้ ใช้ได้เลยพวก	
VO_LOOTA_BOSS_16h_Male_Troll_EventPlayerDeathrattle2_01	ไม่มีใครได้หลับสบายหรอก 	
VO_LOOTA_BOSS_16h_Male_Troll_EventPlayerDeathrattle3_01	เดี๋ยวข้ายื่นมือช่วยเอง 	
VO_LOOTA_BOSS_16h_Male_Troll_EventPlayerDeathrattle4_01	เจ้านั่นตายซะดีกว่าอยู่	
VO_LOOTA_BOSS_16h_Male_Troll_EventPlayerDeathrattle5_01	เกิดครั้งเดียวตายสองครั้ง เฮะเฮะ	
VO_LOOTA_BOSS_16h_Male_Troll_Intro_01	ข้าพูดกับคนตาย! สบายดีมั้ย สบายดี 	
VO_LOOTA_BOSS_17h_Male_Troll_Death_01	<ตาย>	
VO_LOOTA_BOSS_17h_Male_Troll_DefeatPlayer_01	เจ้ามอบการต่อสู้ให้จิน'โซ? จิน'โซมอบความเจ็บปวดให้เจ้า	
VO_LOOTA_BOSS_17h_Male_Troll_EmoteResponse_01	อย่ามัวแต่คุยกัน เวลานี้ต้องคำราม!	
VO_LOOTA_BOSS_17h_Male_Troll_EventPlayerBattlecry1_01	ใจมันได้ ข้าชอบ	
VO_LOOTA_BOSS_17h_Male_Troll_EventPlayerBattlecry2_01	จิน'โซชอบ!	
VO_LOOTA_BOSS_17h_Male_Troll_EventPlayerBattlecry3_01	ดีมาก เจ้านี่พูด[b]ภาษาเดียวกับจิน'โซ!	
VO_LOOTA_BOSS_17h_Male_Troll_EventPlayerBrann_01	คนแคระจิ๋วคิดว่า[b]ตะโกนดังกว่าจิน'โซ[b]เหรอ ไม่มีทาง!	
VO_LOOTA_BOSS_17h_Male_Troll_Intro_01	จิน'โซเตรียม[b]แผนการใหญ่[b]ไว้ให้เจ้า!	
VO_LOOTA_BOSS_19h_Male_Trogg_Death_01	<ตาย>	
VO_LOOTA_BOSS_19h_Male_Trogg_DefeatPlayer_01	ใครตุกติกจะโดนเฆี่ยน	
VO_LOOTA_BOSS_19h_Male_Trogg_EmoteResponse_01	เจ้าชอบทร็อกก์มั้ย ข้ามีทร็อกก์	
VO_LOOTA_BOSS_19h_Male_Trogg_EventHandFull_01	เงียบได้แล้ว - ข้า - เอ่อ มากไป!	
VO_LOOTA_BOSS_19h_Male_Trogg_HeroPower1_01	มานี่ ทร็อกก์!	
VO_LOOTA_BOSS_19h_Male_Trogg_HeroPower2_01	พูดต่อสิ ข้ามีอีก	
VO_LOOTA_BOSS_19h_Male_Trogg_HeroPower3_01	พวกมันได้กลิ่นเวทมนตร์	
VO_LOOTA_BOSS_19h_Male_Trogg_HeroPowerHard1_01	พลังมากเหลือเกิน	
VO_LOOTA_BOSS_19h_Male_Trogg_HeroPowerHard2_01	พูดอีกสิ	
VO_LOOTA_BOSS_19h_Male_Trogg_HeroPowerHard3_01	อาาาา… เวทมนตร์…	
VO_LOOTA_BOSS_19h_Male_Trogg_Intro_01	คุกเข่าให้ทร็อกก์!	
VO_LOOTA_BOSS_20h_Male_Earthen_Death_01	ง่วงแล้ว…	
VO_LOOTA_BOSS_20h_Male_Earthen_DefeatPlayer_01	สถานที่นี้ปลอดภัยแล้ว	
VO_LOOTA_BOSS_20h_Male_Earthen_EmoteResponse_01	ไม่มีใครหยุดข้าได้	
VO_LOOTA_BOSS_20h_Male_Earthen_EventPlayerSilence_01	อ้าว... ขอบใจมาก	
VO_LOOTA_BOSS_20h_Male_Earthen_EventStatueDestroyed1_01	เจ้าทำได้แค่ถ่วงเวลาเท่านั้น	
VO_LOOTA_BOSS_20h_Male_Earthen_EventStatueDestroyed2_01	อะไรจะเกิดก็ต้องเกิด	
VO_LOOTA_BOSS_20h_Male_Earthen_EventStatueDestroyed3_01	เจ้าลบหลู่ที่แห่งนี้	
VO_LOOTA_BOSS_20h_Male_Earthen_EventStatueDestroyed4_01	ข้า... ต้องปกป้อง... ที่นี่...	
VO_LOOTA_BOSS_20h_Male_Earthen_EventStatueDestroyed5_01	ใจข้าแกร่งดั่งหินผา...	
VO_LOOTA_BOSS_20h_Male_Earthen_HeroPower_01	จงตื่นขึ้น!	
VO_LOOTA_BOSS_20h_Male_Earthen_HeroPowerNoStatues_01	จงตื่นขึ้น! ...อ้าว	
VO_LOOTA_BOSS_20h_Male_Earthen_Intro_01	จงไปซะ ข้าไม่มีสิ่งใดให้เจ้า	
VO_LOOTA_BOSS_22h_Male_Murloc_Death_01	<ตาย>	
VO_LOOTA_BOSS_22h_Male_Murloc_DeathSpecial_01	...!!	
VO_LOOTA_BOSS_22h_Male_Murloc_DefeatPlayer_01	...! ...?	
VO_LOOTA_BOSS_22h_Male_Murloc_EmoteResponse_01	...?!	
VO_LOOTA_BOSS_22h_Male_Murloc_EventFishUpChest_01	...	
VO_LOOTA_BOSS_22h_Male_Murloc_EventSummonCrab_01	...!!	
VO_LOOTA_BOSS_22h_Male_Murloc_FishLarge_02	...!	
VO_LOOTA_BOSS_22h_Male_Murloc_FishMedium_01	...?	
VO_LOOTA_BOSS_22h_Male_Murloc_FishSmall_01	...	
VO_LOOTA_BOSS_22h_Male_Murloc_Intro_01	...!	
VO_LOOTA_BOSS_23h_Male_Furbolg_Death_01	<ตาย>	
VO_LOOTA_BOSS_23h_Male_Furbolg_DefeatPlayer_01	เหลือกระดูกไว้เตือน[b]คนอื่นด้วย	
VO_LOOTA_BOSS_23h_Male_Furbolg_EmoteResponse_01	พูดอีกสิ สัตว์ของข้า[b]จะได้หาเจ้าเจอ…	
VO_LOOTA_BOSS_23h_Male_Furbolg_EventPlayBigMinion1_01	การล่า... จบแล้ว!	
VO_LOOTA_BOSS_23h_Male_Furbolg_EventPlayBigMinion2_01	หนีไม่พ้นหรอก	
VO_LOOTA_BOSS_23h_Male_Furbolg_EventPlayBigMinion3_01	พวกมันรู้ว่าเจ้ากลัว!	
VO_LOOTA_BOSS_23h_Male_Furbolg_HeroPower1_01	เจ้าใกล้ชะตาขาดแล้ว...	
VO_LOOTA_BOSS_23h_Male_Furbolg_HeroPower2_01	ข้าทรงพลังขึ้นเรื่อยๆ	
VO_LOOTA_BOSS_23h_Male_Furbolg_HeroPower3_01	สัตว์ของข้าจะตามล่าเจ้า	
VO_LOOTA_BOSS_23h_Male_Furbolg_HeroPower4_01	ข้ารู้จักถ้ำพวกนี้ เจ้าไม่รู้อะไรเลย	
VO_LOOTA_BOSS_23h_Male_Furbolg_HeroPower5_01	ที่นี่คือเขตล่าสัตว์ของข้า	
VO_LOOTA_BOSS_23h_Male_Furbolg_Intro_01	ที่นี่... เจ้าคือผู้ถูกล่า!	
VO_LOOTA_BOSS_25h_Male_Dragon_Death_01	<ตาย>	
VO_LOOTA_BOSS_25h_Male_Dragon_DefeatPlayer_01	สมบัติโบราณและล้ำค่าพวกนี้[b]จะต้องอยู่ที่นี่ 	
VO_LOOTA_BOSS_25h_Male_Dragon_EmoteResponse_01	ข้าจะลองเก็บไปคิดดู	
VO_LOOTA_BOSS_25h_Male_Dragon_EventMarinTheFox_01	เจ้าจิ้งจอกมาริน! ยังกล้ากลับมาที่นี่อีกเรอะ	
VO_LOOTA_BOSS_25h_Male_Dragon_HeroPower1_01	ไหม้ไปซะ ผู้บุกรุก	
VO_LOOTA_BOSS_25h_Male_Dragon_HeroPower2_01	เจ้าโจรชั่ว!	
VO_LOOTA_BOSS_25h_Male_Dragon_HeroPower3_01	จงเจ็บปวด!	
VO_LOOTA_BOSS_25h_Male_Dragon_HeroPower4_01	ไสหัวไป!	
VO_LOOTA_BOSS_25h_Male_Dragon_HeroPower5_01	ไม่มีที่ให้ซ่อนตัวแล้ว	
VO_LOOTA_BOSS_25h_Male_Dragon_Intro_01	โผล่หัวออกมา เจ้าโจรชั่ว 	
VO_LOOTA_BOSS_25h_Male_Dragon_TreasureDestroy1_01	นั่นไม่ใช่ของเจ้านะ!	
VO_LOOTA_BOSS_25h_Male_Dragon_TreasureDestroy2_01	ขโมย!	
VO_LOOTA_BOSS_25h_Male_Dragon_TreasureDestroy3_01	เอาคืนมา!	
VO_LOOTA_BOSS_25h_Male_Dragon_TreasureDestroy4_02	เจ้าเด็กขี้ขโมย!	
VO_LOOTA_BOSS_25h_Male_Dragon_TreasureDestroy5_01	เจ้าต้องชดใช้ต่อ[b]ความละโมบของเจ้า	
VO_LOOTA_BOSS_26h_Female_Demon_Death_01	<ตาย>	
VO_LOOTA_BOSS_26h_Female_Demon_DefeatPlayer_01	โง่เขลาเหลือเกิน ผู้บุกรุกเอ้ย ข้าเห็นทุกสิ่ง	
VO_LOOTA_BOSS_26h_Female_Demon_EmoteResponse_01	ข้ามองแต่เจ้า… คนเดียว	
VO_LOOTA_BOSS_26h_Female_Demon_EyeStalkConfuse_01	มึนงง	
VO_LOOTA_BOSS_26h_Female_Demon_EyeStalkDeath_01	มอดม้วย	
VO_LOOTA_BOSS_26h_Female_Demon_EyeStalkDevitalize_01	หมดแรง	
VO_LOOTA_BOSS_26h_Female_Demon_EyeStalkFear_01	หมดหวัง	
VO_LOOTA_BOSS_26h_Female_Demon_EyeStalkFire_01	มอดไหม้	
VO_LOOTA_BOSS_26h_Female_Demon_EyeStalkFrost_01	หมดท่า	
VO_LOOTA_BOSS_26h_Female_Demon_Intro_01	ฉลาดมากที่มาได้ถึงที่นี่... ขอดูหน้าหน่อยซิ...	
VO_LOOTA_BOSS_32h_Male_Human_Death_01	<ตาย>	
VO_LOOTA_BOSS_32h_Male_Human_EmoteResponse_01	ข้าไม่พูดกับคนแปลกหน้า	
VO_LOOTA_BOSS_32h_Male_Human_PartnerDeath_01	จอร์จ? ไม่ อย่าทำจอร์จ!	
VO_LOOTA_BOSS_32h_Male_Human_TaggedIn1_01	ให้ข้าเล่นเถอะ!	
VO_LOOTA_BOSS_32h_Male_Human_TaggedIn2_01	ให้ข้าช่วยเถอะ จอร์จ!	
VO_LOOTA_BOSS_32h_Male_Human_TaggedIn3_01	ข้าเล่นได้มั้ย จอร์จ ได้มั้ย	
VO_LOOTA_BOSS_34h_Male_Demon_Death_01	<ตาย>	
VO_LOOTA_BOSS_34h_Male_Demon_DefeatPlayer_01	ข้าต้องกินอีก... กินอีก!	
VO_LOOTA_BOSS_34h_Male_Demon_EmoteResponse_01	ข้าดื่มด่ำความกลัว[b]และเสพความ[b]โศกเศร้าของเจ้า 	
VO_LOOTA_BOSS_34h_Male_Demon_HeroPower1_01	กลืนกิน	
VO_LOOTA_BOSS_34h_Male_Demon_HeroPower2_01	ยังไม่พอ…	
VO_LOOTA_BOSS_34h_Male_Demon_HeroPower3_01	เอามาให้ข้าอีก…	
VO_LOOTA_BOSS_34h_Male_Demon_HeroPower4_01	ข้าจะกลืนกินโลกนี้	
VO_LOOTA_BOSS_34h_Male_Demon_HeroPower5_01	นี่คือจุดจบของเจ้า	
VO_LOOTA_BOSS_34h_Male_Demon_Intro_01	ข้าหิว	
VO_LOOTA_BOSS_35h_Male_Furbolg_Death_01	กลับไป... หายนะรอเจ้าอยู่ข้างล่าง!	
VO_LOOTA_BOSS_35h_Male_Furbolg_DefeatPlayer_01	ร่างกายเจ้าคงอยู่ แต่วิญญาณเป็นอิสระแล้ว	
VO_LOOTA_BOSS_35h_Male_Furbolg_EmoteResponse_01	ถ้าเจ้ามาดี ทิ้งสมบัติไว้แล้วไปซะ	
VO_LOOTA_BOSS_35h_Male_Furbolg_Intro_01	ไปซะ! ที่นี่เวทมนตร์ช่วยเจ้าไม่ได้!	
VO_LOOTA_BOSS_35h_Male_Furbolg_SpellCountered1_01	เวทมนตร์เจ้าจะถูก[b]กลืนหายไปในโพรง	
VO_LOOTA_BOSS_35h_Male_Furbolg_SpellCountered2_01	เงียบซะ! 	
VO_LOOTA_BOSS_35h_Male_Furbolg_SpellCountered3_01	พลังเจ้าเสื่อมถอยลง	
VO_LOOTA_BOSS_35h_Male_Furbolg_SpellCountered4_01	เวทมนตร์ของข้า[b]เหนือกว่าเจ้า...	
VO_LOOTA_BOSS_35h_Male_Furbolg_SpellCountered5_01	วีถีเก่าไม่มีวันถูกทำลาย	
VO_LOOTA_BOSS_37h_Female_BloodElf_Death_01	ไหม้หมดแล้ว!	
VO_LOOTA_BOSS_37h_Female_BloodElf_DefeatPlayer_01	มาเดินเล่นในดันเจี้ยนของข้า คิดเหรอว่าจะรอดจากถูกเผา...	
VO_LOOTA_BOSS_37h_Female_BloodElf_EmoteResponse_01	ข้าเป็นคนมีไฟ!	
VO_LOOTA_BOSS_37h_Female_BloodElf_EventFireball_01	ไฟ... ไฟ! 	
VO_LOOTA_BOSS_37h_Female_BloodElf_EventPyroblast_01	ร้อนแรงจริงๆ!	
VO_LOOTA_BOSS_37h_Female_BloodElf_EventRagnaros_01	มันต้องแบบนี้สิถึงจะสนุก!	
VO_LOOTA_BOSS_37h_Female_BloodElf_EventTheCandle_01	สรุปว่า... เจ้าเอาเทียนไปเหรอ	
VO_LOOTA_BOSS_37h_Female_BloodElf_Flamewakers_01	พร้อมจะดู[b]ดอกไม้ไฟหรือยัง	
VO_LOOTA_BOSS_37h_Female_BloodElf_HeroPower1_01	ขอพลังให้ข้าอีก...	
VO_LOOTA_BOSS_37h_Female_BloodElf_HeroPower2_01	เอาอีก… เอาอีก!	
VO_LOOTA_BOSS_37h_Female_BloodElf_HeroPower3_01	เวทมนตร์สนุกจะตาย! สนุกมากๆ!	
VO_LOOTA_BOSS_37h_Female_BloodElf_Intro_01	ไฟจะเผาจนเจ้า[b]เต้นไม่หยุด!	
VO_LOOTA_BOSS_38h_Male_Kobold_Death_01	บัดซบ!	
VO_LOOTA_BOSS_38h_Male_Kobold_DefeatPlayer_01	ข้าเสกวูดูดีๆ ใส่เจ้า!	
VO_LOOTA_BOSS_38h_Male_Kobold_EmoteResponse_01	ข้าสาปเจ้า!	
VO_LOOTA_BOSS_38h_Male_Kobold_EventBrann_01	วูดูคนแคระพิลึกจะตาย	
VO_LOOTA_BOSS_38h_Male_Kobold_EventPlayerBattlecries1_01	เจ้านั่นเสียงดังจัง	
VO_LOOTA_BOSS_38h_Male_Kobold_EventPlayerBattlecries2_01	เจ้านั่นคำรามอยู่ได้ 	
VO_LOOTA_BOSS_38h_Male_Kobold_EventPlayerBattlecries3_01	ตะโกนอะไรนักหนา	
VO_LOOTA_BOSS_38h_Male_Kobold_EventPlayerDeathrattles1_01	จะตายแล้วยังส่งเสียงอีก!	
VO_LOOTA_BOSS_38h_Male_Kobold_EventPlayerDeathrattles3_01	มันเสกวูดูตอนตายด้วย	
VO_LOOTA_BOSS_38h_Male_Kobold_EventRivendare_01	วูดูคนตายน่ากลัวที่สุด	
VO_LOOTA_BOSS_38h_Male_Kobold_Intro_01	ข้าเสกวูดูเหมือนกัน!	
VO_LOOTA_BOSS_39h_Male_Golem_Death_01	ข้า... พังแล้ว...	
VO_LOOTA_BOSS_39h_Male_Golem_DefeatPlayer_01	ขุมทรัพย์ปลอดภัยแล้ว 	
VO_LOOTA_BOSS_39h_Male_Golem_EmoteResponse_01	เจ้าไม่ใช่นายท่าน	
VO_LOOTA_BOSS_39h_Male_Golem_HeroPower1_01	บดขยี้	
VO_LOOTA_BOSS_39h_Male_Golem_HeroPower2_01	เหยียบย่ำ	
VO_LOOTA_BOSS_39h_Male_Golem_HeroPower3_01	ห้ามใครผ่าน!	
VO_LOOTA_BOSS_39h_Male_Golem_HeroPower4_01	จ้อยร่อย... เหลือเกิน...	
VO_LOOTA_BOSS_39h_Male_Golem_HeroPower5_01	ไสหัวไป!	
VO_LOOTA_BOSS_39h_Male_Golem_Intro_01	ปกป้อง... ขุมทรัพย์...	
VO_LOOTA_BOSS_40h_Female_Dragon_Death_01	<ตาย>	
VO_LOOTA_BOSS_40h_Female_Dragon_DefeatPlayer_01	ทไวไลท์ดราก้อนไฟลท์[b]จะผงาดอีกครั้ง!	
VO_LOOTA_BOSS_40h_Female_Dragon_EmoteResponse_01	เถียงไปก็เท่านั้น	
VO_LOOTA_BOSS_40h_Female_Dragon_EventPlayTwilightDrake_01	อย่าทรยศเราสิ น้องชาย	
VO_LOOTA_BOSS_40h_Female_Dragon_EventPlayTwilightWhelp_01	กลับเข้าฝูงเถอะ เจ้าตัวน้อย!	
VO_LOOTA_BOSS_40h_Female_Dragon_HeroPower1_01	สูบกิน…!	
VO_LOOTA_BOSS_40h_Female_Dragon_HeroPower2_01	พลังของเจ้าหล่อเลี้ยงข้า	
VO_LOOTA_BOSS_40h_Female_Dragon_HeroPower3_01	เผ่าพันธุ์ข้าต้องอยู่รอด	
VO_LOOTA_BOSS_40h_Female_Dragon_HeroPower4_01	จงอาบแสงแห่งสนธยา	
VO_LOOTA_BOSS_40h_Female_Dragon_Intro_01	ข้ารู้สึกถึงพลังกล้าแกร่ง เข้ามาใกล้ๆ สิ…	
VO_LOOTA_BOSS_41h_Male_Kobold_Death_01	<ตาย>	
VO_LOOTA_BOSS_41h_Male_Kobold_DefeatPlayer_01	ข้าได้เทียน เจ้าไม่ได้เลย	
VO_LOOTA_BOSS_41h_Male_Kobold_EmoteResponse_01	เลิกพ่นเสียง! สู้กัน!	
VO_LOOTA_BOSS_41h_Male_Kobold_EventHornOfCenarius_01	อะไร - อะไรกัน? เจ้าเล่นสกปรก!	
VO_LOOTA_BOSS_41h_Male_Kobold_HeroPower1_01	ทุกคน… สู้กัน!	
VO_LOOTA_BOSS_41h_Male_Kobold_HeroPower2_01	ซัดมัน!	
VO_LOOTA_BOSS_41h_Male_Kobold_HeroPower3_01	ตะลุมบอน!	
VO_LOOTA_BOSS_41h_Male_Kobold_Intro_01	เอาเทียนคืนมา! 	
VO_LOOTA_BOSS_42h_Female_Furbolg_Armor10_01	ขอบคุณบรรพบุรุษผู้เบิกทาง	
VO_LOOTA_BOSS_42h_Female_Furbolg_Armor15_01	ด้วยอำนาจแห่งบรรพชน!	
VO_LOOTA_BOSS_42h_Female_Furbolg_Armor20_01	มอบสมบัติให้ข้าเถอะ[b]เป้าหมายของเจ้า[b]เป็นไปไม่ได้!	
VO_LOOTA_BOSS_42h_Female_Furbolg_Armor5_01	ข้าสู้โดยไร้ความกลัว	
VO_LOOTA_BOSS_42h_Female_Furbolg_Death_01	ข้าจะได้พบ... บรรพบุรุษแล้ว...	
VO_LOOTA_BOSS_42h_Female_Furbolg_DefeatPlayer_01	ขอบคุณวิญญาณบรรพชน! ผู้ปกป้องและคุ้มครองข้า 	
VO_LOOTA_BOSS_42h_Female_Furbolg_EmoteResponse_01	วิญญาณบรรพชน... ไม่ชอบหน้าเจ้าเลยสักนิด	
VO_LOOTA_BOSS_42h_Female_Furbolg_Intro_01	วิญญาณบรรพชน! ข้าขออัญเชิญท่าน	
VO_LOOTA_BOSS_43h_Female_Djinn_Death_01	<ตาย>	
VO_LOOTA_BOSS_43h_Female_Djinn_DefeatPlayer_01	ข้าก็ให้ตามที่ขอ[b]แล้วไม่ใช่เหรอ...	
VO_LOOTA_BOSS_43h_Female_Djinn_EmoteResponse_01	นั่นเจ้าขอพรแล้วใช่มั้ย	
VO_LOOTA_BOSS_43h_Female_Djinn_HeroAbility1_01	เจ้าปรารถนาอะไรล่ะ	
VO_LOOTA_BOSS_43h_Female_Djinn_HeroAbility2_01	หนึ่ง... สอง... สาม...	
VO_LOOTA_BOSS_43h_Female_Djinn_HeroAbility3_01	จัดให้ตามที่ขอ!	
VO_LOOTA_BOSS_43h_Female_Djinn_HeroAbilityHandFull1_01	ฮี่ฮี่ฮี่!	
VO_LOOTA_BOSS_43h_Female_Djinn_HeroAbilityHandFull2_01	เยอะไปหรอกเหรอ	
VO_LOOTA_BOSS_43h_Female_Djinn_HeroAbilityHandFull3_01	ขออะไรก็ระวังด้วยล่ะ	
VO_LOOTA_BOSS_43h_Female_Djinn_Intro_01	ข้าจะมอบทุกสิ่ง[b]ตามบัญชา... ถ้าเจ้า[b]จ่ายไหว...	
VO_LOOTA_BOSS_44h_Female_Dragon_Death_01	<ตาย>	
VO_LOOTA_BOSS_44h_Female_Dragon_DefeatPlayer_01	ไปหมดแย้ว! บ๊ายบาย!	
VO_LOOTA_BOSS_44h_Female_Dragon_EmoteResponse_01	แม่จ๋าอยู่ไหน!	
VO_LOOTA_BOSS_44h_Female_Dragon_Intro_01	กินนมเหรอ	
VO_LOOTA_BOSS_45h_Male_Gnome_Death_01	<ตาย>	
VO_LOOTA_BOSS_45h_Male_Gnome_DefeatPlayer_01	นี่คือเกมที่มีทั้ง[b]ผู้ให้และผู้รับ[b]และข้าเป็นผู้รับ	
VO_LOOTA_BOSS_45h_Male_Gnome_EmoteResponse_01	บ้าจริง ที่นี่เหมือน[b]เขาวงกตเล็กเลยๆ[b]เหมือนกันไปหมด!	
VO_LOOTA_BOSS_45h_Male_Gnome_HeroPower1_01	อา ของมีค่า	
VO_LOOTA_BOSS_45h_Male_Gnome_HeroPower2_01	เฮะเฮะ…	
VO_LOOTA_BOSS_45h_Male_Gnome_HeroPower3_01	ออกหัว! ข้าชนะ	
VO_LOOTA_BOSS_45h_Male_Gnome_HeroPower4_01	ออกก้อย! เจ้าแพ้	
VO_LOOTA_BOSS_45h_Male_Gnome_Intro_01	กระเป๋าเจ้าท่าทาง[b]หนักมากเลย[b]นะเพื่อน!	
VO_LOOTA_BOSS_46h_Male_Murloc_Death_01	<ตาย>	
VO_LOOTA_BOSS_46h_Male_Murloc_DefeatPlayer_01	... ...? ...!	
VO_LOOTA_BOSS_46h_Male_Murloc_EmoteResponse_01	<น้ำลายแตกฟอง>	
VO_LOOTA_BOSS_46h_Male_Murloc_HeroPower1_01	...	
VO_LOOTA_BOSS_46h_Male_Murloc_HeroPower2_01	...?	
VO_LOOTA_BOSS_46h_Male_Murloc_HeroPower3_01	...	
VO_LOOTA_BOSS_46h_Male_Murloc_Intro_01	...!!	
VO_LOOTA_BOSS_49h_Male_Elemental_Death_01	<ตาย>	
VO_LOOTA_BOSS_49h_Male_Elemental_DefeatPlayer_01	วะฮ่าฮ่าฮ่า...	
VO_LOOTA_BOSS_49h_Male_Elemental_EmoteResponse_01	ข้าจะแย่งเทียน ข้าชอบของข้าอย่างนี้	
VO_LOOTA_BOSS_49h_Male_Elemental_HeroPower1_01	ความมืด...	
VO_LOOTA_BOSS_49h_Male_Elemental_HeroPower2_01	หนีซะสิ...	
VO_LOOTA_BOSS_49h_Male_Elemental_HeroPower3_01	เฮะเฮะเฮะฮะฮ่า	
VO_LOOTA_BOSS_49h_Male_Elemental_Intro_01	แสงของเจ้าริบหรี่แล้ว นักผจญภัย…	
VO_LOOTA_BOSS_50h_Male_Kobold_Death_01	<ตาย>	
VO_LOOTA_BOSS_50h_Male_Kobold_DefeatPlayer_01	โอ้ วี้ ของเขาดีจริงๆ!	
VO_LOOTA_BOSS_50h_Male_Kobold_EmoteResponse_01	ไม่ ซื้อแล้วห้ามคืน	
VO_LOOTA_BOSS_50h_Male_Kobold_EventKazakus_01	คาซากัส จะซื้ออีกเหรอ หืม?	
VO_LOOTA_BOSS_50h_Male_Kobold_EventMakePotion1_01	นี่มัน… ใช้ไม่ได้	
VO_LOOTA_BOSS_50h_Male_Kobold_EventMakePotion2_01	นี่แหละของแรง แรงสุด	
VO_LOOTA_BOSS_50h_Male_Kobold_EventMakePotion3_01	นี่ นี่ อยากลองมั้ย เฮะ ไม่ให้หรอก	
VO_LOOTA_BOSS_50h_Male_Kobold_EventUsePotion1_01	โอ้ย! ไม่ได้เรื่อง ดมดูสิ!	
VO_LOOTA_BOSS_50h_Male_Kobold_EventUsePotion2_01	เย้เฮ้ เฮ้เย้! เฮะ	
VO_LOOTA_BOSS_50h_Male_Kobold_EventUsePotion3_01	ไม่อร่อย แต่ไม่เลว	
VO_LOOTA_BOSS_50h_Male_Kobold_Intro_01	นี่… นี่… อยากได้เห็ดมั้ย	
VO_LOOTA_BOSS_51h_Male_Dwarf_Death_01	ราตรีสวัสดิ์ อาเซรอธ!	
VO_LOOTA_BOSS_51h_Male_Dwarf_DefeatPlayer_02	ขอบใจที่ให้มินเนี่ยนข้านะ เพื่อน!	
VO_LOOTA_BOSS_51h_Male_Dwarf_EmoteResponse_01	โอ้ พวกชอบขัดคอเหรอ	
VO_LOOTA_BOSS_51h_Male_Dwarf_EventBoombox_01	เฮ้ย! เบาเสียงไอ้กล่องนั่นหน่อย!	
VO_LOOTA_BOSS_51h_Male_Dwarf_Intro_01	อยู่ฟังสักเดี๋ยวสิ!	
VO_LOOTA_BOSS_51h_Male_Dwarf_KillingBlowReady_01	Kobolds & Catacombs!	
VO_LOOTA_BOSS_51h_Male_Dwarf_Song1A_01	เจ้ารวบรวมผู้กล้า คือภารกิจยิ่งใหญ่...	
VO_LOOTA_BOSS_51h_Male_Dwarf_Song1B_01	ตามหาขุมทรัพย์[b]มหาสมบัติ	
VO_LOOTA_BOSS_51h_Male_Dwarf_Song1C_01	เงินทองวางเป็นกอง แต่อันตรายรายล้อม...	
VO_LOOTA_BOSS_51h_Male_Dwarf_Song1D_01	ทั่วทุกหนแห่ง ไร้ปราณีไร้กฎเกณฑ์	
VO_LOOTA_BOSS_51h_Male_Dwarf_Song2A_01	ถ้าเจ้าขโมยเปลวไฟ จงรีบเผ่นให้ไกล	
VO_LOOTA_BOSS_51h_Male_Dwarf_Song2B_01	จงรีบไปพ้น[b]อันตรายต้องหลบ	
VO_LOOTA_BOSS_51h_Male_Dwarf_Song2C_01	โกยอ้าวอย่าคิดชีวิต ให้เจ้าสัตว์ร้ายไล่ล่า...	
VO_LOOTA_BOSS_51h_Male_Dwarf_Song2D_01	ทางไหนจงหา ชีวิตมีแผนที่ช่วยนำทาง	
VO_LOOTA_BOSS_51h_Male_Dwarf_Song3A_01	พวกมันเข้ารุมล้อม เจ้าร่วงโรยอ่อนแรง...	
VO_LOOTA_BOSS_51h_Male_Dwarf_Song3B_01	ช่างน่ากลัว และไม่รู้จะรอดกลับบ้านมั้ย	
VO_LOOTA_BOSS_51h_Male_Dwarf_Song3C_01	ที่หวังว่าจะรวย เจ้าจะซวยพบจุดจบ	
VO_LOOTA_BOSS_51h_Male_Dwarf_Song3D_01	ที่ Kobolds & Catacombs!	
VO_LOOTA_BOSS_51h_Male_Dwarf_Steal_01	มานี่เร็ว!	
VO_LOOTA_BOSS_51h_Male_Dwarf_Steal_02	มาสิ	
VO_LOOTA_BOSS_51h_Male_Dwarf_Steal_03	ได้เวลาปาร์ตี้แล้ว!	
VO_LOOTA_BOSS_51h_Male_Dwarf_StealDoomsayer_01	สมาชิกทัวร์ สุด ห่วย!	
VO_LOOTA_BOSS_51h_Male_Dwarf_StealMinstrel_01	ได้เวลาร้องคู่กันแล้ว!	
VO_LOOTA_BOSS_53h2_Female_Undead_Death_01	ปฏิทรรศน์!	
VO_LOOTA_BOSS_53h2_Female_Undead_DefeatPlayer_01	รู้อยู่แล้วว่าต้องชนะ ข้าเห็นอนาคตตัวเองแล้ว 	
VO_LOOTA_BOSS_53h2_Female_Undead_EmoteResponse_01	ข้าหลอกได้แม้[b]แต่มังกรบรอนซ์[b]อย่างเจ้าน่ะสบายมาก	
VO_LOOTA_BOSS_53h2_Female_Undead_EventManaDestroyed_01	ได้แค่ถ่วงเวลา[b]เท่านั้นแหละ!	
VO_LOOTA_BOSS_53h2_Female_Undead_EventPlayerTimeWalk_01	เจ้าก็เคยไป[b]เกาะเหนือกาลเวลา[b]เหมือนกันเหรอ	
VO_LOOTA_BOSS_53h2_Female_Undead_Intro_01	เวลาอาจย้อนกลับได้ แต่เจ้าจะไม่ได้ย้อนกลับไป	
VO_LOOTA_BOSS_53h2_Female_Undead_RitualPrep1_01	สักวันจะเป็นเวลา[b]ของเจ้าบ้าง...	
VO_LOOTA_BOSS_53h2_Female_Undead_RitualPrep2_01	พลังมาแล้ว	
VO_LOOTA_BOSS_53h2_Female_Undead_RitualPrep3_01	ติ๊กต่อก...	
VO_LOOTA_BOSS_53h2_Female_Undead_TimeRewindPlayCard1_01	ข้าเก่งขึ้นทุกครั้ง	
VO_LOOTA_BOSS_53h2_Female_Undead_TimeRewindPlayCard2_01	ข้าผ่านมาหมดแล้ว	
VO_LOOTA_BOSS_53h2_Female_Undead_TimeRewindPlayCard3_01	เวลาอยู่ข้างข้า	
VO_LOOTA_BOSS_53h2_Female_Undead_TimeRewindPlayCard4_01	ผู้ใดควบคุมเวลา ผู้นั้นควบคุมทุกสิ่ง!	
VO_LOOTA_BOSS_53h2_Female_Undead_TimeRewindPlayCard5_01	ถึงเวลาปิดฉากแล้ว!	
VO_LOOTA_BOSS_53h2_Female_Undead_TimeRewindStart1_01	นี่คือการค้นพบของข้า!	
VO_LOOTA_BOSS_53h2_Female_Undead_TimeRewindStart2_01	ถึงเวลาแล้ว!	
VO_LOOTA_BOSS_53h2_Female_Undead_TimeRewindStart3_01	อีกที! มาเริ่มกันใหม่อีกที!	
VO_LOOTA_BOSS_53h2_Female_Undead_TimeRewindStart4_01	นี่แหละเวลาของข้า!	
VO_LOOTA_BOSS_54h_Female_Human_Death_01	ข้ายังไม่พร้อม!	
VO_LOOTA_BOSS_54h_Female_Human_DefeatPlayer_01	โอเค! ตอนนี้พร้อมแล้ว	
VO_LOOTA_BOSS_54h_Female_Human_EmoteResponse_01	เดี๋ยวตามไป เริ่มสู้เมื่อไหร่บอกด้วยล่ะ!	
VO_LOOTA_BOSS_54h_Female_Human_Intro_01	<ผิวปากอย่างไม่ใส่ใจ>	
VO_LOOTA_BOSS_54h_Female_Human_Intro_02	<ผิวปากอย่างสบายใจ>	
VO_LOOTA_BOSS_54h_Female_Human_Intro_03	<ผิวปากอย่างสบายใจ>	
VO_LOOTA_BOSS_54h_Female_Human_Intro_04	<ผิวปากอย่างสบายใจ>	
VO_LOOTA_BOSS_54h_Female_Human_Intro_07	<ผิวปากอย่างสบายใจ>	
VO_LOOTA_BOSS_54h_Female_Human_WakeUp_01	อ้าว! สู้กันอยู่เหรอ	
VO_Maiden_Female_Titan_FinalMaidenEmoteResponse_01	ข้าจะไม่ทนกับพฤติกรรมของเจ้า	
VO_Maiden_Female_Titan_FinalMaidenEyeForAnEye_01	ความยุติธรรมบังเกิดแล้ว	
VO_Maiden_Female_Titan_FinalMaidenHeroPower_01	กำจัดความคิดชั่วร้ายของเจ้าออกไป	
VO_Maiden_Female_Titan_FinalMaidenHumility_01	ใช่แล้ว! คุกเข่าลง แล้วข้าอาจไว้ชีวิตเจ้า!	
VO_Maiden_Female_Titan_FinalMaidenOpen_01	เจ้าอัญเชิญผู้แทนแห่งไททันมางั้นรึ?	
VO_Maiden_Female_Titan_FinalMaidenTurn5_01	เราคือนิรันดร์ และเจ้าไม่คู่ควร!	
VO_Malchezaar_Male_Demon_Brawl_06	เจ้าคงไม่ได้คิดว่า\nจะเอาชนะข้าได้ใช่มั้ย	
VO_Malchezaar_Male_Demon_EmoteParty_01	มัลเคซาร์ก็ชอบปาร์ตี้!	
VO_Malchezaar_Male_Demon_FinalAltOpening_01	เจ้าพวกโง่!	
VO_Malchezaar_Male_Demon_FinalMalchezaarDeath_01	ไม่! มันต้องไม่เกิดขึ้นอีก!	
VO_Malchezaar_Male_Demon_FinalMalchezaarEmoteResponse_01	ข้าจะเป็นจุดจบของเจ้า!	
VO_Malchezaar_Male_Demon_FinalMalchezaarHeroPower_01	เจ้าไม่ได้เผชิญหน้ากับมัลเคซาร์เพียงผู้เดียว แต่รวมถึงกองทัพที่ข้าบัญชาด้วย!	
VO_Malchezaar_Male_Demon_FinalMalchezaarJaraxxus_01	เจ้า! นั่นมันบัตรเชิญของข้า!	
VO_Malchezaar_Male_Demon_FinalMalchezaarMedivhSkin_01	เจ้าแต่งชุดแฟนซีมางั้นเรอะ? อืมมม…ข้าแต่งบ้างดีกว่า…	
VO_Malchezaar_Male_Demon_FinalMalchezaarSacrificialPact_03	ฮ่าฮ่าฮ่า!\n คิดเหรอว่าจะใช้ได้ผล\nกับลอร์ดเอเรดาร์ที่แท้จริง!	
VO_Malchezaar_Male_Demon_FinalMalchezaarTurn1_01	เจ้าจอมเวทนั่นแข็งแกร่งก็จริง แต่เจ้าจะต้านทานพลังไร้ขอบเขตของข้าได้ยังไงกัน?	
VO_Malchezaar_Male_Demon_FinalMalchezaarTurn7_01	ข้าได้ยินเสียงเพลง!  เมดิว่า!  งานปาร์ตี้!  คืนนี้เป็นคืนของข้า!	
VO_Malchezaar_Male_Demon_FinalThirdSequence_01	กลับไปที่คาราซานงั้นเรอะ? ทันเวลาปาร์ตี้พอดี!	
VO_Malchezaar_Male_Demon_FinalThirdSequence_04	หลีกทางไป เจ้าโง่!	
VO_Malchezaar_Male_Demon_PrologueEmoteResponse_01	เจ้าโง่!	
VO_Malchezaar_Male_Demon_PrologueHeroPower_01	จักรวาลและมิติทั้งหลาย[b]ล้วนเปิดทางให้ข้า!	
VO_Malchezaar_Male_Demon_PrologueOpen_01	บัตรเชิญของข้าอยู่ไหน?	
VO_Malchezaar_Male_Demon_PrologueTurn1_04	เจ้าไม่ได้เชิญข้างั้นเหรอ?![b]ข้าเป็นถึง[b]เจ้าชายแห่งเอเรดาร์นะ!	
VO_Malchezaar_Male_Demon_PrologueTurn11_02	เจ้าเชิญจาแร็กซ์ซัสมาด้วย? เจ้าคนอ่อนแอนั่นน่ะเหรอ?	
VO_Malchezaar_Male_Demon_PrologueWin_01	ข้าจะพาตัวเจ้าไปด้วย!	
VO_Mediva_01_Female_Blood Elf_AranSpell_04	โอ้...บรื๋ออ	
VO_Mediva_01_Female_Blood Elf_ChessEmoteOops_06	โอ๊ะโอ!	
VO_Mediva_01_Female_Blood Elf_PrologueTurn5_06	เมดิว่า!	
VO_Mediva_02_Female_Draenei_JulianneDeadlyPoison_02	น่าสงสารจัง!	
VO_Mediva_02_Female_Draenei_PrologueTurn5_05	จ๋า?	
VO_Mediva_03_Male_Night Elf_AranHeroPower_01	เผาเลย เบบี๋!	
VO_Mediva_03_Male_Night Elf_CuratorBeasts_04	ฮัดเช้ย เบบี๋!	
VO_Mediva_03_Male_Night Elf_PrologueTurn5_01	เรียกข้าเหรอคะ?	
VO_Medivas_Multiple_Multiple_CroneLionTigerBear_01	โอ้ ไม่!	
VO_Medivas_Multiple_Multiple_IllhoofWounded_01	อืมม...ข้ากลัวจังเลย!	
VO_Medivas_Multiple_Multiple_NetherspiteTurn1_01	ลำแสง!	
VO_Medivh_Male_Human_EmoteGreetings_01	เจ้ามาทำอะไรที่นี่?	
VO_Medivh_Male_Human_EmoteOops_01	เจ้าวางแผนไว้งั้นหรอ?	
VO_Medivh_Male_Human_EmoteSorry_01	โอ้ ท่าทางไม่ค่อยดีเลย…	
VO_Medivh_Male_Human_EmoteThanks_01	ใจดีกับข้าเกินไปแล้ว	
VO_Medivh_Male_Human_EmoteThreaten_01	เจ้าไม่มีทางชนะข้าได้หรอก!	
VO_Medivh_Male_Human_EmoteWellPlayed_01	พยายามได้ดี เจ้าปีศาจ	
VO_Medivh_Male_Human_EmoteWow_01	โอ้โฮ่โฮ่! เจ๋งไปเลย!	
VO_Medivh_Male_Human_FinalMalchezaarTurn5_01	ทำได้ดีมาก โมโรส์ ปาร์ตี้กำลังไปได้สวยเลย!	
VO_Medivh_Male_Human_FinalMalchezaarWin_01	เยี่ยมจริงๆ! มาเถอะ ได้เวลาปาร์ตี้แล้ว!	
VO_Medivh_Male_Human_FinalMedivhMedivhSkin_01	โอ้ เดี๋ยวนะ! เจ้าคือข้างั้นเหรอ?!  จากอนาคต? ช่วยบอกที... ปาร์ตี้ข้าเจ๋งมากมั้ย?  มันสุดยอดไปเลยใช่มั้ยล่ะ?	
VO_Medivh_Male_Human_FinalThirdSequence_01	อ้า แขกของข้า! โปรดช่วยจัดการเจ้าปีศาจนี่ที ข้ามีงานปาร์ตี้ที่ต้องดูแลน่ะ!	
VO_Medivh_Male_Human_FinalThirdSequence_02	เขาไม่เหลือการ์ดไว้ให้เจ้าเลยเหรอ? งั้นใช้ประตูมิติได้ตามสบายเลย	
VO_Medivh_Male_Human_FinalThirdSequence_03	นี่ ข้าจะให้ยืมไม้เท้า มันใช้ควบคุมประตูมิติได้ แต่อย่าให้มีรอยขีดข่วนล่ะ	
VO_Medivh_Male_Human_PrologueDeath_02	อะไรกัน? เป็นไปไม่ได้!	
VO_Medivh_Male_Human_PrologueHeroPower_01	ยกเว้นปาร์ตี้แห่งนี้!	
VO_Medivh_Male_Human_PrologueOpen_01	อั่ก เจ้าอีกแล้วเหรอ?	
VO_Medivh_Male_Human_PrologueTurn1_02	หลังจากที่เจ้าสร้างผลงานไว้[b]น่ะเหรอ? เรายังปะรูบนหลังคา[b]ไม่หมดเลย!	
VO_Medivh_Male_Human_PrologueTurn11_01	เจ้าเคยฟังเขา[b]ร้องคาราโอเกะมั้ย?[b]สุดยอดเป็นบ้า!	
VO_Medivh_Male_Human_PrologueTurn3_02	โมโรส์ ไปดูชุดหมากรุกให้ข้าหน่อย แขกตัวจริงใกล้จะมาถึงแล้ว	
VO_Medivh_Male_Human_PrologueTurn9_01	ลูกโป่ง! โมโรส์ เราลืมลูกโป่ง!	
VO_Medivh_Male_Human_PrologueWin_01	กลับบ้านไปเลย เจ้าปีศาจ!	
VO_Medivh_Male_Human_Wing0Intro_01	เราเสกให้เครื่องเงินมีชีวิต ซ้อมละครโอเปร่า และเตรียมงานจัดแสดงไว้เรียบร้อยแล้ว  คืนนี้จะเป็นคืนที่พวกท่านลืมไม่ลงอย่างแน่นอน!	
VO_Medivh_Male_Human_Wing4Win_01	มาเลย นักผจญภัย! มาสนุกกับปาร์ตี้กัน!	
VO_Mirror_Male_Mirror_MirrorDeath_01	เฮ้ย! ขี้โกงนี่หว่า! ข้าจะแข่งใหม่!	
VO_Mirror_Male_Mirror_MirrorEmoteResponse_01	ไม่ เจ้านั่นแหละ!	
VO_Mirror_Male_Mirror_MirrorFirstCard_01	เจ้ามีไอ้นั่น[b]อยู่ในเด็คด้วยเหรอ??	
VO_Mirror_Male_Mirror_MirrorMedivhSkin_01	โอ้ ท่านเมดิฟห์! ยังหล่อเหมือน... เฮ้! เดี๋ยว! เจ้าไม่ใช่เมดิฟห์นี่!	
VO_Mirror_Male_Mirror_MirrorMirrorImage_01	เฮ้ นั่นการ์ดโปรดของข้าเลย! แล้วของเจ้าล่ะ? แม็กม่าเรจเจอร์ใช่ป่ะ?	
VO_Mirror_Male_Mirror_MirrorOpen_02	วอสสสสซัพ!	
VO_Mirror_Male_Mirror_MirrorTurn1_01	ว้าว พวกเจ้าขี้เหร่เป็นบ้าเลย!	
VO_Mirror_Male_Mirror_MirrorTurn3_01	กระจกวิเศษบอกข้าเถิด ใครงามเลิศในปฐพี?	
VO_Mirror_Male_Mirror_MirrorTurn3_03	ไม่ใช่เจ้าแน่ ตาแก่!	
VO_Mirror_Male_Mirror_MirrorTurn5_02	เนฟาเรียสเหรอ? เนฟาเหร่มากกว่าล่ะมั้ง ใช่มั้ยใช่มั้ย?	
VO_Mirror_Male_Mirror_MirrorWellPlayedResponse_01	เสียดายที่ข้าพูดแบบนั้นกับเจ้าไม่ได้! ตึ่งโป๊ะ!	
VO_Moroes_Male_Human_AranTurn1_01	*เฮ้อ* ขอแนะนำอาราน ผีเฒ่าอารมณ์ร้าย	
VO_Moroes_Male_Human_AranTurn9_04	มังกรสวาปามบุฟเฟ่ต์จนหมด และหันไปมองพวกเมอร์ล็อคแล้ว!	
VO_Moroes_Male_Human_AranWin_01	ประตูมิติอยู่ในห้องถัดไป! เรามาทันเวลาพอดี!	
VO_Moroes_Male_Human_ChessForfeit_02	คุณไม่มีตัวหมากเหลือแล้ว เกมจบลงแล้ว	
VO_Moroes_Male_Human_ChessTurn1_03	คุณครับ ตัวหมากจะโจมตีโดยอัตโนมัติ[b]เมื่อจบเทิร์นของคุณ	
VO_Moroes_Male_Human_ChessTurn3_01	ถ้าตัวหมากอยู่ระหว่างศัตรูสองตัว มันก็จะโจมตีศัตรูทั้งสองตัว!	
VO_Moroes_Male_Human_ChessTurn5_01	การวางตำแหน่งอย่างเหมาะสม[b]คือกุญแจสู่ชัยชนะ[b]พยายามโจมตีศัตรู[b]ทั้งสองในคราวเดียว!	
VO_Moroes_Male_Human_ChessTurn7_01	แถวแขกที่อยู่ด้านนอกเริ่มยาวแล้ว! อีกนิดก็จะไปถึงโรงละครโอเปร่า แต่เราต้องรีบหน่อย!	
VO_Moroes_Male_Human_ChessTurn7_02	คุณมีตัวหมากไม่มาก ถ้าตัวหมากหมด คุณก็จะเป็นฝ่ายแพ้	
VO_Moroes_Male_Human_ChessTurn7_03	คุณครับ คุณมีตัวหมากไม่มาก ถ้าตัวหมากหมด คุณก็จะเป็นฝ่ายแพ้	
VO_Moroes_Male_Human_ChessWin_01	เยี่ยมมาก! ไปโรงละครโอเปร่ากันต่อเลย!	
VO_Moroes_Male_Human_CroneTurn5_02	เมเจอร์โดโม เอ็กเซคิวตัสอยู่ที่ชั้นล่าง ให้ข้าบอกเขามั้ยว่าเขามาเร็วเกินไป	
VO_Moroes_Male_Human_CroneWin_01	ในที่สุด! เราจะได้ไปช่วยนายท่านกลับมาซักที!	
VO_Moroes_Male_Human_CuratorTurn3_01	ภัณฑารักษ์กำลังสับสน! [b]คุณต้องหยุดมันก่อนที่[b]มันจะปล่อยทุกอย่างออกมา!	
VO_Moroes_Male_Human_CuratorWin_01	เอาล่ะ...ปรับตรงนี้หน่อย...เรียบร้อยแล้ว!	
VO_Moroes_Male_Human_EndWing1_01	เยี่ยมมาก!  แค่ขึ้นบันไดนั่นไปก็ถึงโรงละครโอเปร่าแล้ว! ข้ามั่นใจว่าบาร์นส์จะต้องปล่อยให้เราผ่านไป!	
VO_Moroes_Male_Human_FinalAltTurn5_01	มีประตูมิติเต็มไปหมด สงสัยจริงว่าอะไรอยู่ในนี้...	
VO_Moroes_Male_Human_FinalMaidenTurn1_01	ขออภัย ช่วยจัดการกับเธอคนนี้ที ข้ามั่นใจว่าข้าหาเครื่องควบคุมเจอแน่	
VO_Moroes_Male_Human_FinalMaidenTurn7_03	โอ้ นั่นมันโลกแห่งหนวดปลาหมึก ไม่ใช่สิ่งที่เราต้องการแน่นอน	
VO_Moroes_Male_Human_FinalNazraTurn7_02	ส่งยายออร์คนั่นกลับไป เราจะได้เปิดอีกประตูนึง!	
VO_Moroes_Male_Human_FinalSecondSequence_01	เยี่ยมมาก! คราวนี้มาดูซิว่าประตูนี้จะได้ผลมั้ย…	
VO_Moroes_Male_Human_FInalStartSequence_01	อืมม...ไหนดูซิ ประตูนี้รึเปล่า?	
VO_Moroes_Male_Human_FinalThirdSequence_01	นี่แหละ!	
VO_Moroes_Male_Human_FinalTurn1_02	อุ๊ปส์! ไม่ใช่ประตูนี้ จัดการกับยายออร์คนั่นก่อน ข้าจะได้ลองใหม่อีกที	
VO_Moroes_Male_Human_IllhoofKilrekResponse_01	พวกมันกำลังเรียกอะไรออกมาน่ะ?	
VO_Moroes_Male_Human_JulianneTurn5_01	บาร์นส์ ให้เราผ่านไปเดี๋ยวนี้! เราต้องไปหาเมดิฟห์[b]ก่อนที่ปาร์ตี้จะพังหมด!	
VO_Moroes_Male_Human_JulianneTurn9_02	อิลลิดันมาถึงแล้ว! เรายังไม่พร้อม!	
VO_Moroes_Male_Human_MedivhSkinResponse_01	ชุดเมดิฟห์เหรอครับ? เหมือนของจริงมากทีเดียว!	
VO_Moroes_Male_Human_MirrorTurn3_01	อืมมมม...	
VO_Moroes_Male_Human_MirrorTurn5_01	ลอร์ดเนฟาเรียสน่าจะใกล้มาถึงแล้ว ข้าล่ะกลัวคำตอบของเขาจริงๆ	
VO_Moroes_Male_Human_MirrorWin_02	ยอดเยี่ยม! บันไดไปยังโรงละครโอเปร่าอยู่ข้างหน้านี่แล้ว!	
VO_Moroes_Male_Human_NetherspiteTurn1_01	ลำแสงพวกนั้นจะเพิ่มพลังให้มังกร ใช้มินเนี่ยนไปบังมันไว้เร็ว!	
VO_Moroes_Male_Human_NetherspiteTurn5_01	บอกมาเถอะน่า\nว่าเมดิฟห์อยู่ในประตูไหน!	
VO_Moroes_Male_Human_NetherspiteTurn7_01	เราต้องการประตูพวกนั้น!\n พวกแขกเริ่มโยนหนังสือ\nลงในบ่อมานาแล้ว!	
VO_Moroes_Male_Human_NetherspiteWin_01	ดีมาก! ขอข้านึกก่อนว่าเจ้านี่มันทำงานยังไง...	
VO_Moroes_Male_Human_NightbaneTurn3_01	ภัณฑารักษ์ เราต้องไปช่วยเมดิฟห์!	
VO_Moroes_Male_Human_NightbaneTurn7_01	สมาพันธ์นักสำรวจมาถึงแล้ว รีโน่ เก็บเครื่องเงินไว้ที่เดิมเดี๋ยวนี้!	
VO_Moroes_Male_Human_PrologueTurn11_01	*อะแฮ่ม* แล้วเขาก็ไม่ได้เผาห้องสมุดด้วย...	
VO_Moroes_Male_Human_PrologueTurn5_03	ท่านครับ เมดิว่าพร้อมแล้ว[b]บาร์นส์กำลังซักซ้อม[b]กับพวกเขาอยู่ครับ	
VO_Moroes_Male_Human_PrologueTurn7_01	ได้เห็นข้างนอกหรือยังครับท่าน?[b]พวกเรดบอสมารุมแย่ง[b]บัตรเชิญกันใหญ่แล้ว	
VO_Moroes_Male_Human_PrologueTurn9_02	ท่านครับ ลูกโป่งทำให้เมอร์ล็อคกลัว จำสัปดาห์ที่แล้วได้มั้ยครับ?	
VO_Moroes_Male_Human_PrologueWin_02	นี่มันแย่ แย่เอามากๆ	
VO_Moroes_Male_Human_SilverwareResponse_01	อุ๊บ ชิ้นนั้นเก่ามากเลยนะ	
VO_Moroes_Male_Human_SilverwareTurn3_02	พวกเครื่องเงินร่วมมือกันแล้ว! เราถูกล้อมแล้ว!	
VO_Moroes_Male_Human_SilverwareWin_01	เฮ้อ เละเทะไปหมด!	
VO_Moroes_Male_Human_Wing1Intro_02	ข้าคือโมโรส์ พ่อบ้านแห่งคาราซาน และข้าต้องการ[b]ความช่วยเหลือของคุณ เมดิฟห์ถูกลักพาตัวไป!  เราต้องใช้ประตูมิติที่อยู่บนยอดหอคอย[b]เพื่อช่วยเขากลับมาและกอบกู้งานปาร์ตี้!	
VO_Moroes_Male_Human_Wing1Win_01	ยอดมาก! ด้วยความเร็วขนาดนี้ เราจะไปถึงยอดหอคอยได้ทันกอบกู้งานปาร์ตี้แน่นอน!	
VO_Moroes_Male_Human_Wing2Win_01	มุ่งหน้าไปเลย! ขึ้นบันได้นั่นไปจะเจอภัณฑารักษ์เฝ้าห้องจัดแสดงอยู่ ข้าหวังว่ามันจะไม่ทำงานผิดปกตินะ...	
VO_Moroes_Male_Human_Wing3Open_02	ภัณฑารักษ์คอยเฝ้าห้องจัดแสดง ซึ่งเป็นที่รวมของสิ่งมีชีวิตหายากจากทั่วทั้งอาเซรอธ ถัดไปเป็นห้องของนายท่าน และประตูที่จะพาเราไปหาเมดิฟห์	
VO_Moroes_Male_Human_Wing3Win_02	ใกล้จะถึงชั้นบนสุดแล้ว! เราต้องช่วยเมดิฟห์กลับมาก่อนที่ปาร์ตี้จะกลายเป็นการวิวาท!	
VO_Moroes_Male_Human_Wing4Intro_01	ในที่สุด! เรามาถึงยอดหอคอยแล้ว! หาประตูที่ถูกต้องแล้วพาตัวเมดิฟห์กลับมากัน!	
VO_Moroes_Male_Human_Wing4Win_01	คุณทำสำเร็จ  ข้าไม่อยากจะเชื่อเลยว่าเราเริ่มปาร์ตี้ได้ตรงเวลา สัปดาห์หน้าช่วยกลับมาอีกได้มั้ย มันเป็นวันเกิดของเมดิฟห์ แล้วก็ เอ่อ…ข้าอยากได้คนช่วยน่ะ	
VO_Moroes_Male_Human_WolfClaws_03	ข้าไม่คิดว่าเขาพูดจริงนะ…	
VO_NAX1_01_CARD_02	ให้ข้าชิมหน่อยสิ!	
VO_NAX1_01_DEATH_05	ไม่... ไม่จริง!	
VO_NAX1_01_EMOTE_04	มันพูดได้!	
VO_NAX1_01_HP_03	อีกนิดเดียว เนื้อนุ่มๆ ของข้า!	
VO_NAX1_01_START_01	ยินดีต้อนรับสู่ที่พำนักของข้า	
VO_NAX10_01_DEATH_LINE_03	แพทช์เวิร์คเป็น... อะไร... อ๊าาา…	
VO_NAX10_01_EMOTE1_04	เล่นกันมั้ย?	
VO_NAX10_01_EMOTE2_05	ดี! เล่น! เล่น!	
VO_NAX10_01_HP_02	ไม่เล่นแล้วเหรอ?	
VO_NAX10_01_START_01	แพทช์เวิร์คอยากเล่น!	
VO_NAX11_01_CARD_03	เละ	
VO_NAX11_01_DEATH_05	*อึก เอ่อ อ้าโอ้ แว้ก กรรรลรรลรรลาาาฮฮฮ*	
VO_NAX11_01_EMOTE_04	ไม่คุย	
VO_NAX11_01_HP_02	เหม็น	
VO_NAX11_01_START_01	เนื้อ	
VO_NAX12_01_CARD_01	*คำราม*	
VO_NAX12_01_DEATH_01	*ร้องคราง*	
VO_NAX12_01_EMOTE_01	*บ่น*	
VO_NAX12_01_EMOTE_02	*คำราม*	
VO_NAX12_01_EMOTE_03	*คำราม*	
VO_NAX12_01_HP_01	*อาาาาาร์ งั่ม*	
VO_NAX12_01_START_01	*คำราม*	
VO_NAX13_01_DEATH_LINE_03	ขอบคุณ...	
VO_NAX13_01_EMOTE_04	ฆ่า!	
VO_NAX13_01_HP_02	จงตายซะ!	
VO_NAX13_01_START_01	ข้าต้องเชื่อฟัง!	
VO_NAX14_01_CARD_01	*คำราม*	
VO_NAX14_01_DEATH_01	*คำราม*	
VO_NAX14_01_EMOTE_01	*คำราม*	
VO_NAX14_01_EMOTE_02	*คำราม*	
VO_NAX14_01_EMOTE_03	*คำราม*	
VO_NAX14_01_HP_01	*คำราม*	
VO_NAX14_01_START_01	*คำราม*	
VO_NAX15_01_BIGGLES_32	ไม่!!! ข้าขอสาปแช่งเจ้า ผู้บุกรุก!	
VO_NAX15_01_DEATH_LINE_08	มันยังไม่จบแค่นี้หรอก!!! มาเจอกันในโหมดฮีโร่สิ!	
VO_NAX15_01_DEATH_LINE2_09	ม่ายยยยยยยยยยยยยย!!!	
VO_NAX15_01_EMOTE_HELLO_26	ปกติแล้วเจ้าทักทาย[b]คนที่พยายามฆ่าเจ้าด้วยเหรอ	
VO_NAX15_01_EMOTE_OOPS_29	ใช่เลย	
VO_NAX15_01_EMOTE_SORRY_28	ไม่เป็นไร ผู้บุกรุก ใครๆ ก็เคยผิดพลาดกันทั้งนั้น	
VO_NAX15_01_EMOTE_THANKS_27	ยินดี... มั้ง	
VO_NAX15_01_EMOTE_THREATEN_30	โอ๊ย กลัวจังเลย!	
VO_NAX15_01_EMOTE_WP_25	มันแน่นอนอยู่แล้ว ข้าคือเคลธูซาด พ่อทุกสถาบันนะเฟ้ย!	
VO_NAX15_01_HP_07	เจ้าจะต้องหนาวไปจนถึงกระดูก!	
VO_NAX15_01_HP2_05	วิญญาณเจ้าเป็นของข้าแล้ว	
VO_NAX15_01_HP3_06	เจ้าไม่มีวันหนีพ้น	
VO_NAX15_01_HURRY_31	ความอดทนข้ามีจำกัดนะ	
VO_NAX15_01_PHASE2_10	เจ้าโง่! เจ้าประมาทข้ามากเกินไปแล้ว!	
VO_NAX15_01_PHASE2_ALT_11	ไม่! เทิร์นเจ้าจบแล้ว นี่คือเทิร์น *ของข้า*	
VO_NAX15_01_RESPOND_ANDUIN_24	อ่อนหัดซะจริง! ลืมไปแล้วเหรอว่าเกิดอะไรขึ้นกับอูเธอร์น่ะ?	
VO_NAX15_01_RESPOND_GARROSH_15	เหรอ งั้นข้าเลือกความตายให้ละกัน	
VO_NAX15_01_RESPOND_GARROSH_ALT_16	ถามข้าเหรอ? ดูยังไงเจ้าก็ตายแหงๆ!	
VO_NAX15_01_RESPOND_GULDAN_22	โอ๊ย กินไม่เลือกแบบนี้ระวังจะท้องเสียเอานะ	
VO_NAX15_01_RESPOND_JAINA_23	มั่วเห็นๆ เลยแม่คุณ เจ้าบุกเข้ามาในเนโครโปลิสลอยฟ้าของข้าเองนะ!	
VO_NAX15_01_RESPOND_MALFURION_ALT_21	ธรรมชาติงั้นรึ? แล้วเจ้ามาทำอะไรใน Naxxramas ล่ะ?	
VO_NAX15_01_RESPOND_REXXAR_19	เอาที่เจ้าสบายใจเลย	
VO_NAX15_01_RESPOND_THRALL_17	แฮมเมอร์? สู้เพื่อค้อนเนี่ยนะ เอาที่เจ้าสบายใจเลย	
VO_NAX15_01_RESPOND_UTHER_14	...และข้าก็จะสู้ด้วยมินเนี่ยนโหดๆ และเวทมนตร์ทำลายล้าง โชคดีละกัน!	
VO_NAX15_01_RESPOND_VALEERA_18	ได้ ขอบ ใจ	
VO_NAX15_01_START_13	ในที่สุดเราก็ได้พบกัน	
VO_NAX15_01_SUMMON_ADDS_12	จงเป็นอิสระ มินเนี่ยนของข้า!	
VO_NAX2_01_CARD_02	สังหารพวกมัน ในนามของนายท่าน!	
VO_NAX2_01_CUSTOM_03	เจ้าทำให้ข้าผิดหวัง!	
VO_NAX2_01_DEATH_LINE_05	นายท่านจะล้างแค้นให้ข้า!	
VO_NAX2_01_EMOTE_06	ฮ่าฮ่าฮ่าฮ่า!	
VO_NAX2_01_HP_04	จงคุกเข่าต่อหน้าข้า เจ้าหนอนโสโครก!	
VO_NAX2_01_START_01	เหล่าสาวกล้วนรับใช้ข้า อย่างเปี่ยมศรัทธา!	
VO_NAX3_01_CARD_01	*กรกฮฮกฮกฮ*	
VO_NAX3_01_DEATH_01	*ฟ่อ*	
VO_NAX3_01_EMOTE_01	*ฟ่อ*	
VO_NAX3_01_EMOTE_02	*ฟ่อ*	
VO_NAX3_01_EMOTE_03	*ฟ่อ*	
VO_NAX3_01_EMOTE_04	*ฟ่อ*	
VO_NAX3_01_EMOTE_05	*ฟ่อ*	
VO_NAX3_01_HP_01	*ฟ่อ*	
VO_NAX3_01_START_01	*แซ่กแซ่ก*	
VO_NAX4_01_CARD_03	นี่คือจุดจบของเจ้า	
VO_NAX4_01_DEATH_LINE_04	ข้าจะรับใช้นายท่าน[b]แม้ในความตาย	
VO_NAX4_01_EMOTE_06	ตายซะ ผู้บุกรุก!	
VO_NAX4_01_HP_02	จงตื่นขึ้น ทหารของข้า! ตื่นขึ้นและต่อสู้อีกครั้ง!	
VO_NAX4_01_START_01	วิญญาณดวงใหม่\nสำหรับของสะสมของข้า	
VO_NAX5_01_CARD_03	ข้าจะระเบิดสมองเจ้า!	
VO_NAX5_01_DEATH_LINE_04	ทำไมข้าไม่อาบน้ำมานะ	
VO_NAX5_01_EMOTE_05	ไร้สาระ ข้าไม่สนใจหรอก	
VO_NAX5_01_HP_02	เต้นเข้าไป เจ้าพวกโง่!	
VO_NAX5_01_START_01	คิดว่าปลอดภัยแล้วงั้นรึ	
VO_NAX6_01_CARD_03	จุดจบมาถึงแล้ว	
VO_NAX6_01_DEATH_LINE_04	*เอ่ออออ*	
VO_NAX6_01_EMOTE_05	เปลืองน้ำลายเปล่าๆ	
VO_NAX6_01_HP_02	เจ้าไม่รอดแน่	
VO_NAX6_01_START_01	ข้าเห็นเจ้าแล้ว	
VO_NAX7_01_CARD_03	หาเรื่องใส่ตัวแท้ๆ!	
VO_NAX7_01_DEATH_LINE_04	อั่ก... ข้าตายอย่างมีเกียรติแล้ว	
VO_NAX7_01_EMOTE_05	ฮ่าฮ่า! ข้าเพิ่งเริ่มอุ่นเครื่องเองนะ!	
VO_NAX7_01_HP_02	ย้าาา!	
VO_NAX7_01_START_01	ไม่! ไม่! นักเรียนของข้า! เอาคืนมานะ!	
VO_NAX8_01_CARD_02	ฆ่ามินเนี่ยนของข้าซะสิ... วิญญาณพวกมันจะคอย หลอกหลอนเจ้า	
VO_NAX8_01_CUSTOM_03	ฮ่าฮ่าฮ่า! เจ้าโง่! ข้าคือยมทูตล่าวิญญาณนะ!	
VO_NAX8_01_CUSTOM2_04	คนตายคืนชีพ!	
VO_NAX8_01_DEATH_LINE_05	ข้าเสียท่าแล้ว!	
VO_NAX8_01_EMOTE1_06	เจ้านำหายนะมาสู่ตน อย่างโง่เขลา	
VO_NAX8_01_EMOTE2_07	เจ้าบังอาจเผชิญหน้า กับอำนาจที่อยู่เหนือ ความเข้าใจอย่างโอหัง	
VO_NAX8_01_EMOTE3_08	เจ้าต่อสู้ฝ่าฟันและรุกล้ำ เข้ามาในดินแดนของ ยมทูตล่าวิญญาณ	
VO_NAX8_01_EMOTE4_09	ตอนนี้เจ้าเหลือทางรอด เพียงทางเดียว...	
VO_NAX8_01_EMOTE5_10	... เปิดเมนูตัวเลือก แล้วกดยอมแพ้ซะ	
VO_NAX8_01_START_01	มินเนี่ยนของข้าไม่เคยตาย	
VO_NAX9_01_CUSTOM_02	เลิกคุยกันได้แล้ว ให้มันมาเลย	
VO_NAX9_01_DEATH_LINE_03	ไม่! ข้าต้องการเวลาอีก!	
VO_NAX9_01_EMOTE_04	อยากตายงั้นรึ?	
VO_NAX9_01_START_01	เราจะบดขยี้เจ้าไม่ให้เหลือซาก	
VO_NAX9_02_CUSTOM_01	ผู้บุกรุก! กลับไปซะ ระหว่างที่เจ้า ยังมีโอกาส!	
VO_NAX9_03_CUSTOM_01	ไม่เอาน่าเซเลียค ให้เราสนุกกันหน่อยสิ	
VO_NAX9_04_CUSTOM_01	เข้ามาเลย ไอ้กระจอก!	
VO_Nazra_Female_Orc_FinalNazraChogall_02	เผ่าทไวไลท์แฮมเมอร์? ที่นี่เนี่ยนะ?	
VO_Nazra_Female_Orc_FinalNazraDeath_01	แด่ชนเผ่า...	
VO_Nazra_Female_Orc_FinalNazraEmoteResponse_01	นาซร่าจะบดขยี้เจ้า!	
VO_Nazra_Female_Orc_FinalNazraGrom_01	กรอมแมช?! ไม่เจอกันนานนะ!	
VO_Nazra_Female_Orc_FinalNazraHeroPower_01	นาซร่าจะปกครองโลกไร้ค่านี้เอง!	
VO_Nazra_Female_Orc_FinalStartSequence_01	จงสยบให้กับชนเผ่า!	
VO_NEFARIAN_ATRAMEDES_DEATH_76	เจ้าฆ่ามังกรตาบอด ไม่รู้สึกละอายใจบ้างหรือไง	
VO_NEFARIAN_BARON_GEDDON_DEAD_40	เราใกล้จะถึงแล้ว ดี ดีมาก!	
VO_NEFARIAN_CHROMAGGUS_DEAD_63	ที่จริงแล้ว โครแม็กกัสเป็นลูกสมุนที่อ่อนแอที่สุดของข้าต่างหาก อย่าเหลิงไปหน่อยเลย	
VO_NEFARIAN_CHROMAGGUS1_59	ที่ข้าให้มันมีสองหัวก็เพราะว่ามันจะได้กัดเจ็บเป็นสองเท่าไง	
VO_NEFARIAN_CHROMAGGUS2_60	ข้าผสมผสานพลังของดราก้อนไฟลท์ทั้งหมดลงในตัวมัน นี่แหละคือความสมบูรณ์แบบ	
VO_NEFARIAN_CHROMAGGUS3_61	ดีมาก โครแม็กกัส เด็กดี	
VO_NEFARIAN_CHROMAGGUS4_62	การ์ดเริ่มเต็มมือแล้วล่ะสิ? เก่งมากเจ้าหนู	
VO_NEFARIAN_COREN_DEAD_28	กริม กัซเลอร์ น่าขำสิ้นดี	
VO_NEFARIAN_DRAKKISATH_DEAD_50	ข้าชักจะเริ่มรำคาญแล้ว	
VO_NEFARIAN_DRAKKISATH_RESPOND_48	ใช่แล้ว ดราคคิซาธ นักผจญภัย เจ้าอยู่ผิดที่ผิดทางอีกแล้ว!	
VO_NEFARIAN_DRAKKISATH1_49	ฟังนะ ไปลองเล่นโหมดจัดอันดับดูสิ การผจญภัยนี้ไม่เหมาะสำหรับเจ้าหรอก	
VO_NEFARIAN_GARR_DEAD1_38	เจ้าน่าจะเก็บชิ้นส่วนของการ์ไปโยนลงในบ่อลาวาของแร็กนารอสนะ เขาต้องชอบแน่	
VO_NEFARIAN_GARR2_35	ระวังก้อนหินเล็กๆ พวกนั้นด้วยนะ เข้าใจมั้ย?	
VO_NEFARIAN_GARR3_36	ระวังอย่าให้ตัวระเบิดล่ะ เจ้ายังต้องไปกำจัดเจ้าแห่งธาตุต่อนะ	
VO_NEFARIAN_GARR4_37	รู้อะไรไหม ข้าล่ะชอบความทุ่มเทของเจ้าจริงๆ	
VO_NEFARIAN_GRIMSTONE_DEAD1_30	ถ้ายังเป็นแบบนี้อยู่ อีกไม่นานต้องกำจัดแร็กนารอสได้แน่!	
VO_NEFARIAN_HEROIC_BLOCK_77	นี่มันโหมดฮีโร่นะ อย่าหวัง	
VO_NEFARIAN_MALORIAK_DEATH_PT1_72	ยินดีด้วย เป็นความสำเร็จที่ยิ่งใหญ่มากกกกกก	
VO_NEFARIAN_MALORIAK_DEATH_PT2_73	ข้าคิดว่าข้าจะตั้งชื่อใหม่ให้เจ้า เพื่อเป็นเกียรติแก่ช่วงเวลานี้	
VO_NEFARIAN_MALORIAK_DEATH_PT3_74	ผู้สังหารเหล่ามินเนี่ยนที่โง่เง่า ไร้ความสามารถ และน่าผิดหวัง ใช่แล้ว เหมาะมาก	
VO_NEFARIAN_MALORIAK_TURN2_71	มาลอเรียค พยายามอย่าแพ้ให้กับเจ้ามนุษย์นี่ล่ะ	
VO_NEFARIAN_NEF_MISSION_66	นี่มันโกงกันชัดๆ! ข้าไม่ยอมหรอก!	
VO_NEFARIAN_NEF2_65	ไม่! ไม่! ข้าจะทำลายเจ้า!	
VO_NEFARIAN_OMNOTRON_DEAD_69	เจ้าช่วยข้าประหยัดค่าซ่อมแซมไปได้เยอะเลย ขอบใจนะ	
VO_NEFARIAN_OMOKK_DEAD_46	นี่มันไร้สาระที่สุด!	
VO_NEFARIAN_OMOKK1_44	เจ้ามาทำอะไรที่นี่? แร็กนารอสตายแล้ว เจ้าก็น่าจะไปฉลองกับเพื่อนๆ นะ	
VO_NEFARIAN_OMOKK2_45	ข้าชักจะงงแล้วนะ แร็กนารอสไม่ได้อยู่ที่นี่แล้ว ภารกิจของเจ้าจบแล้ว กลับบ้านไปซะสิ	
VO_NEFARIAN_RAZORGORE_DEAD_55	ไข่พวกนั้นคือการทดลองอันยิ่งใหญ่ของข้านะ!	
VO_NEFARIAN_REND_DEAD_53	เอาล่ะ มนุษย์ เจ้าหาเรื่องมังกรผิดตัวแล้ว	
VO_NEFARIAN_REND1_52	แม้แต่ออร์คตัวนี้ยังรู้เลยว่าเจ้าทำไม่ถูก!	
VO_NEFARIAN_THAURISSAN_DEAD_32	เจ้าน่าจะกำจัดคนแคระอีกคนนั่นด้วย! ฆ่าให้หมดอย่าให้เหลือ!	
VO_NEFARIAN_THAURISSAN_DEAD2_33	เจ้าฆ่าคนแคระได้ทั้งคู่เลยรึ! น่าประทับใจจริงเชียว นักผจญภัย	
VO_NEFARIAN_VAEL_DEAD_57	ฮ่า! เจ้าเพิ่งฆ่ามังกรดีๆ ไปตัวนึงนะ สำนึกผิดบ้างรึเปล่าเนี่ย?	
VO_Netherspite_Male_Dragon_NetherspiteAngryChicken_01	เจ้าอีกแล้ว!  ทำไมเจ้าถึงมาอยู่ในประตู\nของข้าได้ทุกครั้งเลย?!	
VO_Netherspite_Male_Dragon_NetherspiteDeath_01	งานของข้า...	
VO_Netherspite_Male_Dragon_NetherspiteEmoteResponse_01	เจ้ากล้าท้าทายมังกร\nในห้องแล็บของเขางั้นรึ?	
VO_Netherspite_Male_Dragon_NetherspiteEmpowerment_01	มีโลกอยู่มากมาย! มีหลายสิ่งให้ข้าเรียนรู้!	
VO_Netherspite_Male_Dragon_NetherspiteOpen_01	ใครบังอาจรบกวน\nการวิจัยของข้า?	
VO_Netherspite_Male_Dragon_NetherspiteShadowBreath_01	ไปให้พ้น!	
VO_Netherspite_Male_Dragon_NetherspiteTurn12_01	If 12 murlocs leave the red portal at 4 o’clock, and C’Thun arrives at 5 o’clock...	
VO_Netherspite_Male_Dragon_NetherspiteTurn3_02	การทดลองของข้า! อย่ายุ่งกับมันนะ!	
VO_Netherspite_Male_Dragon_NetherspiteTurn5_01	อย่าแตะต้องประตูมิติ!\n ข้าปรับจูนระบบควบคุม\nการไหลเวียนไว้ดีแล้ว!	
VO_Netherspite_Male_Dragon_NetherspiteTurn7_01	ปาร์ตี้นั่นฟังดูน่าสนุกนะ\n ไปร่วมงานแล้วเลิกยุ่งกับ\nประตูมิติของข้าซะที!	
VO_Netherspite_Male_Dragon_NetherspiteUnstablePortal_01	น่าสนใจ อืมมม... มีความไม่เสถียรขั้นพื้นฐาน	
VO_Netherspite_Male_Dragon_NetherspiteUnstablePortal_02	น่าสนใจ... มีความไม่เสถียรขั้นพื้นฐาน...	
VO_Nightbane_Roar	*คำราม*	
VO_PrinceKeleseth_Male_Vampire_ResponseLanaThel_01	องค์ราชินี!	
VO_PrinceTaldaram_Male_Vampire_ResponseLanaThel_01	ราชินี... ข้าต้องการเลือด	
VO_PrinceValanar_Male_Vampire_ResponseLanaThel_01	ราชินีลานา'เธล	
VO_RAGNAROS_GRIMSTONE_DEAD2_66	ข้าจะกำจัดเจ้า เจ้าจิ้งจก!	
VO_RAGNAROS_NEF1_71	นักผจญภัย! ดูเหมือนเจ้าจะต้องการความช่วยเหลือ!	
VO_RAGNAROS_NEF3_72	ข้าจะต้องได้แก้แค้น! ไฟจะเผาผลาญมัน!	
VO_RAGNAROS_NEF4_73	ข้าจะส่งมินเนี่ยนของข้าไปทำลายเจ้า แบล็ควิง!	
VO_RAGNAROS_NEF5_74	เล่นงานไอ้มังกรขี้โม้นี่ให้เละไปเลย!	
VO_RAGNAROS_NEF6_75	ของขวัญจากไฟร์แลนด์!	
VO_RAGNAROS_NEF7_76	เจ้าไม่มีวันดับเปลวไฟของเจ้าแห่งเพลิงได้!	
VO_RAGNAROS_NEF8_77	ข้าจะแก้แค้น เจ้ามังกร!	
VO_Rakanishu_Male_Elemental_CastSpell1_01	อย่าเอาข้าไป!	
VO_Rakanishu_Male_Elemental_CastSpell2_01	มอดไหม้ในกองเพลิง!	
VO_Rakanishu_Male_Elemental_CastSpell3_01	ตายซะ นักผจญภัย!	
VO_Rakanishu_Male_Elemental_CastSpell4_01	เพื่อราฟาม!	
VO_Rakanishu_Male_Elemental_CastSpell5_01	ทุกสิ่งจงมอดไหม้!	
VO_Rakanishu_Male_Elemental_EventRagnaros_02	ฮีโร่ของข้า!	
VO_Rakanishu_Male_Elemental_Intro_01	ทำลาย! เอาสมบัติมา!	
VO_SilverwareGolem_Male_SilverwareGolem_SilverwareDeath_02	กินหมดไม่เหลือเลย…	
VO_SilverwareGolem_Male_SilverwareGolem_SilverwareEmoteResponse_01	ได้เวลาขัดเงาแล้ว!	
VO_SilverwareGolem_Male_SilverwareGolem_SilverwareForkedLightning_01	นอกจากส้อมแล้วมีอะไรที่เป็นแฉกๆ อีกน้า?	
VO_SilverwareGolem_Male_SilverwareGolem_SilverwareHeroPower_01	เตรียมตั้งโต๊ะ! เตรียมเปิดฟลอร์!	
VO_SilverwareGolem_Male_SilverwareGolem_SilverwareKnifeJuggler_01	อู้ว ขว้างมีด!	
VO_SilverwareGolem_Male_SilverwareGolem_SilverwareOpen_01	เต้นกันมันส์จะตาย!	
VO_SilverwareGolem_Male_SilverwareGolem_SilverwarePlateTossing_01	รับจานไป! รับจานไป! ทุกคนรับจานไป!	
VO_TB_MEDIVA1_001	เผาเลย...	
VO_TB_MEDIVA1_002	ระวัง!	
VO_TB_MEDIVA1_003	โอ้ ติโต้!	
VO_TB_MEDIVA1_004	หายเร็วๆ นะ...	
VO_TB_MEDIVA1_005	สัตว์ร้าย!	
VO_TB_MEDIVA1_006	นุ่มนิ่มน่ากอด	
VO_TB_MEDIVA1_007	ไม่! ไม่เอายาพิษ!	
VO_TB_MEDIVA1_008	สว่างวาบ!	
VO_TB_MEDIVA1_009	เรียกข้าเหรอ? 	
VO_TB_MEDIVA2_001	ฮอทมาก!	
VO_TB_MEDIVA2_002	น่ากลัวจัง!	
VO_TB_MEDIVA2_003	อู้ว หนาว!	
VO_TB_MEDIVA2_004	โอ้ไม่ กับดัก!	
VO_TB_MEDIVA2_005	ข้าทนดูไม่ไหวแล้ว!	
VO_TB_MEDIVA2_006	น่าร้าก	
VO_TB_MEDIVA2_007	ข้าชอบอิมพ์	
VO_TB_MEDIVA2_008	สว่างวาบ!	
VO_TB_MEDIVA2_009	ฮัดเช้ย! อั่ก!	
VO_TB_MEDIVA2_010	เรียกข้าเหรอ?	
VO_TB_MEDIVA3_001	ฮอทมาก!	
VO_TB_MEDIVA3_002	หนาวจ้าหนาว!	
VO_TB_MEDIVA3_003	ความมืดน่ากลัว!	
VO_TB_MEDIVA3_004	กับดัก!	
VO_TB_MEDIVA3_005	สัตว์เต็มไปหมดเลย!	
VO_TB_MEDIVA3_006	มีสัตว์เลี้ยงด้วย!	
VO_TB_MEDIVA3_007	โอ้ ไม่ ท่าทางไม่ดีเลย	
VO_TB_MEDIVA3_008	พิษร้ายนะนั่น...	
VO_TB_MEDIVA3_009	แล้วก็...เมดิว่า!	
VO_TB_MEDIVA3_010	จ๋า!	
VO_Terenas_Male_Human_ICCDruidVictory_01	ครั้งหนึ่งเขาเคยหล่อเลี้ยงชีวิตด้วยการปกป้องดูแลผืนป่าแห่งอาเซรอธ แต่ยามนี้มัลฟิวเรี่ยน ผู้ผลาญชีวิตรักษาสมดุลธรรมชาติด้วยการกำจัดชีวิตในสวนแห่งความตาย	
VO_Terenas_Male_Human_ICCHunterVictory_01	เร็กซ์ซาร์ปลดปล่อยวิญญาณที่ถูกลิชคิงกักขังให้เป็นอิสระ เขาหยิบลูกธนูสีดำออกจากกระบอก "มาเถอะ มิชา!" เขาเอ่ย "ถึงเวลาออกล่าแล้ว..."	
VO_Terenas_Male_Human_ICCMageVictory_01	ฟรอสต์ลิชตนใหม่ทอดตามองอาณาจักรของนาง กองทัพอันเดดจำนวนมหาศาลกลายเป็นขุมกำลังใหม่ นางไม่ทันสังเกตด้วยซ้ำว่าเลือดในกายเย็นจนเป็นน้ำแข็งแล้ว	
VO_Terenas_Male_Human_ICCPaladinVictory_01	อดีตพาลาดินผู้สูงส่งยอมรับชะตากรรมใหม่ของตน ผู้ที่ดำเนินชีวิตอย่างมีเกียรติไม่จำเป็นต้องหวาดกลัว แต่เมื่อความตายมาเยือน เหล่าผู้ชั่วช้าจะต้องถูกเขาพิพากษา... 	
VO_Terenas_Male_Human_ICCPriestVictory_01	ร่างกายของเจ้าชายหนุ่มสลายกลายเป็นเงามืด “ข้าเข้าใจแล้ว” เขาเอ่ยปาก เปลวเพลิงสีฟ้าลุกโพลงในดวงตาของเขา "ข้าช่างอ่อนหัดเหลือเกิน..."	
VO_Terenas_Male_Human_ICCRogueVictory_01	เพชฌฆาตไร้วิญญาณวาลีร่าหายตัวไปในยามราตรี ภูตผีและเงามืดของนางรับรู้ทุกสิ่ง คนตายโกหกไม่ได้ และไม่มีใครปลอดภัยจากคมมีดเย็นเยียบของนาง...	
VO_Terenas_Male_Human_ICCShamanVictory_01	The shaman’s mind was overwhelmed with voices, a cacophony of the dead. The Deathseer closed his eyes and uttered a single word: “Sleep…”	
VO_Terenas_Male_Human_ICCWarlockVictory_01	ท้ายที่สุดกุล'ดานก็ได้ครอบครองบัลลังก์เยือกแข็ง ประตูมิติมืดเปิดขึ้นอีกครา และโลกอื่นอีกนับไม่ถ้วนจะต้องสยบต่อเขา...	
VO_Terenas_Male_Human_ICCWarriorVictory_01	อดีตผู้นำแห่งชนเผ่ารับพลังใหม่มาอย่างยินดี ซากศพเยือกแข็งที่ถูกกองทัพของเขาสังหารจะลุกขึ้นมารับใช้ จนกระทั่งวันที่เขาปกครองดินแดนทั้งหมดแต่เพียงผู้เดียว...	
VO_TIRION_INTRO_03	อัศวินผู้กล้าคนใดกันนะที่จะได้รับตำแหน่งแชมเปี้ยนวันนี้	
VO_WhiteKing_Male_ChessPiece_ChessDeath_01	รุกฆาต...	
VO_WhiteKing_Male_ChessPiece_ChessEmoteGreetings_01	เล่นกันซักเกมมั้ย?	
VO_WhiteKing_Male_ChessPiece_ChessEmoteOops_01	โอ้ พลาดแล้ว	
VO_WhiteKing_Male_ChessPiece_ChessEmoteSorry_01	โชคไม่ดีเลย	
VO_WhiteKing_Male_ChessPiece_ChessEmoteThanks_01	ใจดีเหลือเกิน	
VO_WhiteKing_Male_ChessPiece_ChessEmoteThinking_01	เรือไปที่ A3...	
VO_WhiteKing_Male_ChessPiece_ChessEmoteThinking_02	ม้าไปที่ F6...	
VO_WhiteKing_Male_ChessPiece_ChessEmoteThinking_03	ควีนไปที่ E5... ไม่ ไม่...	
VO_WhiteKing_Male_ChessPiece_ChessEmoteThreaten_01	ข้าจะรุกฆาตในอีก 4 ตา	
VO_WhiteKing_Male_ChessPiece_ChessEmoteWellPlayed_01	รุกฆาต	
VO_WhiteKing_Male_ChessPiece_ChessEmoteWow_01	อ้า ยอดเยี่ยมมาก!	
VO_WhiteKing_Male_ChessPiece_ChessOpen_02	อังการ์ด!	
VOX_Nightbane_Start_01	แฮ่!	
