TAG	TEXT	COMMENT
GAMEPLAY_EMOTE_EX1_323h_CONCEDE	Wygrywasz... ALE ŚWIAT I TAK CZEKA ZAGŁADA!!	
GAMEPLAY_EMOTE_EX1_323h_ERROR_FULL_MINIONS	ZBYT WIELE STWORÓW!	
GAMEPLAY_EMOTE_EX1_323h_ERROR_GENERIC	NIE MOGĘ TEGO ZROBIĆ!	
GAMEPLAY_EMOTE_EX1_323h_ERROR_HAND_FULL	ZA DUŻO KART!!!	
GAMEPLAY_EMOTE_EX1_323h_ERROR_I_ATTACKED	JUŻ ATAKOWAŁEM.	
GAMEPLAY_EMOTE_EX1_323h_ERROR_JUST_PLAYED	DAJ MU CHWILĘ!	
GAMEPLAY_EMOTE_EX1_323h_ERROR_MINION_ATTACKED	TEN STWÓR JUŻ ATAKOWAŁ!	
GAMEPLAY_EMOTE_EX1_323h_ERROR_NEED_MANA	ZA MAŁO MANY!	
GAMEPLAY_EMOTE_EX1_323h_ERROR_NEED_WEAPON	GDZIE SIĘ PODZIAŁA MOJA BROŃ?!	
GAMEPLAY_EMOTE_EX1_323h_ERROR_PLAY	NIE MOGĘ TEGO ZAGRAĆ!	
GAMEPLAY_EMOTE_EX1_323h_ERROR_STEALTH	JEST W UKRYCIU!	
GAMEPLAY_EMOTE_EX1_323h_ERROR_TARGET	NIE DA SIĘ!	
GAMEPLAY_EMOTE_EX1_323h_ERROR_TAUNT	TEN IRYTUJĄCY STWÓR STOI MI NA DRODZE!	
GAMEPLAY_EMOTE_EX1_323h_FIRE_FESTIVAL	ROZPALMY OGNIE!	
GAMEPLAY_EMOTE_EX1_323h_GOOD_GAME	DOBRA GRA!	
GAMEPLAY_EMOTE_EX1_323h_GREETINGS	Stoisz przed Jaraxusem, władcą Płonącego Legionu!	
GAMEPLAY_EMOTE_EX1_323h_HALLOWS_END	ZADUSZNIKI... TEŻ WYZIONIESZ DUCHA!	
GAMEPLAY_EMOTE_EX1_323h_LOW_CARDS	BRAKUJE MI KART W TALII!	
GAMEPLAY_EMOTE_EX1_323h_LUNAR_NEW_YEAR	Stoisz przed Jaraxusem, władcą Płonącego Legionu!	
GAMEPLAY_EMOTE_EX1_323h_NO_CARDS	NIEE! SKOŃCZYŁY MI SIĘ KARTY!	
GAMEPLAY_EMOTE_EX1_323h_NOBLEGARDEN	WESOŁYCH MIŁOGRODÓW!	
GAMEPLAY_EMOTE_EX1_323h_OOPS	TO BYŁ BŁĄD!!!!	
GAMEPLAY_EMOTE_EX1_323h_PIRATE_DAY	JESTEM JARRRRRRRAXXUS!	
GAMEPLAY_EMOTE_EX1_323h_SORRY	JARAXUSOWI JEST... przykro.	
GAMEPLAY_EMOTE_EX1_323h_THANKS	DZIĘKI!	
GAMEPLAY_EMOTE_EX1_323h_THINK1	Hmmm…	
GAMEPLAY_EMOTE_EX1_323h_THINK2	Tak sobie myślę...	
GAMEPLAY_EMOTE_EX1_323h_THINK3	Jak by cię tu zniszczyć...	
GAMEPLAY_EMOTE_EX1_323h_THREATEN	ZNISZCZENIE!!!	
GAMEPLAY_EMOTE_EX1_323h_TIMER	CZAS UCIEKA	
GAMEPLAY_EMOTE_EX1_323h_WELL_PLAYED	NIEŹLE!	
GAMEPLAY_EMOTE_EX1_323h_WINTERVEIL_GREETINGS	URZĄDZĘ SOBIE UCZTĘ Z TWOJEJ DUSZY!	
GAMEPLAY_EMOTE_EX1_323h_WOW_04	NIEWIARYGODNE!	
GAMEPLAY_EMOTE_HERO_01_CONCEDE	Wybieram śmierć!	
GAMEPLAY_EMOTE_HERO_01_ERROR_FULL_MINIONS	Mam zbyt wielu stronników.	
GAMEPLAY_EMOTE_HERO_01_ERROR_GENERIC	Nie mogę tego zrobić.	
GAMEPLAY_EMOTE_HERO_01_ERROR_HAND_FULL	Mam pełną rękę!	
GAMEPLAY_EMOTE_HERO_01_ERROR_I_ATTACKED	Już atakowałem.	
GAMEPLAY_EMOTE_HERO_01_ERROR_JUST_PLAYED	Daj temu stronnikowi turę na przygotowanie.	
GAMEPLAY_EMOTE_HERO_01_ERROR_MINION_ATTACKED	Ten stronnik już atakował.	
GAMEPLAY_EMOTE_HERO_01_ERROR_NEED_MANA	Mam za mało many.	
GAMEPLAY_EMOTE_HERO_01_ERROR_NEED_WEAPON	Potrzebna mi broń.	
GAMEPLAY_EMOTE_HERO_01_ERROR_PLAY	Nie mogę tego zagrać.	
GAMEPLAY_EMOTE_HERO_01_ERROR_STEALTH	Nie mogę wybrać ukrytych stronników.	
GAMEPLAY_EMOTE_HERO_01_ERROR_TARGET	To nie jest prawidłowy cel.	
GAMEPLAY_EMOTE_HERO_01_ERROR_TAUNT	Na drodze stoi stronnik z Prowokacją.	
GAMEPLAY_EMOTE_HERO_01_EVENT_FIRE_FESTIVAL	Rozpalcie świąteczne ogniska!	
GAMEPLAY_EMOTE_HERO_01_EVENT_LUNAR_NEW_YEAR	Ha, witaj...	
GAMEPLAY_EMOTE_HERO_01_GOOD_GAME	Dobra gra!	
GAMEPLAY_EMOTE_HERO_01_GREETINGS	Ha, witaj...	
GAMEPLAY_EMOTE_HERO_01_HALLOWS_END	Szczęśliwych Zaduszników!	
GAMEPLAY_EMOTE_HERO_01_LOW_CARDS	Kart już prawie nie mam!	
GAMEPLAY_EMOTE_HERO_01_MIRROR_START	Ha! Pokaż, co potrafisz!	
GAMEPLAY_EMOTE_HERO_01_NO_CARDS	Skończyły mi się karty!	
GAMEPLAY_EMOTE_HERO_01_NOBLEGARDEN	Radosnych Miłogrodów!	
GAMEPLAY_EMOTE_HERO_01_OOPS	To był błąd.	
GAMEPLAY_EMOTE_HERO_01_PIRATE_DAY	Arrrr! Pirrratem być!	
GAMEPLAY_EMOTE_HERO_01_SORRY	Przepraszam za to.	
GAMEPLAY_EMOTE_HERO_01_START	Zwycięstwo albo śmierć!	
GAMEPLAY_EMOTE_HERO_01_THANKS	Dzięki.	
GAMEPLAY_EMOTE_HERO_01_THINK1	Hmmm…	
GAMEPLAY_EMOTE_HERO_01_THINK2	Tak się zastanawiam…	
GAMEPLAY_EMOTE_HERO_01_THINK3	Co teraz...	
GAMEPLAY_EMOTE_HERO_01_THREATEN	Zmiażdżę cię!	
GAMEPLAY_EMOTE_HERO_01_TIMER	Muszę wybrać!	
GAMEPLAY_EMOTE_HERO_01_WELL_PLAYED	Dobre zagranie.	
GAMEPLAY_EMOTE_HERO_01_WINTERVEIL_GREETINGS	Szczęśliwej Zimowej Uczty!	
GAMEPLAY_EMOTE_HERO_01_WOW	Niesamowite!	
GAMEPLAY_EMOTE_HERO_01A_CELEBRATE	Hip hip hurra!	
GAMEPLAY_EMOTE_HERO_01A_CONCEDE	No cóż... wygrywasz.	
GAMEPLAY_EMOTE_HERO_01A_ERROR_FULL_MINIONS	Za dużo u mnie stronników.	
GAMEPLAY_EMOTE_HERO_01A_ERROR_GENERIC	Nie mogę tego zrobić.	
GAMEPLAY_EMOTE_HERO_01A_ERROR_HAND_FULL	Nie mam już miejsca w ręce!	
GAMEPLAY_EMOTE_HERO_01A_ERROR_I_ATTACKED	Jam już atakował.	
GAMEPLAY_EMOTE_HERO_01A_ERROR_JUST_PLAYED	Daj temu stronnikowi turę, co by się przygotował.	
GAMEPLAY_EMOTE_HERO_01A_ERROR_MINION_ATTACKED	Ten stronnik już atakował.	
GAMEPLAY_EMOTE_HERO_01A_ERROR_NEED_MANA	Za mało mam many.	
GAMEPLAY_EMOTE_HERO_01A_ERROR_NEED_WEAPON	Broń potrzebuję.	
GAMEPLAY_EMOTE_HERO_01A_ERROR_PLAY	Nie mogę tego zagrać.	
GAMEPLAY_EMOTE_HERO_01A_ERROR_STEALTH	Ukrytych stronników nawet król nie namierzy.	
GAMEPLAY_EMOTE_HERO_01A_ERROR_TARGET	To nie jest tentegowy cel.	
GAMEPLAY_EMOTE_HERO_01A_ERROR_TAUNT	Trza mi zaatakować stronnika z Prowokacją.	
GAMEPLAY_EMOTE_HERO_01A_EVENT_LUNAR_NEW_YEAR	Witojże.	
GAMEPLAY_EMOTE_HERO_01A_FIRE_FESTIVAL	Celebrujemy Festiwal Letniego Przesilenia!	
GAMEPLAY_EMOTE_HERO_01A_GOOD_GAME	Dobra gra!	
GAMEPLAY_EMOTE_HERO_01A_GREETINGS	Witojże.	
GAMEPLAY_EMOTE_HERO_01A_HALLOWS_END	Szczęśliwych Zaduszników.	
GAMEPLAY_EMOTE_HERO_01A_LOW_CARDS	Już prawie nie mam kart!	
GAMEPLAY_EMOTE_HERO_01A_MIRROR_START	Ano! Za Khaz Modan!	
GAMEPLAY_EMOTE_HERO_01A_NO_CARDS	Karty mnie się skończyły.	
GAMEPLAY_EMOTE_HERO_01A_NOBLEGARDEN	Wesołych Miłogrodów!	
GAMEPLAY_EMOTE_HERO_01A_OOPS	Cuś tu... nie wysło.	
GAMEPLAY_EMOTE_HERO_01A_PIRATE_DAY	Arrrrr! Jestem morrrrskim wilkiem!	
GAMEPLAY_EMOTE_HERO_01A_SORRY	Strasznie mi przykro.	
GAMEPLAY_EMOTE_HERO_01A_START	Za Khaz Modan!	
GAMEPLAY_EMOTE_HERO_01A_THANKS	Aaa, dzięki wielkie!	
GAMEPLAY_EMOTE_HERO_01A_THINK1	Hmm...	
GAMEPLAY_EMOTE_HERO_01A_THINK2	Może zrobim tak... No, nie nie nie.	
GAMEPLAY_EMOTE_HERO_01A_THINK3	Tyle do wyboru...	
GAMEPLAY_EMOTE_HERO_01A_THREATEN	Poczuj gniew gór!	
GAMEPLAY_EMOTE_HERO_01A_TIMER	Oj, trza się w końcu ruszyć!	
GAMEPLAY_EMOTE_HERO_01A_WELL_PLAYED	Pikne zagranie.	
GAMEPLAY_EMOTE_HERO_01A_WINTERVEIL_GREETINGS	Szczęśliwej Zimowej Uczty!	
GAMEPLAY_EMOTE_HERO_01A_WOW	Na mojom brodę!	
GAMEPLAY_EMOTE_HERO_02_CONCEDE	Wygrana jest twoja.	
GAMEPLAY_EMOTE_HERO_02_ERROR_FULL_MINIONS	Mam zbyt wielu stronników.	
GAMEPLAY_EMOTE_HERO_02_ERROR_GENERIC	Nie mogę tego zrobić.	
GAMEPLAY_EMOTE_HERO_02_ERROR_HAND_FULL	Mam za dużo kart!	
GAMEPLAY_EMOTE_HERO_02_ERROR_I_ATTACKED	Ja już atakowałem.	
GAMEPLAY_EMOTE_HERO_02_ERROR_JUST_PLAYED	Daj temu stronnikowi turę na przygotowanie.	
GAMEPLAY_EMOTE_HERO_02_ERROR_MINION_ATTACKED	Ten stronnik już atakował.	
GAMEPLAY_EMOTE_HERO_02_ERROR_NEED_MANA	Mam za mało many.	
GAMEPLAY_EMOTE_HERO_02_ERROR_NEED_WEAPON	Potrzebna mi broń.	
GAMEPLAY_EMOTE_HERO_02_ERROR_PLAY	Nie mogę tego zagrać.	
GAMEPLAY_EMOTE_HERO_02_ERROR_STEALTH	Nie mogę wybrać ukrytych stronników.	
GAMEPLAY_EMOTE_HERO_02_ERROR_TARGET	To nie jest prawidłowy cel.	
GAMEPLAY_EMOTE_HERO_02_ERROR_TAUNT	Na drodze stoi stronnik z Prowokacją.	
GAMEPLAY_EMOTE_HERO_02_EVENT_FIRE_FESTIVAL	Święto żywiołów!	
GAMEPLAY_EMOTE_HERO_02_EVENT_LUNAR_NEW_YEAR	Witaj!	
GAMEPLAY_EMOTE_HERO_02_GOOD_GAME	Dobre zagranie.	
GAMEPLAY_EMOTE_HERO_02_GREETINGS	Witaj!	
GAMEPLAY_EMOTE_HERO_02_HALLOWS_END	Szczęśliwych Zaduszników!	
GAMEPLAY_EMOTE_HERO_02_LOW_CARDS	Już prawie nie mam kart!	
GAMEPLAY_EMOTE_HERO_02_MIRROR_START	Za Mroźne Wilki!	
GAMEPLAY_EMOTE_HERO_02_NO_CARDS	Skończyły mi się karty!	
GAMEPLAY_EMOTE_HERO_02_NOBLEGARDEN	Wesołych Miłogrodów, przyjacielu.	
GAMEPLAY_EMOTE_HERO_02_OOPS	To był błąd.	
GAMEPLAY_EMOTE_HERO_02_PIRATE_DAY	Arrr, szczurry lądowe. Dziś dzień pirrrata!	
GAMEPLAY_EMOTE_HERO_02_SORRY	Przepraszam za to.	
GAMEPLAY_EMOTE_HERO_02_START	Za Zgładziciela!	
GAMEPLAY_EMOTE_HERO_02_THANKS	Dziękuję ci!	
GAMEPLAY_EMOTE_HERO_02_THINK1	Hmmm…	
GAMEPLAY_EMOTE_HERO_02_THINK2	Tak sobie myślę...	
GAMEPLAY_EMOTE_HERO_02_THINK3	Hmm... Co tu robić...	
GAMEPLAY_EMOTE_HERO_02_THREATEN	Zniszczą cię żywioły!	
GAMEPLAY_EMOTE_HERO_02_TIMER	My tu kartu kartu, a czas ucieka!	
GAMEPLAY_EMOTE_HERO_02_WELL_PLAYED	Dobre zagranie.	
GAMEPLAY_EMOTE_HERO_02_WINTERVEIL_GREETINGS	Szczęśliwej Zimowej Uczty!	
GAMEPLAY_EMOTE_HERO_02_WOW	To niesamowite!	
GAMEPLAY_EMOTE_HERO_02A_CELEBRATE	<Świętowanie!>	
GAMEPLAY_EMOTE_HERO_02A_CONCEDE	<Zostałem\npokonany.>	
GAMEPLAY_EMOTE_HERO_02A_ERROR_FULL_MINIONS	<Mam zbyt\nwielu stronników.>	
GAMEPLAY_EMOTE_HERO_02A_ERROR_GENERIC	<Nie mogę\ntego zrobić.>	
GAMEPLAY_EMOTE_HERO_02A_ERROR_HAND_FULL	<Mam pełną rękę.>	
GAMEPLAY_EMOTE_HERO_02A_ERROR_I_ATTACKED	<Już atakowałem.>	VO_HERO_15_ERROR04_43.wav
GAMEPLAY_EMOTE_HERO_02A_ERROR_JUST_PLAYED	<Ten stronnik\nmusi poczekać.>	
GAMEPLAY_EMOTE_HERO_02A_ERROR_MINION_ATTACKED	<Ten stronnik\njuż atakował.>	
GAMEPLAY_EMOTE_HERO_02A_ERROR_NEED_MANA	<Potrzebuję\nwięcej many.>	
GAMEPLAY_EMOTE_HERO_02A_ERROR_NEED_WEAPON	<Potrzebuję broni.>	
GAMEPLAY_EMOTE_HERO_02A_ERROR_PLAY	<Nie mogę\ntego zagrać.>	
GAMEPLAY_EMOTE_HERO_02A_ERROR_STEALTH	<Nie mogę\nzaatakować\nUkrytego stronnika!>	
GAMEPLAY_EMOTE_HERO_02A_ERROR_TARGET	<To nie jest\nprawidłowy cel.>	
GAMEPLAY_EMOTE_HERO_02A_ERROR_TAUNT	<Nie mogę\nominąć stronnika\nz Prowokacją.>	
GAMEPLAY_EMOTE_HERO_02A_EVENT_LUNAR_NEW_YEAR	<Pomyślnego\nnowego roku!>	
GAMEPLAY_EMOTE_HERO_02A_FIRE_FESTIVAL	<Tam, skąd pochodzę\nnie obchodzimy\ntego święta.>	
GAMEPLAY_EMOTE_HERO_02A_GREETINGS	<Witaj.>	
GAMEPLAY_EMOTE_HERO_02A_HALLOWS_END	<Upiornych Zaduszników\nkijanki.>	
GAMEPLAY_EMOTE_HERO_02A_LOW_CARDS	<Kończą mi się\nkarty.>	
GAMEPLAY_EMOTE_HERO_02A_MIRROR_START	<Musisz się\njeszcze\nwiele nauczyć.>	
GAMEPLAY_EMOTE_HERO_02A_NO_CARDS	<Nie mam\njuż kart!>	
GAMEPLAY_EMOTE_HERO_02A_NOBLEGARDEN	<Wesołych Miłogrodów!>	
GAMEPLAY_EMOTE_HERO_02A_OOPS	<A niech to!>	
GAMEPLAY_EMOTE_HERO_02A_PIRATE_DAY	<Piraci?! Murloki\nbyły pierwsze!>	
GAMEPLAY_EMOTE_HERO_02A_SORRY	<Wybacz sędziwemu\nwieszczowi.>	
GAMEPLAY_EMOTE_HERO_02A_START	<Pora na lekcję!>	
GAMEPLAY_EMOTE_HERO_02A_THANKS	<Masz moją\nwdzięczność.>	
GAMEPLAY_EMOTE_HERO_02A_THINK1	<A może by tak...>	VO_HERO_15_Thinking1_13.wav
GAMEPLAY_EMOTE_HERO_02A_THINK2	<Ciekawy pomysł...>	
GAMEPLAY_EMOTE_HERO_02A_THINK3	<Hmm, a może...>	
GAMEPLAY_EMOTE_HERO_02A_THREATEN	<Poznaj\nmądrość mórz!>	
GAMEPLAY_EMOTE_HERO_02A_TIMER	<Szybko, szybko!>	
GAMEPLAY_EMOTE_HERO_02A_WELL_PLAYED	<Dobre zagranie.>	
GAMEPLAY_EMOTE_HERO_02A_WINTERVEIL_GREETINGS	<Szczęśliwej\nZimowej Uczty!>	
GAMEPLAY_EMOTE_HERO_02A_WOW	<To niepojęte!>	
GAMEPLAY_EMOTE_HERO_03_CONCEDE	Poddaję się.	
GAMEPLAY_EMOTE_HERO_03_ERROR_FULL_MINIONS	Mam zbyt wielu stronników.	
GAMEPLAY_EMOTE_HERO_03_ERROR_GENERIC	Nie mogę tego zrobić.	
GAMEPLAY_EMOTE_HERO_03_ERROR_HAND_FULL	Już nic mi się do ręki nie zmieści!	
GAMEPLAY_EMOTE_HERO_03_ERROR_I_ATTACKED	Ja już atakowałam.	
GAMEPLAY_EMOTE_HERO_03_ERROR_JUST_PLAYED	Daj temu stronnikowi turę na przygotowanie.	
GAMEPLAY_EMOTE_HERO_03_ERROR_MINION_ATTACKED	Ten stronnik już atakował.	
GAMEPLAY_EMOTE_HERO_03_ERROR_NEED_MANA	Mam za mało many.	
GAMEPLAY_EMOTE_HERO_03_ERROR_NEED_WEAPON	Potrzebna mi broń.	
GAMEPLAY_EMOTE_HERO_03_ERROR_PLAY	Nie mogę tego zagrać.	
GAMEPLAY_EMOTE_HERO_03_ERROR_STEALTH	Nie mogę wybrać ukrytych stronników.	
GAMEPLAY_EMOTE_HERO_03_ERROR_TARGET	To nie jest prawidłowy cel.	
GAMEPLAY_EMOTE_HERO_03_ERROR_TAUNT	Na drodze stoi stronnik z Prowokacją.	
GAMEPLAY_EMOTE_HERO_03_EVENT_LUNAR_NEW_YEAR	Bardzo mi przyjemnie.	
GAMEPLAY_EMOTE_HERO_03_FIRE_FESTIVAL	Wesołego święta Letniego Przesilenia!	
GAMEPLAY_EMOTE_HERO_03_GOOD_GAME	Dobra gra!	
GAMEPLAY_EMOTE_HERO_03_GREETINGS	Cała przyjemność po mojej stronie.	
GAMEPLAY_EMOTE_HERO_03_HALLOWS_END	Szczęśliwych Zaduszników!	
GAMEPLAY_EMOTE_HERO_03_LOW_CARDS	Już prawie nie mam kart!	
GAMEPLAY_EMOTE_HERO_03_MIRROR_START	Wzajemnie, moja droga.	
GAMEPLAY_EMOTE_HERO_03_NO_CARDS	Skończyły mi się karty!	
GAMEPLAY_EMOTE_HERO_03_NOBLEGARDEN	Radosnych Miłogrodów.	
GAMEPLAY_EMOTE_HERO_03_OOPS	Każdemu się zdarza...	
GAMEPLAY_EMOTE_HERO_03_PIRATE_DAY	Arrrrr!	
GAMEPLAY_EMOTE_HERO_03_SORRY	Wybacz mi.	
GAMEPLAY_EMOTE_HERO_03_START	Zachowaj czujność.	
GAMEPLAY_EMOTE_HERO_03_THANKS	Dziękuję.	
GAMEPLAY_EMOTE_HERO_03_THINK1	Hmmm…	
GAMEPLAY_EMOTE_HERO_03_THINK2	Tak sobie myślę...	
GAMEPLAY_EMOTE_HERO_03_THINK3	Tyle możliwości...	
GAMEPLAY_EMOTE_HERO_03_THREATEN	Będę twoją śmiercią!	
GAMEPLAY_EMOTE_HERO_03_TIMER	Muszę zaraz dokonać wyboru...	
GAMEPLAY_EMOTE_HERO_03_WELL_PLAYED	Dobre zagranie.	
GAMEPLAY_EMOTE_HERO_03_WINTERVEIL_GREETINGS	Szczęśliwej Zimowej Uczty.	
GAMEPLAY_EMOTE_HERO_03_WOW	Niesamowite!	
GAMEPLAY_EMOTE_HERO_04_CONCEDE	Zwycięstwo jest twoje.	
GAMEPLAY_EMOTE_HERO_04_ERROR_FULL_MINIONS	Mam zbyt wielu stronników.	
GAMEPLAY_EMOTE_HERO_04_ERROR_GENERIC	Nie mogę tego zrobić.	
GAMEPLAY_EMOTE_HERO_04_ERROR_HAND_FULL	Mam za dużo kart!	
GAMEPLAY_EMOTE_HERO_04_ERROR_I_ATTACKED	Już atakowałem.	
GAMEPLAY_EMOTE_HERO_04_ERROR_JUST_PLAYED	Daj temu stronnikowi turę na przygotowanie.	
GAMEPLAY_EMOTE_HERO_04_ERROR_MINION_ATTACKED	Ten stronnik już atakował.	
GAMEPLAY_EMOTE_HERO_04_ERROR_NEED_MANA	Mam za mało many.	
GAMEPLAY_EMOTE_HERO_04_ERROR_NEED_WEAPON	Potrzebna mi broń.	
GAMEPLAY_EMOTE_HERO_04_ERROR_PLAY	Nie mogę tego zagrać.	
GAMEPLAY_EMOTE_HERO_04_ERROR_STEALTH	Nie mogę wybrać ukrytych stronników.	
GAMEPLAY_EMOTE_HERO_04_ERROR_TARGET	To nie jest prawidłowy cel.	
GAMEPLAY_EMOTE_HERO_04_ERROR_TAUNT	Na drodze stoi stronnik z Prowokacją.	
GAMEPLAY_EMOTE_HERO_04_EVENT_LUNAR_NEW_YEAR	Dobrze cię widzieć!	
GAMEPLAY_EMOTE_HERO_04_FIRE_FESTIVAL	Celebrujemy Festiwal Letniego Przesilenia!	
GAMEPLAY_EMOTE_HERO_04_GOOD_GAME	Dobra gra!	
GAMEPLAY_EMOTE_HERO_04_GREETINGS	Dobrze cię widzieć!	
GAMEPLAY_EMOTE_HERO_04_HALLOWS_END	Szczęśliwych Zaduszników, czempionie!	VO_HERO_04_HAPPY_HALLOWEEN_13.wav
GAMEPLAY_EMOTE_HERO_04_LOW_CARDS	Już prawie nie mam kart!	
GAMEPLAY_EMOTE_HERO_04_MIRROR_START	Będę dowodzić Światłością!	
GAMEPLAY_EMOTE_HERO_04_NO_CARDS	Skończyły mi się karty!	
GAMEPLAY_EMOTE_HERO_04_NOBLEGARDEN	Radosnych Miłogrodów, czempionie!	VO_HERO_04_HAPPY_NOBLEGARDEN_17.wav
GAMEPLAY_EMOTE_HERO_04_OOPS	Każdemu może się zdarzyć.	
GAMEPLAY_EMOTE_HERO_04_PIRATE_DAY	Ahoj, szczury lądowe!	VO_HERO_04_PIRATE_DAY_33.wav
GAMEPLAY_EMOTE_HERO_04_SORRY	Przykro mi.	
GAMEPLAY_EMOTE_HERO_04_START	Będę walczyć z honorem!	
GAMEPLAY_EMOTE_HERO_04_THANKS	Dziękuję.	
GAMEPLAY_EMOTE_HERO_04_THINK1	Hmmm…	
GAMEPLAY_EMOTE_HERO_04_THINK2	Tak sobie myślę...	
GAMEPLAY_EMOTE_HERO_04_THINK3	Pozwól mi się zastanowić...	
GAMEPLAY_EMOTE_HERO_04_THREATEN	Sprawiedliwość żąda pomsty!	
GAMEPLAY_EMOTE_HERO_04_TIMER	Muszę się śpieszyć!	
GAMEPLAY_EMOTE_HERO_04_WELL_PLAYED	Dobre zagranie.	
GAMEPLAY_EMOTE_HERO_04_WINTERVEIL_GREETINGS	Szczęśliwej Zimowej Uczty, czempionie!	
GAMEPLAY_EMOTE_HERO_04_WOW	Na świętą Światłość!	
GAMEPLAY_EMOTE_HERO_04A_CELEBRATE	Oto dzień Światłości!	
GAMEPLAY_EMOTE_HERO_04A_CONCEDE	Wygrywasz. Poddaję się.	
GAMEPLAY_EMOTE_HERO_04A_ERROR_FULL_MINIONS	Mam zbyt wielu stronników.	
GAMEPLAY_EMOTE_HERO_04A_ERROR_GENERIC	Nie mogę tego zrobić.	
GAMEPLAY_EMOTE_HERO_04A_ERROR_HAND_FULL	Mam pełną rękę!	
GAMEPLAY_EMOTE_HERO_04A_ERROR_I_ATTACKED	Już atakowałam.	
GAMEPLAY_EMOTE_HERO_04A_ERROR_JUST_PLAYED	Daj temu stronnikowi turę na przygotowanie.	
GAMEPLAY_EMOTE_HERO_04A_ERROR_MINION_ATTACKED	Ten stronnik już atakował.	
GAMEPLAY_EMOTE_HERO_04A_ERROR_NEED_MANA	Mam za mało many.	
GAMEPLAY_EMOTE_HERO_04A_ERROR_NEED_WEAPON	Potrzebna mi broń.	
GAMEPLAY_EMOTE_HERO_04A_ERROR_PLAY	Nie mogę tego zagrać.	
GAMEPLAY_EMOTE_HERO_04A_ERROR_STEALTH	Nie mogę namierzyć zakamuflowanych stronników.	
GAMEPLAY_EMOTE_HERO_04A_ERROR_TARGET	To nie jest prawidłowy cel.	
GAMEPLAY_EMOTE_HERO_04A_ERROR_TAUNT	Muszę zaatakować stronnika z Prowokacją.	
GAMEPLAY_EMOTE_HERO_04A_FIRE_FESTIVAL	Świętujmy Festiwal Ognia!	
GAMEPLAY_EMOTE_HERO_04A_GOOD_GAME	Dobra gra!	
GAMEPLAY_EMOTE_HERO_04A_GREETINGS	Ach, witaj!	
GAMEPLAY_EMOTE_HERO_04A_HALLOWS_END	Szczęśliwych Zaduszników!	
GAMEPLAY_EMOTE_HERO_04A_LOW_CARDS	Już prawie nie mam kart!	
GAMEPLAY_EMOTE_HERO_04A_LUNAR_NEW_YEAR	Witaj, pretendencie.	
GAMEPLAY_EMOTE_HERO_04A_MIRROR_START	Święty ogień to ja zjadam na śniadanie.	
GAMEPLAY_EMOTE_HERO_04A_NO_CARDS	Skończyły mi się karty!	
GAMEPLAY_EMOTE_HERO_04A_NOBLEGARDEN	Wesołych Miłogrodów.	
GAMEPLAY_EMOTE_HERO_04A_OOPS	To bez wątpienia błąd.	
GAMEPLAY_EMOTE_HERO_04A_PIRATE_DAY	Arrrrrr, zabieram twój skarb!	
GAMEPLAY_EMOTE_HERO_04A_SORRY	Och, wybacz.	
GAMEPLAY_EMOTE_HERO_04A_START	Moje ostrze płonie świętym ogniem!	
GAMEPLAY_EMOTE_HERO_04A_THANKS	Najszczersze podziękowania.	
GAMEPLAY_EMOTE_HERO_04A_THINK1	Hmm...	
GAMEPLAY_EMOTE_HERO_04A_THINK2	Tyle możliwości…	
GAMEPLAY_EMOTE_HERO_04A_THINK3	A może zrobić tak...	
GAMEPLAY_EMOTE_HERO_04A_THREATEN	Zapłacisz za to, kundlu!	
GAMEPLAY_EMOTE_HERO_04A_TIMER	Ruszajmy!	
GAMEPLAY_EMOTE_HERO_04A_WELL_PLAYED	Dobre zagranie.	
GAMEPLAY_EMOTE_HERO_04A_WINTERVEIL_GREETINGS	Szczęśliwej Zimowej Uczty!	
GAMEPLAY_EMOTE_HERO_04A_WOW	To niesamowite.	
GAMEPLAY_EMOTE_HERO_05_CONCEDE	Dobra walka, muszę ustąpić.	
GAMEPLAY_EMOTE_HERO_05_ERROR_FULL_MINIONS	Mam zbyt wielu stronników.	
GAMEPLAY_EMOTE_HERO_05_ERROR_GENERIC	Nie mogę tego zrobić.	
GAMEPLAY_EMOTE_HERO_05_ERROR_HAND_FULL	Mam za dużo kart!	
GAMEPLAY_EMOTE_HERO_05_ERROR_I_ATTACKED	Ja już atakowałem.	
GAMEPLAY_EMOTE_HERO_05_ERROR_JUST_PLAYED	Daj temu stronnikowi turę na przygotowanie.	
GAMEPLAY_EMOTE_HERO_05_ERROR_MINION_ATTACKED	Ten stronnik już atakował.	
GAMEPLAY_EMOTE_HERO_05_ERROR_NEED_MANA	Mam za mało many.	
GAMEPLAY_EMOTE_HERO_05_ERROR_NEED_WEAPON	Potrzebna mi broń.	
GAMEPLAY_EMOTE_HERO_05_ERROR_PLAY	Nie mogę tego zagrać.	
GAMEPLAY_EMOTE_HERO_05_ERROR_STEALTH	Nie mogę namierzyć ukrytych stronników.	
GAMEPLAY_EMOTE_HERO_05_ERROR_TARGET	To nie jest prawidłowy cel.	
GAMEPLAY_EMOTE_HERO_05_ERROR_TAUNT	Na drodze stoi stronnik z Prowokacją.	
GAMEPLAY_EMOTE_HERO_05_EVENT_LUNAR_NEW_YEAR	Witaj, podróżniku...	
GAMEPLAY_EMOTE_HERO_05_FIRE_FESTIVAL	Wesołego święta Letniego Przesilenia!	
GAMEPLAY_EMOTE_HERO_05_GOOD_GAME	Dobra gra!	
GAMEPLAY_EMOTE_HERO_05_GREETINGS	Witaj, podróżniku...	
GAMEPLAY_EMOTE_HERO_05_HALLOWS_END	Szczęśliwych Zaduszników!	
GAMEPLAY_EMOTE_HERO_05_LOW_CARDS	Już prawie nie mam kart!	
GAMEPLAY_EMOTE_HERO_05_MIRROR_START	Pokaż, co potrafisz!	
GAMEPLAY_EMOTE_HERO_05_NO_CARDS	Skończyły mi się karty!	
GAMEPLAY_EMOTE_HERO_05_NOBLEGARDEN	Radosnych Miłogrodów!	
GAMEPLAY_EMOTE_HERO_05_OOPS	Coś chyba poszło nie tak.	
GAMEPLAY_EMOTE_HERO_05_PIRATE_DAY	Arrrr, zdrrrowie wilków morskich!	
GAMEPLAY_EMOTE_HERO_05_SORRY	Przepraszam.	
GAMEPLAY_EMOTE_HERO_05_START	Niech rozpoczną się łowy!	
GAMEPLAY_EMOTE_HERO_05_THANKS	Dziękuję.	
GAMEPLAY_EMOTE_HERO_05_THINK1	Hmmm…	
GAMEPLAY_EMOTE_HERO_05_THINK2	Tak sobie myślę...	
GAMEPLAY_EMOTE_HERO_05_THINK3	Hrmmmmm...	
GAMEPLAY_EMOTE_HERO_05_THREATEN	Nie uciekniesz przede mną!	
GAMEPLAY_EMOTE_HERO_05_TIMER	Czas ucieka!	
GAMEPLAY_EMOTE_HERO_05_WELL_PLAYED	Dobre zagranie.	
GAMEPLAY_EMOTE_HERO_05_WINTERVEIL_GREETINGS	Szczęśliwej Zimowej Uczty!	
GAMEPLAY_EMOTE_HERO_05_WOW	Zadziwiające!	
GAMEPLAY_EMOTE_HERO_05A_CELEBRATE	Hahaha! Tak! Tak!	
GAMEPLAY_EMOTE_HERO_05A_CONCEDE	Mistrzowskie zagranie. Poddaję partię.	
GAMEPLAY_EMOTE_HERO_05A_ERROR_FULL_MINIONS	Mam zbyt wielu stronników.	
GAMEPLAY_EMOTE_HERO_05A_ERROR_GENERIC	Nie mogę tego zrobić.	
GAMEPLAY_EMOTE_HERO_05A_ERROR_HAND_FULL	Mam pełną rękę!	
GAMEPLAY_EMOTE_HERO_05A_ERROR_I_ATTACKED	Już atakowałam.	
GAMEPLAY_EMOTE_HERO_05A_ERROR_JUST_PLAYED	Daj temu stronnikowi turę na przygotowanie.	
GAMEPLAY_EMOTE_HERO_05A_ERROR_MINION_ATTACKED	Ten stronnik już atakował.	
GAMEPLAY_EMOTE_HERO_05A_ERROR_NEED_MANA	Mam za mało many.	
GAMEPLAY_EMOTE_HERO_05A_ERROR_NEED_WEAPON	Potrzebna mi broń.	
GAMEPLAY_EMOTE_HERO_05A_ERROR_PLAY	Nie mogę tego zagrać.	
GAMEPLAY_EMOTE_HERO_05A_ERROR_STEALTH	Nie mogę namierzyć zakamuflowanych stronników.	
GAMEPLAY_EMOTE_HERO_05A_ERROR_TARGET	To nie jest prawidłowy cel.	
GAMEPLAY_EMOTE_HERO_05A_ERROR_TAUNT	Muszę zaatakować stronnika z Prowokacją.	
GAMEPLAY_EMOTE_HERO_05A_EVENT_FIRE_FESTIVAL	Rozpoczyna się Festiwal Ognia.	
GAMEPLAY_EMOTE_HERO_05A_EVENT_HALLOWS_END	Szczęśliwych Zaduszników!	
GAMEPLAY_EMOTE_HERO_05A_EVENT_LUNAR_NEW_YEAR	Witaj wędrowcze.	
GAMEPLAY_EMOTE_HERO_05A_EVENT_NOBLEGARDEN	Wesołych Miłogrodów.	
GAMEPLAY_EMOTE_HERO_05A_EVENT_PIRATE_DAY	Arrrrr! Poślę cię na dno!	
GAMEPLAY_EMOTE_HERO_05A_GOOD_GAME	Dobra gra!	
GAMEPLAY_EMOTE_HERO_05A_GREETINGS	Witaj wędrowcze.	
GAMEPLAY_EMOTE_HERO_05A_LOW_CARDS	Już prawie nie mam kart!	
GAMEPLAY_EMOTE_HERO_05A_MIRROR_START	Ja nigdy nie drżę.	
GAMEPLAY_EMOTE_HERO_05A_NO_CARDS	Skończyły mi się karty!	
GAMEPLAY_EMOTE_HERO_05A_OOPS	Hmm. Błąd.	
GAMEPLAY_EMOTE_HERO_05A_SORRY	Przykro mi.	
GAMEPLAY_EMOTE_HERO_05A_START	Drżyj przed potęgą elfów.	
GAMEPLAY_EMOTE_HERO_05A_THANKS	Dziękuję.	
GAMEPLAY_EMOTE_HERO_05A_THINK1	Hmm...	
GAMEPLAY_EMOTE_HERO_05A_THINK2	Do kogo by tu strzelić?	
GAMEPLAY_EMOTE_HERO_05A_THINK3	Co tu robić…	
GAMEPLAY_EMOTE_HERO_05A_THREATEN	Moja zemsta będzie nagła!	
GAMEPLAY_EMOTE_HERO_05A_TIMER	Ruszże się w końcu!	
GAMEPLAY_EMOTE_HERO_05A_WELL_PLAYED	Dobre zagranie.	
GAMEPLAY_EMOTE_HERO_05A_WINTERVEIL_GREETING	Szczęśliwej Zimowej Uczty.	
GAMEPLAY_EMOTE_HERO_05A_WOW	To niesamowite!	
GAMEPLAY_EMOTE_HERO_06_CONCEDE	Poddaję tę walkę.	
GAMEPLAY_EMOTE_HERO_06_ERROR_FULL_MINIONS	Mam zbyt wielu stronników.	
GAMEPLAY_EMOTE_HERO_06_ERROR_GENERIC	Nie mogę tego zrobić.	
GAMEPLAY_EMOTE_HERO_06_ERROR_HAND_FULL	Mam za dużo kart!	
GAMEPLAY_EMOTE_HERO_06_ERROR_I_ATTACKED	Już atakowałem.	
GAMEPLAY_EMOTE_HERO_06_ERROR_JUST_PLAYED	Daj temu stronnikowi turę na przygotowanie.	
GAMEPLAY_EMOTE_HERO_06_ERROR_MINION_ATTACKED	Ten stronnik już atakował.	
GAMEPLAY_EMOTE_HERO_06_ERROR_NEED_MANA	Mam za mało many.	
GAMEPLAY_EMOTE_HERO_06_ERROR_NEED_WEAPON	Potrzebna mi broń.	
GAMEPLAY_EMOTE_HERO_06_ERROR_PLAY	Nie mogę tego zagrać.	
GAMEPLAY_EMOTE_HERO_06_ERROR_STEALTH	Nie mogę wybrać ukrytych stronników.	
GAMEPLAY_EMOTE_HERO_06_ERROR_TARGET	To nie jest prawidłowy cel.	
GAMEPLAY_EMOTE_HERO_06_ERROR_TAUNT	Na drodze stoi stronnik z Prowokacją.	
GAMEPLAY_EMOTE_HERO_06_EVENT_LUNAR_NEW_YEAR	Pozdrawiam cię.	
GAMEPLAY_EMOTE_HERO_06_FIRE_FESTIVAL	Wesołego święta Letniego Przesilenia!	
GAMEPLAY_EMOTE_HERO_06_GOOD_GAME	Dobra gra!	
GAMEPLAY_EMOTE_HERO_06_GREETINGS	Pozdrawiam cię.	
GAMEPLAY_EMOTE_HERO_06_HALLOWS_END	Szczęśliwych Zaduszników!	
GAMEPLAY_EMOTE_HERO_06_LOW_CARDS	Już prawie nie mam kart!	
GAMEPLAY_EMOTE_HERO_06_MIRROR_START	Chrońmy naturę!	
GAMEPLAY_EMOTE_HERO_06_NO_CARDS	Skończyły mi się karty!	
GAMEPLAY_EMOTE_HERO_06_NOBLEGARDEN	Radosnych Miłogrodów!	
GAMEPLAY_EMOTE_HERO_06_OOPS	To błąd, naturalnie...	
GAMEPLAY_EMOTE_HERO_06_PIRATE_DAY	Arrrrrr!	
GAMEPLAY_EMOTE_HERO_06_SORRY	Wybacz mi.	
GAMEPLAY_EMOTE_HERO_06_START	Muszę chronić dzikie ostępy!	
GAMEPLAY_EMOTE_HERO_06_START_TYRANDE	Moja kochana Tyrande!	
GAMEPLAY_EMOTE_HERO_06_THANKS	Składam ci podziękowania.	
GAMEPLAY_EMOTE_HERO_06_THINK1	Hmmm…	
GAMEPLAY_EMOTE_HERO_06_THINK2	Hmmm... Zastanawiam się...	
GAMEPLAY_EMOTE_HERO_06_THINK3	Co tu zrobić...	
GAMEPLAY_EMOTE_HERO_06_THREATEN	Natura powstanie przeciw tobie!	
GAMEPLAY_EMOTE_HERO_06_TIMER	Czas na nikogo nie czeka...	
GAMEPLAY_EMOTE_HERO_06_WELL_PLAYED	Dobre zagranie.	
GAMEPLAY_EMOTE_HERO_06_WINTERVEIL_GREETINGS	Szczęśliwej Zimowej Uczty.	
GAMEPLAY_EMOTE_HERO_06_WOW	Spektakularne!	
GAMEPLAY_EMOTE_HERO_07_CONCEDE	Tym razem wygrywasz...	
GAMEPLAY_EMOTE_HERO_07_ERROR_FULL_MINIONS	Mam zbyt wielu stronników.	
GAMEPLAY_EMOTE_HERO_07_ERROR_GENERIC	Nie mogę tego zrobić.	
GAMEPLAY_EMOTE_HERO_07_ERROR_HAND_FULL	Mam za dużo kart!	
GAMEPLAY_EMOTE_HERO_07_ERROR_I_ATTACKED	Już atakowałem.	
GAMEPLAY_EMOTE_HERO_07_ERROR_JUST_PLAYED	Daj temu stronnikowi turę na przygotowanie.	
GAMEPLAY_EMOTE_HERO_07_ERROR_MINION_ATTACKED	Ten stronnik już atakował.	
GAMEPLAY_EMOTE_HERO_07_ERROR_NEED_MANA	Mam za mało many.	
GAMEPLAY_EMOTE_HERO_07_ERROR_NEED_WEAPON	Potrzebna mi broń.	
GAMEPLAY_EMOTE_HERO_07_ERROR_PLAY	Nie mogę tego zagrać.	
GAMEPLAY_EMOTE_HERO_07_ERROR_STEALTH	Nie mogę wybrać ukrytych stronników.	
GAMEPLAY_EMOTE_HERO_07_ERROR_TARGET	To nie jest prawidłowy cel.	
GAMEPLAY_EMOTE_HERO_07_ERROR_TAUNT	Na drodze stoi stronnik z Prowokacją.	
GAMEPLAY_EMOTE_HERO_07_EVENT_LUNAR_NEW_YEAR	Pozdrawiam cię.	
GAMEPLAY_EMOTE_HERO_07_FIRE_FESTIVAL	Rozpalić ognie!	
GAMEPLAY_EMOTE_HERO_07_GOOD_GAME	Dobre zagranie!	
GAMEPLAY_EMOTE_HERO_07_GREETINGS	Pozdrawiam cię.	
GAMEPLAY_EMOTE_HERO_07_HALLOWS_END	Szalonych Zaduszników.	
GAMEPLAY_EMOTE_HERO_07_LOW_CARDS	Już prawie nie mam kart!	
GAMEPLAY_EMOTE_HERO_07_MIRROR_START	Jestem twoim koszmarem!	
GAMEPLAY_EMOTE_HERO_07_NO_CARDS	Skończyły mi się karty!	
GAMEPLAY_EMOTE_HERO_07_NOBLEGARDEN	Radosnych Miłogrodów.	
GAMEPLAY_EMOTE_HERO_07_OOPS	To był błąd.	
GAMEPLAY_EMOTE_HERO_07_PIRATE_DAY	Święto piratów? Nie rozumiem...	
GAMEPLAY_EMOTE_HERO_07_SORRY	Wybacz.	
GAMEPLAY_EMOTE_HERO_07_START	Twoja dusza będzie moja!	
GAMEPLAY_EMOTE_HERO_07_THANKS	Dziękuję.	
GAMEPLAY_EMOTE_HERO_07_THINK1	Hmmm…	
GAMEPLAY_EMOTE_HERO_07_THINK2	Tak sobie myślę...	
GAMEPLAY_EMOTE_HERO_07_THINK3	Tyle możliwości...	
GAMEPLAY_EMOTE_HERO_07_THREATEN	Twoja dusza będzie cierpieć!	
GAMEPLAY_EMOTE_HERO_07_TIMER	Kończy mi się czas!	
GAMEPLAY_EMOTE_HERO_07_WELL_PLAYED	Dobre zagranie.	
GAMEPLAY_EMOTE_HERO_07_WINTERVEIL_GREETINGS	Szczęśliwej Zimowej Uczty...	
GAMEPLAY_EMOTE_HERO_07_WOW	Niesłychane!	
GAMEPLAY_EMOTE_HERO_08_CONCEDE	Tym razem ci się udało...	
GAMEPLAY_EMOTE_HERO_08_ERROR_FULL_MINIONS	Mam zbyt wielu stronników.	
GAMEPLAY_EMOTE_HERO_08_ERROR_GENERIC	Nie mogę tego zrobić.	
GAMEPLAY_EMOTE_HERO_08_ERROR_HAND_FULL	Mam za dużo kart!	
GAMEPLAY_EMOTE_HERO_08_ERROR_I_ATTACKED	Ja już atakowałam.	
GAMEPLAY_EMOTE_HERO_08_ERROR_JUST_PLAYED	Daj temu stronnikowi turę na przygotowanie.	
GAMEPLAY_EMOTE_HERO_08_ERROR_MINION_ATTACKED	Ten stronnik już atakował.	
GAMEPLAY_EMOTE_HERO_08_ERROR_NEED_MANA	Mam za mało many.	
GAMEPLAY_EMOTE_HERO_08_ERROR_NEED_WEAPON	Potrzebna mi broń.	
GAMEPLAY_EMOTE_HERO_08_ERROR_PLAY	Nie mogę tego zagrać.	
GAMEPLAY_EMOTE_HERO_08_ERROR_STEALTH	Nie mogę namierzyć ukrytych stronników.	
GAMEPLAY_EMOTE_HERO_08_ERROR_TARGET	To nie jest prawidłowy cel.	
GAMEPLAY_EMOTE_HERO_08_ERROR_TAUNT	Na drodze stoi stronnik z Prowokacją.	
GAMEPLAY_EMOTE_HERO_08_EVENT_LUNAR_NEW_YEAR	Witaj.	
GAMEPLAY_EMOTE_HERO_08_FIRE_FESTIVAL	Celebrujmy Festiwal Letniego Przesilenia!	
GAMEPLAY_EMOTE_HERO_08_GOOD_GAME	Dobre zagranie!	
GAMEPLAY_EMOTE_HERO_08_GREETINGS	Witaj.	
GAMEPLAY_EMOTE_HERO_08_HALLOWS_END	Szczęśliwych Zaduszników!	
GAMEPLAY_EMOTE_HERO_08_LOW_CARDS	Już prawie nie mam kart!	
GAMEPLAY_EMOTE_HERO_08_MIRROR_START	O, już się zaczęło.	
GAMEPLAY_EMOTE_HERO_08_NO_CARDS	Skończyły mi się karty!	
GAMEPLAY_EMOTE_HERO_08_NOBLEGARDEN	Radosnych Miłogrodów.	
GAMEPLAY_EMOTE_HERO_08_OOPS	Oj…	
GAMEPLAY_EMOTE_HERO_08_PIRATE_DAY	Arrrr! Ahoj!	
GAMEPLAY_EMOTE_HERO_08_SORRY	Wybacz.	
GAMEPLAY_EMOTE_HERO_08_START	Prosisz się o lanie.	
GAMEPLAY_EMOTE_HERO_08_THANKS	Dziękuję.	
GAMEPLAY_EMOTE_HERO_08_THINK1	Hmmm…	
GAMEPLAY_EMOTE_HERO_08_THINK2	Tak sobie myślę...	
GAMEPLAY_EMOTE_HERO_08_THINK3	Co tu robić, co tu robić...	
GAMEPLAY_EMOTE_HERO_08_THREATEN	Moja magia rozerwie cię na strzępy!	
GAMEPLAY_EMOTE_HERO_08_TIMER	Kończy mi się czas...	
GAMEPLAY_EMOTE_HERO_08_WELL_PLAYED	Dobre zagranie.	
GAMEPLAY_EMOTE_HERO_08_WINTERVEIL_GREETINGS	Szczęśliwej Zimowej Uczty!	
GAMEPLAY_EMOTE_HERO_08_WOW	Niesamowite.	
GAMEPLAY_EMOTE_HERO_08A_CELEBRATE	Tak, tak! Hahahaha!	
GAMEPLAY_EMOTE_HERO_08A_CONCEDE	No i mat! Gratuluję.	
GAMEPLAY_EMOTE_HERO_08A_ERROR_FULL_MINIONS	Mam zbyt wielu stronników.	
GAMEPLAY_EMOTE_HERO_08A_ERROR_GENERIC	Nie mogę tego zrobić.	
GAMEPLAY_EMOTE_HERO_08A_ERROR_HAND_FULL	Mam pełną rękę!	
GAMEPLAY_EMOTE_HERO_08A_ERROR_I_ATTACKED	Już atakowałem.	
GAMEPLAY_EMOTE_HERO_08A_ERROR_JUST_PLAYED	Daj temu stronnikowi turę na przygotowanie.	
GAMEPLAY_EMOTE_HERO_08A_ERROR_MINION_ATTACKED	Ten stronnik już atakował.	
GAMEPLAY_EMOTE_HERO_08A_ERROR_NEED_MANA	Mam za mało many.	
GAMEPLAY_EMOTE_HERO_08A_ERROR_NEED_WEAPON	Potrzebuję broni.	
GAMEPLAY_EMOTE_HERO_08A_ERROR_PLAY	Nie mogę tego zagrać.	
GAMEPLAY_EMOTE_HERO_08A_ERROR_STEALTH	Nie mogę namierzyć ukrytych stronników.	
GAMEPLAY_EMOTE_HERO_08A_ERROR_TARGET	To nie jest prawidłowy cel.	
GAMEPLAY_EMOTE_HERO_08A_ERROR_TAUNT	Muszę zaatakować stronnika z Prowokacją.	
GAMEPLAY_EMOTE_HERO_08A_FIRE_FESTIVAL	Zaczyna się Festiwal Letniego Przesilenia!	
GAMEPLAY_EMOTE_HERO_08A_GOOD_GAME	Dobra gra!	
GAMEPLAY_EMOTE_HERO_08A_GREETINGS	Ach, witaj.	
GAMEPLAY_EMOTE_HERO_08A_HALLOWS_END	Szczęśliwych Zaduszników!	
GAMEPLAY_EMOTE_HERO_08A_LOW_CARDS	Już prawie nie mam kart!	
GAMEPLAY_EMOTE_HERO_08A_LUNAR_NEW_YEAR	Ach, witaj.	
GAMEPLAY_EMOTE_HERO_08A_MIRROR_START	Już się rozpoczęła.	
GAMEPLAY_EMOTE_HERO_08A_NO_CARDS	Skończyły mi się karty!	
GAMEPLAY_EMOTE_HERO_08A_NOBLEGARDEN	Wesołych Miłogrodów!	
GAMEPLAY_EMOTE_HERO_08A_OOPS	Nieprzemyślany ruch.	
GAMEPLAY_EMOTE_HERO_08A_PIRATE_DAY	Jestem strrrrrrrrrażnik Medivh!	
GAMEPLAY_EMOTE_HERO_08A_SORRY	Moje najszczersze przeprosiny.	
GAMEPLAY_EMOTE_HERO_08A_START	Niech rozpocznie się gra!	
GAMEPLAY_EMOTE_HERO_08A_THANKS	Doceniam to.	
GAMEPLAY_EMOTE_HERO_08A_THINK1	Hmm...	
GAMEPLAY_EMOTE_HERO_08A_THINK2	Ciekawe...	
GAMEPLAY_EMOTE_HERO_08A_THINK3	A może tak...	
GAMEPLAY_EMOTE_HERO_08A_THREATEN	Nic mnie nie powstrzyma! Nic!	
GAMEPLAY_EMOTE_HERO_08A_TIMER	Nie mogę spocząć na laurach.	
GAMEPLAY_EMOTE_HERO_08A_WELL_PLAYED	Dobre zagranie.	
GAMEPLAY_EMOTE_HERO_08A_WINTERVEIL_GREETINGS	Szczęśliwej Zimowej Uczty.	
GAMEPLAY_EMOTE_HERO_08A_WOW	To niesamowite!	
GAMEPLAY_EMOTE_HERO_08B_CONCEDE	Dobra robota. Wygrywasz.	
GAMEPLAY_EMOTE_HERO_08B_ERROR_FULL_MINIONS	Mam zbyt wielu stronników.	
GAMEPLAY_EMOTE_HERO_08B_ERROR_GENERIC	Nie mogę tego zrobić.	
GAMEPLAY_EMOTE_HERO_08B_ERROR_HAND_FULL	Mam pełną rękę!	
GAMEPLAY_EMOTE_HERO_08B_ERROR_I_ATTACKED	Już atakowałem.	
GAMEPLAY_EMOTE_HERO_08B_ERROR_JUST_PLAYED	Daj temu stronnikowi turę na przygotowanie.	
GAMEPLAY_EMOTE_HERO_08B_ERROR_MINION_ATTACKED	Ten stronnik już atakował.	
GAMEPLAY_EMOTE_HERO_08B_ERROR_NEED_MANA	Mam za mało many.	
GAMEPLAY_EMOTE_HERO_08B_ERROR_NEED_WEAPON	Potrzebuję broni.	
GAMEPLAY_EMOTE_HERO_08B_ERROR_PLAY	Nie mogę tego zagrać.	
GAMEPLAY_EMOTE_HERO_08B_ERROR_STEALTH	Nie mogę wybrać ukrytych stronników.	
GAMEPLAY_EMOTE_HERO_08B_ERROR_TARGET	To nie jest prawidłowy cel.	
GAMEPLAY_EMOTE_HERO_08B_ERROR_TAUNT	Na drodze stoi stronnik z Prowokacją.	
GAMEPLAY_EMOTE_HERO_08B_FIRE_FESTIVAL	Świętujemy Festiwal Letniego Przesilenia!	
GAMEPLAY_EMOTE_HERO_08B_GOOD_GAME	No proszę. To była dobra rozgrywka!	
GAMEPLAY_EMOTE_HERO_08B_GREETINGS	Witaj, bratnia duszo poszukująca prawdy.	
GAMEPLAY_EMOTE_HERO_08B_HALLOWS_END	Szczęśliwych Zaduszników!	
GAMEPLAY_EMOTE_HERO_08B_LOW_CARDS	Już prawie nie mam kart!	
GAMEPLAY_EMOTE_HERO_08B_LUNAR_NEW_YEAR	Witaj, bratnia duszo poszukująca prawdy.	
GAMEPLAY_EMOTE_HERO_08B_MIRROR_START	Obyśmy razem wiele się nauczyli.	
GAMEPLAY_EMOTE_HERO_08B_NO_CARDS	Skończyły mi się karty!	
GAMEPLAY_EMOTE_HERO_08B_NOBLEGARDEN	Radosnych Miłogrodów!	
GAMEPLAY_EMOTE_HERO_08B_OOPS	Oj. Pomyłka.	
GAMEPLAY_EMOTE_HERO_08B_PIRATE_DAY	Dziś świętujemy... dzień morskich złoczyńców?	
GAMEPLAY_EMOTE_HERO_08B_SORRY	No cóż. Wybacz.	
GAMEPLAY_EMOTE_HERO_08B_START	Wiedza to potęga.	
GAMEPLAY_EMOTE_HERO_08B_THANKS	Dziękuję.	
GAMEPLAY_EMOTE_HERO_08B_THINK1	Hmm...	
GAMEPLAY_EMOTE_HERO_08B_THINK2	Obserwuj i analizuj...	
GAMEPLAY_EMOTE_HERO_08B_THINK3	Musi być jakiś sposób...	
GAMEPLAY_EMOTE_HERO_08B_THREATEN	Czas na naukę.	
GAMEPLAY_EMOTE_HERO_08B_TIMER	Czas ucieka!	
GAMEPLAY_EMOTE_HERO_08B_WELL_PLAYED	Niezłe zagranie.	
GAMEPLAY_EMOTE_HERO_08B_WINTERVEIL_GREETINGS	Szczęśliwej Zimowej Uczty!	
GAMEPLAY_EMOTE_HERO_08B_WOW	Cudownie!	
GAMEPLAY_EMOTE_HERO_09_CONCEDE	Zostałem pokonany.	
GAMEPLAY_EMOTE_HERO_09_ERROR_FULL_MINIONS	Mam zbyt wielu stronników.	
GAMEPLAY_EMOTE_HERO_09_ERROR_GENERIC	Nie mogę tego zrobić.	
GAMEPLAY_EMOTE_HERO_09_ERROR_HAND_FULL	Mam za dużo kart!	
GAMEPLAY_EMOTE_HERO_09_ERROR_I_ATTACKED	Już atakowałem.	
GAMEPLAY_EMOTE_HERO_09_ERROR_JUST_PLAYED	Daj temu stronnikowi turę na przygotowanie.	
GAMEPLAY_EMOTE_HERO_09_ERROR_MINION_ATTACKED	Ten stronnik już atakował.	
GAMEPLAY_EMOTE_HERO_09_ERROR_NEED_MANA	Mam za mało many.	
GAMEPLAY_EMOTE_HERO_09_ERROR_NEED_WEAPON	Potrzebna mi broń.	
GAMEPLAY_EMOTE_HERO_09_ERROR_PLAY	Nie mogę tego zagrać.	
GAMEPLAY_EMOTE_HERO_09_ERROR_STEALTH	Nie mogę namierzyć ukrytych stronników.	
GAMEPLAY_EMOTE_HERO_09_ERROR_TARGET	To nie jest prawidłowy cel.	
GAMEPLAY_EMOTE_HERO_09_ERROR_TAUNT	Na drodze stoi stronnik z Prowokacją.	
GAMEPLAY_EMOTE_HERO_09_EVENT_LUNAR_NEW_YEAR	Witaj!	
GAMEPLAY_EMOTE_HERO_09_FIRE_FESTIVAL	Nie mogę się doczekać fajerwerków!	
GAMEPLAY_EMOTE_HERO_09_GOOD_GAME	Dobra gra!	
GAMEPLAY_EMOTE_HERO_09_GREETINGS	Witaj!	
GAMEPLAY_EMOTE_HERO_09_GREETINGS_DISABLED	Mmmhh!	
GAMEPLAY_EMOTE_HERO_09_HALLOWS_END	Szczęśliwych Zaduszników!	
GAMEPLAY_EMOTE_HERO_09_LOW_CARDS	Już prawie nie mam kart!	
GAMEPLAY_EMOTE_HERO_09_MIRROR_START	Światłość ceni sprawiedliwych!	
GAMEPLAY_EMOTE_HERO_09_NO_CARDS	Skończyły mi się karty!	
GAMEPLAY_EMOTE_HERO_09_NOBLEGARDEN	Radosnych Miłogrodów!	
GAMEPLAY_EMOTE_HERO_09_OOPS	Tego raczej nie planowałem...	
GAMEPLAY_EMOTE_HERO_09_OOPS_DISABLED	Mmmhh?	
GAMEPLAY_EMOTE_HERO_09_PIRATE_DAY	Arrr! Świętujmy dzień piratów!	
GAMEPLAY_EMOTE_HERO_09_SORRY	Przepraszam.	
GAMEPLAY_EMOTE_HERO_09_START	Światłość zapewni nam zwycięstwo!	
GAMEPLAY_EMOTE_HERO_09_THANKS	Dziękuję.	
GAMEPLAY_EMOTE_HERO_09_THANKS_DISABLED	Mmmhh.	
GAMEPLAY_EMOTE_HERO_09_THINK1	Hmmm…	
GAMEPLAY_EMOTE_HERO_09_THINK2	Tak sobie myślę...	
GAMEPLAY_EMOTE_HERO_09_THINK3	Muszę to rozważyć...	
GAMEPLAY_EMOTE_HERO_09_THREATEN	Spali cię światłość!	
GAMEPLAY_EMOTE_HERO_09_THREATEN_DISABLED	Mmmmhhhhhh!	
GAMEPLAY_EMOTE_HERO_09_TIMER	Muszę szybko dokonać wyboru!	
GAMEPLAY_EMOTE_HERO_09_WELL_PLAYED	Dobre zagranie!	
GAMEPLAY_EMOTE_HERO_09_WELL_PLAYED_DISABLED	Mmmhh…	
GAMEPLAY_EMOTE_HERO_09_WINTERVEIL_GREETINGS	Szczęśliwej Zimowej Uczty!	
GAMEPLAY_EMOTE_HERO_09_WOW	Super!	
GAMEPLAY_EMOTE_HERO_09_WOW_DISABLED	Mmmmhhhhhh…!!	
GAMEPLAY_EMOTE_HERO_TBKTRAF_KT_CONCEDE	Jeszcze... powrócę...	
GAMEPLAY_EMOTE_HERO_TBKTRAF_KT_GREETINGS	W końcu się spotykamy!	
GAMEPLAY_EMOTE_HERO_TBKTRAF_KT_LOW_CARDS	Kończą mi się karty!	
GAMEPLAY_EMOTE_HERO_TBKTRAF_KT_NO_CARDS	Nie! Przeklinam cię, intruzie!	
GAMEPLAY_EMOTE_HERO_TBKTRAF_KT_OOPS	No i cały misterny plan…	
GAMEPLAY_EMOTE_HERO_TBKTRAF_KT_SORRY	Wszyscy popełniamy błędy.	
GAMEPLAY_EMOTE_HERO_TBKTRAF_KT_START	Zmierz się ze mną, natręcie!	
GAMEPLAY_EMOTE_HERO_TBKTRAF_KT_THANKS	Nie ma za co.	
GAMEPLAY_EMOTE_HERO_TBKTRAF_KT_THINK1	Być może.	
GAMEPLAY_EMOTE_HERO_TBKTRAF_KT_THINK2	Tak... Tak!	
GAMEPLAY_EMOTE_HERO_TBKTRAF_KT_THINK3	Co ty na to, Sierściuchu?	
GAMEPLAY_EMOTE_HERO_TBKTRAF_KT_THREATEN	Zamrożę ci krew w żyłach!	
GAMEPLAY_EMOTE_HERO_TBKTRAF_KT_WELL_PLAYED	To było niezłe zagranie.	
GAMEPLAY_EMOTE_HERO_TBKTRAF_RAF_CONCEDE	NIE! NIE MOŻNA MNIE POKONAĆ!	
GAMEPLAY_EMOTE_HERO_TBKTRAF_RAF_GREETINGS	Witaj, odkrywco.	
GAMEPLAY_EMOTE_HERO_TBKTRAF_RAF_LOW_CARDS	Kończą mi się karty!	
GAMEPLAY_EMOTE_HERO_TBKTRAF_RAF_NO_CARDS	Moje piękne skarby!	
GAMEPLAY_EMOTE_HERO_TBKTRAF_RAF_OOPS	Porażka!	
GAMEPLAY_EMOTE_HERO_TBKTRAF_RAF_SORRY	Żal mi ciebie.	
GAMEPLAY_EMOTE_HERO_TBKTRAF_RAF_START	RAFAAM, NAJLEPSZY Z ARCHEOLOGÓW!	
GAMEPLAY_EMOTE_HERO_TBKTRAF_RAF_THANKS	A! Dziękuję.	
GAMEPLAY_EMOTE_HERO_TBKTRAF_RAF_THINK1	Hmmm…	
GAMEPLAY_EMOTE_HERO_TBKTRAF_RAF_THINK2	Co tu zabrać...	
GAMEPLAY_EMOTE_HERO_TBKTRAF_RAF_THINK3	Kuszące...	
GAMEPLAY_EMOTE_HERO_TBKTRAF_RAF_THREATEN	WSZECHOGARNIAJĄCA MOC!	
GAMEPLAY_EMOTE_HERO_TBKTRAF_RAF_WELL_PLAYED	Dobra robota...	
GAMEPLAY_EMOTE_HERO_TBMECHWAR01_CONCEDE	<Poddaję się.>	The text is in brackets because the VO files is just Annoy-o-Tron's greeting
GAMEPLAY_EMOTE_HERO_TBMECHWAR01_ERROR_FULL_MINIONS	<Błąd!>	The text is in brackets because the VO files is just Annoy-o-Tron's greeting
GAMEPLAY_EMOTE_HERO_TBMECHWAR01_ERROR_HAND_FULL	<Błąd!>	The text is in brackets because the VO files is just Annoy-o-Tron's greeting
GAMEPLAY_EMOTE_HERO_TBMECHWAR01_ERROR_I_ATTACKED	<Błąd!>	The text is in brackets because the VO files is just Annoy-o-Tron's greeting
GAMEPLAY_EMOTE_HERO_TBMECHWAR01_ERROR_JUST_PLAYED	<Błąd!>	The text is in brackets because the VO files is just Annoy-o-Tron's greeting
GAMEPLAY_EMOTE_HERO_TBMECHWAR01_ERROR_MINION_ATTACKED	<Błąd!>	The text is in brackets because the VO files is just Annoy-o-Tron's greeting
GAMEPLAY_EMOTE_HERO_TBMECHWAR01_ERROR_NEED_MANA	<Błąd!>	The text is in brackets because the VO files is just Annoy-o-Tron's greeting
GAMEPLAY_EMOTE_HERO_TBMECHWAR01_ERROR_NEED_WEAPON	<Błąd!>	The text is in brackets because the VO files is just Annoy-o-Tron's greeting
GAMEPLAY_EMOTE_HERO_TBMECHWAR01_ERROR_PLAY	<Błąd!>	The text is in brackets because the VO files is just Annoy-o-Tron's greeting
GAMEPLAY_EMOTE_HERO_TBMECHWAR01_ERROR_STEALTH	<Błąd!>	The text is in brackets because the VO files is just Annoy-o-Tron's greeting
GAMEPLAY_EMOTE_HERO_TBMECHWAR01_ERROR_TARGET	<Błąd!>	The text is in brackets because the VO files is just Annoy-o-Tron's greeting
GAMEPLAY_EMOTE_HERO_TBMECHWAR01_ERROR_TAUNT	<Błąd!>	The text is in brackets because the VO files is just Annoy-o-Tron's greeting
GAMEPLAY_EMOTE_HERO_TBMECHWAR01_GREETINGS	<Witaj!>	The text is in brackets because the VO files is just Annoy-o-Tron's greeting
GAMEPLAY_EMOTE_HERO_TBMECHWAR01_LOW_CARDS	<Mało kart.>	The text is in brackets because the VO files is just Annoy-o-Tron's greeting
GAMEPLAY_EMOTE_HERO_TBMECHWAR01_NO_CARDS	<Brak kart.>	The text is in brackets because the VO files is just Annoy-o-Tron's greeting
GAMEPLAY_EMOTE_HERO_TBMECHWAR01_OOPS	<Błąd.>	The text is in brackets because the VO files is just Annoy-o-Tron's greeting
GAMEPLAY_EMOTE_HERO_TBMECHWAR01_SORRY	<Wybacz.>	The text is in brackets because the VO files is just Annoy-o-Tron's greeting
GAMEPLAY_EMOTE_HERO_TBMECHWAR01_START	<Zaczynamy.>	The text is in brackets because the VO files is just Annoy-o-Tron's greeting
GAMEPLAY_EMOTE_HERO_TBMECHWAR01_THANKS	<Dzięki.>	The text is in brackets because the VO files is just Annoy-o-Tron's greeting
GAMEPLAY_EMOTE_HERO_TBMECHWAR01_THINK1	<Przetwarzam dane...>	The text is in brackets because the VO files is just Annoy-o-Tron's greeting
GAMEPLAY_EMOTE_HERO_TBMECHWAR01_THINK2	<Namierzam cel...>	The text is in brackets because the VO files is just Annoy-o-Tron's greeting
GAMEPLAY_EMOTE_HERO_TBMECHWAR01_THINK3	<Czekaj, obliczam...>	The text is in brackets because the VO files is just Annoy-o-Tron's greeting
GAMEPLAY_EMOTE_HERO_TBMECHWAR01_THREATEN	<Zniszczę cię!>	The text is in brackets because the VO files is just Annoy-o-Tron's attack
GAMEPLAY_EMOTE_HERO_TBMECHWAR01_TIMER	<Mało czasu.>	The text is in brackets because the VO files is just Annoy-o-Tron's greeting
GAMEPLAY_EMOTE_HERO_TBMECHWAR01_WELL_PLAYED	<Dobre zagranie.>	The text is in brackets because the VO files is just Annoy-o-Tron's greeting
GAMEPLAY_EMOTE_HERO_TBMECHWAR01_WOW	<Niesamowite!>	The text is in brackets because the VO files is just Annoy-o-Tron's greeting
GAMEPLAY_EMOTE_HERO_TBMECHWAR02_CONCEDE	<Wyłączanie...>	The text is in brackets because the VO files is just Boom Bot's greeting
GAMEPLAY_EMOTE_HERO_TBMECHWAR02_ERROR_FULL_MINIONS	<Błąd!>	The text is in brackets because the VO files is just Boom Bot's greeting
GAMEPLAY_EMOTE_HERO_TBMECHWAR02_ERROR_HAND_FULL	<Błąd!>	The text is in brackets because the VO files is just Boom Bot's greeting
GAMEPLAY_EMOTE_HERO_TBMECHWAR02_ERROR_I_ATTACKED	<Błąd!>	The text is in brackets because the VO files is just Boom Bot's greeting
GAMEPLAY_EMOTE_HERO_TBMECHWAR02_ERROR_JUST_PLAYED	<Błąd!>	The text is in brackets because the VO files is just Boom Bot's greeting
GAMEPLAY_EMOTE_HERO_TBMECHWAR02_ERROR_MINION_ATTACKED	<Błąd!>	The text is in brackets because the VO files is just Boom Bot's greeting
GAMEPLAY_EMOTE_HERO_TBMECHWAR02_ERROR_NEED_MANA	<Błąd!>	The text is in brackets because the VO files is just Boom Bot's greeting
GAMEPLAY_EMOTE_HERO_TBMECHWAR02_ERROR_NEED_WEAPON	<Błąd!>	The text is in brackets because the VO files is just Boom Bot's greeting
GAMEPLAY_EMOTE_HERO_TBMECHWAR02_ERROR_PLAY	<Błąd!>	The text is in brackets because the VO files is just Boom Bot's greeting
GAMEPLAY_EMOTE_HERO_TBMECHWAR02_ERROR_STEALTH	<Błąd!>	The text is in brackets because the VO files is just Boom Bot's greeting
GAMEPLAY_EMOTE_HERO_TBMECHWAR02_ERROR_TARGET	<Błąd!>	The text is in brackets because the VO files is just Boom Bot's greeting
GAMEPLAY_EMOTE_HERO_TBMECHWAR02_ERROR_TAUNT	<Błąd!>	The text is in brackets because the VO files is just Boom Bot's greeting
GAMEPLAY_EMOTE_HERO_TBMECHWAR02_GREETINGS	<Witaj!>	The text is in brackets because the VO files is just Annoy-o-Tron's greeting
GAMEPLAY_EMOTE_HERO_TBMECHWAR02_LOW_CARDS	<Mało kart.>	The text is in brackets because the VO files is just Boom Bot's greeting
GAMEPLAY_EMOTE_HERO_TBMECHWAR02_NO_CARDS	<Brak kart!>	The text is in brackets because the VO files is just Boom Bot's greeting
GAMEPLAY_EMOTE_HERO_TBMECHWAR02_OOPS	<Błąd!>	The text is in brackets because the VO files is just Boom Bot's greeting
GAMEPLAY_EMOTE_HERO_TBMECHWAR02_SORRY	<Wybacz.>	The text is in brackets because the VO files is just Boom Bot's greeting
GAMEPLAY_EMOTE_HERO_TBMECHWAR02_START	<Rozpoczynanie.>	The text is in brackets because the VO files is just Boom Bot's greeting
GAMEPLAY_EMOTE_HERO_TBMECHWAR02_THANKS	<Dziękuję.>	The text is in brackets because the VO files is just Boom Bot's greeting
GAMEPLAY_EMOTE_HERO_TBMECHWAR02_THINK1	<Przetwarzam dane...>	The text is in brackets because the VO files is just Boom Bot's greeting
GAMEPLAY_EMOTE_HERO_TBMECHWAR02_THINK2	<Namierzam cel...>	The text is in brackets because the VO files is just Boom Bot's greeting
GAMEPLAY_EMOTE_HERO_TBMECHWAR02_THINK3	<Czekaj, obliczam...>	The text is in brackets because the VO files is just Boom Bot's greeting
GAMEPLAY_EMOTE_HERO_TBMECHWAR02_THREATEN	<Niszczyć!>	The text is in brackets because the VO files is just Boom Bot's Attack sound
GAMEPLAY_EMOTE_HERO_TBMECHWAR02_TIMER	<Mało czasu.>	The text is in brackets because the VO files is just Boom Bot's greeting
GAMEPLAY_EMOTE_HERO_TBMECHWAR02_WELL_PLAYED	<Dobre zagranie.>	The text is in brackets because the VO files is just Boom Bot's greeting
GAMEPLAY_EMOTE_HERO_TBMECHWAR02_WOW	<Zadziwiające!>	The text is in brackets because the VO files is just Annoy-o-Tron's greeting
GAMEPLAY_EMOTE_ICC_481_CONCEDE	Niechaj to zwycięstwo ostudzi twój zapał.	
GAMEPLAY_EMOTE_ICC_481_GREETINGS	Powitaj chłodny uścisk śmierci.	
GAMEPLAY_EMOTE_ICC_481_LOW_CARDS	Już prawie nie mam kart!	
GAMEPLAY_EMOTE_ICC_481_NO_CARDS	Skończyły mi się karty!	
GAMEPLAY_EMOTE_ICC_481_OOPS	Poważny błąd.	
GAMEPLAY_EMOTE_ICC_481_START	Za Zgładziciela!	
GAMEPLAY_EMOTE_ICC_481_THANKS	Dziękuję.	
GAMEPLAY_EMOTE_ICC_481_THINK1	Hmmm…	
GAMEPLAY_EMOTE_ICC_481_THINK2	Hmmm, żywioły milczą.	
GAMEPLAY_EMOTE_ICC_481_THINK3	Sam muszę dokonać wyboru.	
GAMEPLAY_EMOTE_ICC_481_THREATEN	Rozbiję cię w pył!	
GAMEPLAY_EMOTE_ICC_481_TIMER	Trzeba wybrać ścieżkę!	
GAMEPLAY_EMOTE_ICC_481_WELL_PLAYED	Dobre zagranie.	
GAMEPLAY_EMOTE_ICC_481_WOW	Doprawdy niesamowite!	
GAMEPLAY_EMOTE_ICC_827_CONCEDE	Dzisiaj ty triumfujesz.	
GAMEPLAY_EMOTE_ICC_827_GREETINGS	Gdzie się chowasz?	
GAMEPLAY_EMOTE_ICC_827_LOW_CARDS	Już prawie nie mam kart!	
GAMEPLAY_EMOTE_ICC_827_NO_CARDS	Skończyły mi się karty!	
GAMEPLAY_EMOTE_ICC_827_OOPS	Jakie to tragiczne.	
GAMEPLAY_EMOTE_ICC_827_START	Zachowaj czujność.	
GAMEPLAY_EMOTE_ICC_827_THANKS	Dziękuję.	
GAMEPLAY_EMOTE_ICC_827_THINK1	Hmmm…	
GAMEPLAY_EMOTE_ICC_827_THINK2	Cień śmierci się wydłuża...	
GAMEPLAY_EMOTE_ICC_827_THINK3	Marnujemy czas...	
GAMEPLAY_EMOTE_ICC_827_THREATEN	Zaczniesz się bać własnego cienia.	
GAMEPLAY_EMOTE_ICC_827_TIMER	Muszę zaraz dokonać wyboru...	
GAMEPLAY_EMOTE_ICC_827_WELL_PLAYED	Cudownie.	
GAMEPLAY_EMOTE_ICC_827_WOW	Niesamowite!	
GAMEPLAY_EMOTE_ICC_828_CONCEDE	Jesteś górą w tym polowaniu.	
GAMEPLAY_EMOTE_ICC_828_GREETINGS	Lepiej uciekaj, zwierzyno!	
GAMEPLAY_EMOTE_ICC_828_LOW_CARDS	Już prawie nie mam kart!	
GAMEPLAY_EMOTE_ICC_828_NO_CARDS	Skończyły mi się karty!	
GAMEPLAY_EMOTE_ICC_828_OOPS	Coś nie wyszło.	
GAMEPLAY_EMOTE_ICC_828_START	Niech rozpoczną się łowy!	
GAMEPLAY_EMOTE_ICC_828_THANKS	Dziękuję ci.	
GAMEPLAY_EMOTE_ICC_828_THINK1	Hmmm…	
GAMEPLAY_EMOTE_ICC_828_THINK2	Którym tropem by tu podążyć...	
GAMEPLAY_EMOTE_ICC_828_THINK3	Tak sobie myślę...	
GAMEPLAY_EMOTE_ICC_828_THREATEN	Nie uciekniesz przede mną... NIGDY!	
GAMEPLAY_EMOTE_ICC_828_TIMER	Gubię trop!	
GAMEPLAY_EMOTE_ICC_828_WELL_PLAYED	Dobre zagranie.	
GAMEPLAY_EMOTE_ICC_828_WOW	Imponujące.	
GAMEPLAY_EMOTE_ICC_829_CONCEDE	Triumfujesz. Tym razem.	
GAMEPLAY_EMOTE_ICC_829_GREETINGS	Teraz ja jestem sprawiedliwością.	
GAMEPLAY_EMOTE_ICC_829_LOW_CARDS	Już prawie nie mam kart!	
GAMEPLAY_EMOTE_ICC_829_NO_CARDS	Skończyły mi się karty!	
GAMEPLAY_EMOTE_ICC_829_OOPS	To rozczarowujące.	
GAMEPLAY_EMOTE_ICC_829_START	Będę walczyć z honorem!	
GAMEPLAY_EMOTE_ICC_829_THANKS	Dziękuję.	
GAMEPLAY_EMOTE_ICC_829_THINK1	Hmmm…	
GAMEPLAY_EMOTE_ICC_829_THINK2	Ostrze Mrozu wzywa.	
GAMEPLAY_EMOTE_ICC_829_THINK3	Mroźny Tron wzywa...	
GAMEPLAY_EMOTE_ICC_829_THREATEN	Twoja kara będzie trwać wiecznie.	
GAMEPLAY_EMOTE_ICC_829_TIMER	Wkrótce nadejdzie koniec!	
GAMEPLAY_EMOTE_ICC_829_WELL_PLAYED	Przyzwoicie.	
GAMEPLAY_EMOTE_ICC_829_WOW	Niewiarygodne!	
GAMEPLAY_EMOTE_ICC_830_CONCEDE	NIE! Twoje zwycięstwo niczego nie dowodzi!	
GAMEPLAY_EMOTE_ICC_830_GREETINGS	Nadejście ciemności będzie moją zemstą.	
GAMEPLAY_EMOTE_ICC_830_LOW_CARDS	Już prawie nie mam kart!	
GAMEPLAY_EMOTE_ICC_830_NO_CARDS	Skończyły mi się karty!	
GAMEPLAY_EMOTE_ICC_830_OOPS	Błądzić to rzecz ludzka.	
GAMEPLAY_EMOTE_ICC_830_START	Ciemność zapewni mi zwycięstwo!	
GAMEPLAY_EMOTE_ICC_830_THANKS	Dziękuję.	
GAMEPLAY_EMOTE_ICC_830_THINK1	Hmmm…	
GAMEPLAY_EMOTE_ICC_830_THINK2	Ciemność przemawia do mnie...	
GAMEPLAY_EMOTE_ICC_830_THINK3	Moje myśli spowija cień.	
GAMEPLAY_EMOTE_ICC_830_THREATEN	Ciemność cię pochłonie!	
GAMEPLAY_EMOTE_ICC_830_TIMER	Cienie stają się coraz krótsze!	
GAMEPLAY_EMOTE_ICC_830_WELL_PLAYED	Zacne zagranie.	
GAMEPLAY_EMOTE_ICC_830_WOW	Zadziwiające!	
GAMEPLAY_EMOTE_ICC_831_CONCEDE	Wygrywasz... tym razem.	
GAMEPLAY_EMOTE_ICC_831_GREETINGS	Lękaj się mnie.	
GAMEPLAY_EMOTE_ICC_831_LOW_CARDS	Już prawie nie mam kart!	
GAMEPLAY_EMOTE_ICC_831_NO_CARDS	Skończyły mi się karty!	
GAMEPLAY_EMOTE_ICC_831_OOPS	To nie miało żadnego sensu.	
GAMEPLAY_EMOTE_ICC_831_START	Twoja dusza będzie moja!	
GAMEPLAY_EMOTE_ICC_831_THANKS	A! Dziękuję.	
GAMEPLAY_EMOTE_ICC_831_THINK1	Hmmm…	
GAMEPLAY_EMOTE_ICC_831_THINK2	Nieokiełznany głód…	
GAMEPLAY_EMOTE_ICC_831_THINK3	Niech to, tyle decyzji.	
GAMEPLAY_EMOTE_ICC_831_THREATEN	Twoje cierpienie będzie… LEGENDARNE!	
GAMEPLAY_EMOTE_ICC_831_TIMER	Muszę się natychmiast pożywić!	
GAMEPLAY_EMOTE_ICC_831_WELL_PLAYED	Dobra robota.	
GAMEPLAY_EMOTE_ICC_831_WOW	Na piekielny ogień!	
GAMEPLAY_EMOTE_ICC_832_CONCEDE	Wygrywasz. Teraz mogę odpocząć.	
GAMEPLAY_EMOTE_ICC_832_GREETINGS	Rozpoczyna się krąg rozkładu.	
GAMEPLAY_EMOTE_ICC_832_LOW_CARDS	Już prawie nie mam kart!	
GAMEPLAY_EMOTE_ICC_832_NO_CARDS	Skończyły mi się karty!	
GAMEPLAY_EMOTE_ICC_832_OOPS	Dziurawa strategia.	
GAMEPLAY_EMOTE_ICC_832_START	Krąg życia został przerwany.	
GAMEPLAY_EMOTE_ICC_832_THANKS	Składam ci podziękowania.	
GAMEPLAY_EMOTE_ICC_832_THINK1	Hmmm…	
GAMEPLAY_EMOTE_ICC_832_THINK2	Skomplikowana pajęczyna.	
GAMEPLAY_EMOTE_ICC_832_THINK3	Moje myśli toczy zaraza.	
GAMEPLAY_EMOTE_ICC_832_THREATEN	Zmarniejesz\ni zgnijesz!	
GAMEPLAY_EMOTE_ICC_832_TIMER	Śmierć jest wieczna, ale moja tura nie!	
GAMEPLAY_EMOTE_ICC_832_WELL_PLAYED	Mistrzowskie zagranie.	
GAMEPLAY_EMOTE_ICC_832_WOW	Oszałamiające!	
GAMEPLAY_EMOTE_ICC_833_CONCEDE	Chylę czoła przed twoją potęgą.	
GAMEPLAY_EMOTE_ICC_833_GREETINGS	Drżysz... Czy to strach?	
GAMEPLAY_EMOTE_ICC_833_LOW_CARDS	Już prawie nie mam kart!	
GAMEPLAY_EMOTE_ICC_833_NO_CARDS	Skończyły mi się karty!	
GAMEPLAY_EMOTE_ICC_833_OOPS	Śmiertelny błąd.	
GAMEPLAY_EMOTE_ICC_833_START	Prosisz się o lanie.	
GAMEPLAY_EMOTE_ICC_833_THANKS	Hahaha! Dziękuję ci.	
GAMEPLAY_EMOTE_ICC_833_THINK1	Hmmm…	
GAMEPLAY_EMOTE_ICC_833_THINK2	Tracimy tu czas...	
GAMEPLAY_EMOTE_ICC_833_THINK3	Hmm. Muszę podjąć decyzję...	
GAMEPLAY_EMOTE_ICC_833_THREATEN	Pokłoń się królowej!	
GAMEPLAY_EMOTE_ICC_833_TIMER	Czas działać!	
GAMEPLAY_EMOTE_ICC_833_WELL_PLAYED	Dobre zagranie.	
GAMEPLAY_EMOTE_ICC_833_WOW	Na moje lodowe serce!	
GAMEPLAY_EMOTE_ICC_834_CONCEDE	Wybieram śmierć!	
GAMEPLAY_EMOTE_ICC_834_GREETINGS	Dosięgnie cię gniew Piekłorycza!	
GAMEPLAY_EMOTE_ICC_834_LOW_CARDS	Już prawie nie mam kart!	
GAMEPLAY_EMOTE_ICC_834_NO_CARDS	Skończyły mi się karty!	
GAMEPLAY_EMOTE_ICC_834_OOPS	Porażka!	
GAMEPLAY_EMOTE_ICC_834_START	Zwycięstwo albo śmierć!	
GAMEPLAY_EMOTE_ICC_834_THANKS	Dziękuję ci.	
GAMEPLAY_EMOTE_ICC_834_THINK1	Hmmm…	
GAMEPLAY_EMOTE_ICC_834_THINK2	Czas leci...	
GAMEPLAY_EMOTE_ICC_834_THINK3	Co teraz...	
GAMEPLAY_EMOTE_ICC_834_THREATEN	Zaraz padniesz na kolana.	
GAMEPLAY_EMOTE_ICC_834_TIMER	Muszę wybrać!	
GAMEPLAY_EMOTE_ICC_834_WELL_PLAYED	Godny przeciwnik!	
GAMEPLAY_EMOTE_ICC_834_WOW	Zadziwiające!	
VO_Arthas_Male_Human_Attack_01	W imię ŚWIATŁOŚCI!	
VO_Arthas_Male_Human_CONCEDE_01	I po bitwie. Wygrana jest twoja.	
VO_Arthas_Male_Human_ERROR_FULL_MINIONS_01	Mam zbyt wielu stronników!	
VO_Arthas_Male_Human_ERROR_GENERIC_01	Nie mogę tego zrobić.	
VO_Arthas_Male_Human_ERROR_HAND_FULL_01	Mam pełną rękę!	
VO_Arthas_Male_Human_ERROR_I_ATTACKED_01	Już atakowałem.	
VO_Arthas_Male_Human_ERROR_JUST_PLAYED_01	Daj temu stronnikowi turę na przygotowanie.	
VO_Arthas_Male_Human_ERROR_MINION_ATTACKED_01	Ten stronnik już atakował.	
VO_Arthas_Male_Human_ERROR_NEED_MANA_01	Mam za mało many.	
VO_Arthas_Male_Human_ERROR_NEED_WEAPON_01	Potrzebna mi broń.	
VO_Arthas_Male_Human_ERROR_PLAY_01	Nie mogę tego zagrać.	
VO_Arthas_Male_Human_ERROR_STEALTH_01	Nie mogę wybrać ukrytych stronników.	
VO_Arthas_Male_Human_ERROR_TARGET_01	To nie jest prawidłowy cel.	
VO_Arthas_Male_Human_ERROR_TAUNT_01	Na drodze stoi stronnik z Prowokacją.	
VO_Arthas_Male_Human_FIRE_FESTIVAL_01	Rozpalcie świąteczne ogniska!	
VO_Arthas_Male_Human_GREETINGS_01	Witaj, dobrze cię widzieć.	
VO_Arthas_Male_Human_HAPPY_HALLOWEEN_01	Szczęśliwych Zaduszników!	
VO_Arthas_Male_Human_HAPPY_HOLIDAYS_01	Szczęśliwej Zimowej Uczty!	
VO_Arthas_Male_Human_HAPPY_NEW_YEAR_01	Szczęśliwego Nowego Roku!	
VO_Arthas_Male_Human_HAPPY_NEW_YEAR_LUNAR_01	Szczęśliwego Nowego Roku!	
VO_Arthas_Male_Human_HAPPY_NOBLEGARDEN	Wesołych Miłogrodów.	
VO_Arthas_Male_Human_LOW_CARDS_01	Już prawie nie mam kart!	
VO_Arthas_Male_Human_MIRROR_GREETINGS_01	Zaiste!	
VO_Arthas_Male_Human_MIRROR_START_01	Za mojego ojca, króla!	
VO_Arthas_Male_Human_NO_CARDS_01	Skończyły mi się karty!	
VO_Arthas_Male_Human_OOPS_01	Ot, potknięcie.	
VO_Arthas_Male_Human_PIRATE_DAY_01	Jestem Arrrrrthas. ARRRthas, łapiesz?	
VO_Arthas_Male_Human_SORRY_01	Najmocniej przepraszam!	
VO_Arthas_Male_Human_START_01	Za Lordaeron!	
VO_Arthas_Male_Human_THANKS_01	Jestem ci wdzięczny.	
VO_Arthas_Male_Human_THINK1_01	Hmm...	
VO_Arthas_Male_Human_THINK2_01	Którą by tu wybrać ścieżkę…	
VO_Arthas_Male_Human_THINK3_01	Co zrobiłby Uther…	
VO_Arthas_Male_Human_THREATEN_01	Nie licz na odkupienie!	
VO_Arthas_Male_Human_TIMER_01	Muszę działać natychmiast!	
VO_Arthas_Male_Human_WELL_PLAYED_01	Zacne zagranie.	
VO_Arthas_Male_Human_WOW_01	Na świętą Światłość!	
VO_BRM_027h__LUNAR_NEW_YEAR	OCZYŚCI CIĘ OGIEŃ!	
VO_BRM_027h_Attack_15	PATRZ NA PŁOMIENIE SULFURONA!	
VO_BRM_027h_Concede_11	PODDAJĘ SIĘ! GRATULACJE!	
VO_BRM_027h_Emote_Start	JESZCZE SIĘ ZEMSZCZĘ, SMOKU!	
VO_BRM_027h_ERROR01_51	POTRZEBNA MI BROŃ.	
VO_BRM_027h_ERROR02_52	ZA MAŁO MANY!	
VO_BRM_027h_ERROR03_53	TEN STRONNIK JUŻ ATAKOWAŁ.	
VO_BRM_027h_ERROR04_54	JUŻ ATAKOWAŁEM.	
VO_BRM_027h_ERROR05_55	ŚMIERTELNICY POTRZEBUJĄ TURY NA PRZYGOTOWANIE.	
VO_BRM_027h_ERROR06_56	ZA DUŻO KART!	
VO_BRM_027h_ERROR07_57	ZBYT WIELU STRONNIKÓW.	
VO_BRM_027h_ERROR08_58	STRONNIK UKRYTY.	
VO_BRM_027h_ERROR09_59	NIE MOGĘ TEGO ZAGRAĆ.	
VO_BRM_027h_ERROR10_60	NIE DA SIĘ.	
VO_BRM_027h_ERROR11_61	TEN IRYTUJĄCY STWÓR STOI MI NA DRODZE!	
VO_BRM_027h_ERROR12_62	NIE MOGĘ TEGO ZROBIĆ!	
VO_BRM_027h_FIRE_FESTIVAL	OTO NASTAŁO ŚWIĘTO OGNIA!	
VO_BRM_027h_GG_16	DOBRA GRA!	
VO_BRM_027h_Greetings_04	OCZYŚCI CIĘ OGIEŃ!	
VO_BRM_027h_HALLOWS_END	SZCZĘŚLIWYCH ZADUSZNIKÓW!	
VO_BRM_027h_HAPPY_NEW_YEAR_38	DZIĘKI MNIE PRZYSZŁY ROK BĘDZIE NAPRAWDĘ GORĄCY!	
VO_BRM_027h_LowCards_49	NIEDŁUGO ZABRAKNIE MI KART!	
VO_BRM_027h_NOBLEGARDEN	WESOŁEGO JAJKA! NA TWARDO!	
VO_BRM_027h_NoCards_50	NIE MAM WIĘCEJ KART!	
VO_BRM_027h_Oops_07	AAA! BŁĄD!	
VO_BRM_027h_PIRATE_DAY	OGNISTA FLAGA NA MASZT!	
VO_BRM_027h_Sorry_10	WYBACZ!	
VO_BRM_027h_Thanks_09	DZIĘKUJĘ GORĄCO.	
VO_BRM_027h_Thinking1_12	HMMM…	
VO_BRM_027h_Thinking2_13	TAK SOBIE MYŚLĘ...	
VO_BRM_027h_Thinking3_14	CO BY TU SPALIĆ NAJPIERW...	
VO_BRM_027h_Threaten_08	ZGINIESZ W MORZU PŁOMIENI!	
VO_BRM_027h_Time_48	PŁOMIEŃ ROŚNIE... CZAS UCIEKA!	
VO_BRM_027h_Well_Played_06	DOBRE ZAGRANIE!	
VO_BRM_027h_Winterveil_Greetings	W ZIMIE MOGŁOBY BYĆ CIEPLEJ.	
VO_BRM_027h_WOW_20	ALE CZAD!	
VO_EX1_323h_HAPPY_NEW_YEAR_13	SZCZĘŚLIWEGO NOWEGO ROKU!	
VO_GIL_504_Female_Orc_Concede_01	Tym razem wygrywasz.	
VO_GIL_504_Female_Orc_Greetings_02	Witaj w moim królestwie.	
VO_GIL_504_Female_Orc_LowCards_01	Już prawie nie mam kart!	
VO_GIL_504_Female_Orc_NoCards_01	Skończyły mi się karty!	
VO_GIL_504_Female_Orc_Oops_01	To niemądre.	
VO_GIL_504_Female_Orc_Start_01	Las jest groźny nocą.	
VO_GIL_504_Female_Orc_Thanks_01	Dziękuję.	
VO_GIL_504_Female_Orc_Thinking_01	Hmm...	
VO_GIL_504_Female_Orc_Thinking_02	Zastanawiające...	
VO_GIL_504_Female_Orc_Thinking_03	Niepewna ścieżka.	
VO_GIL_504_Female_Orc_Threaten_02	Dopadnie cię klątwa!	
VO_GIL_504_Female_Orc_Time_01	Muszę się zdecydować!	
VO_GIL_504_Female_Orc_Well_Played_01	Dobre zagranie!	
VO_GIL_504_Female_Orc_Wow_01	Na ciemną noc!	
VO_GILA_400h_Male_Human_Concede_01	No nie zmogę cię.	
VO_GILA_400h_Male_Human_Death_02	<Zgon>	
VO_GILA_400h_Male_Human_ERROR_FULL_MINIONS_01	Nie ma już miejsca.	
VO_GILA_400h_Male_Human_ERROR_GENERIC_01	Nie mogę tego zrobić.	
VO_GILA_400h_Male_Human_ERROR_GENERIC_04	No nie da rady.	
VO_GILA_400h_Male_Human_ERROR_HAND_FULL_01	Mam za dużo kart!	
VO_GILA_400h_Male_Human_ERROR_I_ATTACKED_01	Już atakowałem!	
VO_GILA_400h_Male_Human_ERROR_MINION_ATTACKED_01	Ten tu stronnik już atakował.	
VO_GILA_400h_Male_Human_ERROR_NEED_MANA_02	Zabrakło mi many.	
VO_GILA_400h_Male_Human_ERROR_NEED_WEAPON_02	Potrzebna mi broń.	
VO_GILA_400h_Male_Human_ERROR_STEALTH_01	Ten stronnik jest ukryty!	
VO_GILA_400h_Male_Human_ERROR_SUMMON_SICKNESS_01	Ten stronnik nie jest gotowy.	
VO_GILA_400h_Male_Human_ERROR_TARGET_01	Nie mogę wskazać tego celu.	
VO_GILA_400h_Male_Human_ERROR_TAUNT_01	Blokuje nas stronnik z Prowokacją.	
VO_GILA_400h_Male_Human_Greetings_01	Nie lubię cię. Moje psy też cię nie lubią.	
VO_GILA_400h_Male_Human_LowCards_01	Już prawie nie mam kart...	
VO_GILA_400h_Male_Human_NoCards_01	Nie mam już kart!	
VO_GILA_400h_Male_Human_Oops_01	Fatalnie poszło.	
VO_GILA_400h_Male_Human_Sorry_01	Tak mi przykro.	
VO_GILA_400h_Male_Human_Start_01	Patrzcie no co pieski odkopały.	
VO_GILA_400h_Male_Human_Thanks_01	Dzięki za to.	
VO_GILA_400h_Male_Human_Thinking_01	Hmmm….	
VO_GILA_400h_Male_Human_Thinking_03	Muszę to przemyśleć.	
VO_GILA_400h_Male_Human_Thinking_04	No dawaj...	
VO_GILA_400h_Male_Human_Threaten_04	Lepiej udawaj trupa.	
VO_GILA_400h_Male_Human_Time_01	Zostało niewiele czasu.	
VO_GILA_400h_Male_Human_Well_Played_01	Niezła sztuczka!	
VO_GILA_400h_Male_Human_WOW_01	Psiakość!	
VO_GILA_500h3_Female_Human_Concede_01	Nie dałam ci rady.	
VO_GILA_500h3_Female_Human_ERROR_FULL_MINIONS_01	Mam za mało miejsca.	
VO_GILA_500h3_Female_Human_ERROR_GENERIC_04	To niedozwolone!	
VO_GILA_500h3_Female_Human_ERROR_HAND_FULL_02	Mam za dużo kart!	
VO_GILA_500h3_Female_Human_ERROR_I_ATTACKED_02	Nie mogę atakować dwa razy!	
VO_GILA_500h3_Female_Human_ERROR_MINION_ATTACKED_01	Ten stronnik już atakował.	
VO_GILA_500h3_Female_Human_ERROR_NEED_MANA_02	Mam za mało many.	
VO_GILA_500h3_Female_Human_ERROR_NEED_WEAPON_02	Przydałaby się broń.	
VO_GILA_500h3_Female_Human_ERROR_PLAY_01	Nie mogę naginać zasad.	
VO_GILA_500h3_Female_Human_ERROR_STEALTH_01	Nie mogę znaleźć tego celu!	
VO_GILA_500h3_Female_Human_ERROR_SUMMON_SICKNESS_01	Ten stronnik nie jest gotowy.	
VO_GILA_500h3_Female_Human_ERROR_TARGET_01	Nie mogę wskazać tego celu.	
VO_GILA_500h3_Female_Human_ERROR_TAUNT_01	Na drodze stoi stronnik z Prowokacją!	
VO_GILA_500h3_Female_Human_Greetings_01	Nieukoronowani przesyłają pozdrowienia.	
VO_GILA_500h3_Female_Human_LowCards_01	Nie zostało mi wiele kart...	
VO_GILA_500h3_Female_Human_NoCards_01	Skończyły mi się karty!	
VO_GILA_500h3_Female_Human_Oops_02	To nie było zamierzone.	
VO_GILA_500h3_Female_Human_Sorry_01	Wybacz mi.	
VO_GILA_500h3_Female_Human_Start_01	Trop prowadzi tutaj.	
VO_GILA_500h3_Female_Human_Thanks_01	Dziękuję.	
VO_GILA_500h3_Female_Human_Thinking_02	Musi być jakiś sposób...	
VO_GILA_500h3_Female_Human_Thinking_03	Myśl, Tess. Myśl.	
VO_GILA_500h3_Female_Human_Thinking_05	Aaa... hmm.	
VO_GILA_500h3_Female_Human_Threaten_03	Zniszczę cię!	
VO_GILA_500h3_Female_Human_Time_01	Muszę działać szybko.	
VO_GILA_500h3_Female_Human_Well_Played_01	Wyborna taktyka.	
VO_GILA_500h3_Female_Human_WOW_01	Niesamowite!	
VO_GILA_600h_Male_Worgen_Concede_01	Zostałem przechytrzony. Wyrazy szacunku.	
VO_GILA_600h_Male_Worgen_ERROR_FULL_MINIONS_02	Mam zbyt wielu stronników na planszy.	
VO_GILA_600h_Male_Worgen_ERROR_GENERIC_01	To niemożliwe.	
VO_GILA_600h_Male_Worgen_ERROR_GENERIC_02	Nie mogę tego zrobić.	
VO_GILA_600h_Male_Worgen_ERROR_HAND_FULL_01	Mam za dużo kart!	
VO_GILA_600h_Male_Worgen_ERROR_I_ATTACKED_01	Już atakowałem.	
VO_GILA_600h_Male_Worgen_ERROR_MINION_ATTACKED_01	Ten stronnik już atakował.	
VO_GILA_600h_Male_Worgen_ERROR_NEED_MANA_01	Nie mam many.	
VO_GILA_600h_Male_Worgen_ERROR_NEED_WEAPON_02	Potrzebna mi broń!	
VO_GILA_600h_Male_Worgen_ERROR_STEALTH_01	Aaa. Ten stronnik się ukrywa!	
VO_GILA_600h_Male_Worgen_ERROR_SUMMON_SICKNESS_01	Stronnik nie jest jeszcze gotowy.	
VO_GILA_600h_Male_Worgen_ERROR_TARGET_01	Nie mogę wskazać tego celu.	
VO_GILA_600h_Male_Worgen_ERROR_TAUNT_01	Przeszkadza nam stronnik z_Prowokacją!	
VO_GILA_600h_Male_Worgen_Greetings_01	Przywitaj się z moim wielkim przyjacielem.	
VO_GILA_600h_Male_Worgen_LowCards_01	Już prawie nie mam kart!	
VO_GILA_600h_Male_Worgen_NoCards_01	Skończyły mi się karty!	
VO_GILA_600h_Male_Worgen_Oops_01	Złe posunięcie!	
VO_GILA_600h_Male_Worgen_Sorry_01	Wybacz... mi.	
VO_GILA_600h_Male_Worgen_Start_01	Zajmuję pozycję.	
VO_GILA_600h_Male_Worgen_Thanks_01	Dziękuję.	
VO_GILA_600h_Male_Worgen_Thinking_01	Hmmm….	
VO_GILA_600h_Male_Worgen_Thinking_02	Co by tu zrobić...	
VO_GILA_600h_Male_Worgen_Thinking_04	Znajdę sposób...	
VO_GILA_600h_Male_Worgen_Threaten_01	Zostaną z ciebie drzazgi!	
VO_GILA_600h_Male_Worgen_Time_01	Nie poganiaj mnie!	
VO_GILA_600h_Male_Worgen_Well_Played_01	Wspaniały manewr.	
VO_GILA_600h_Male_Worgen_WOW_01	Niewiarygodne!	
VO_GILA_900h_Female_Gnome_Concede_01	Próbowałam wszystkiego. Wygrywasz!	
VO_GILA_900h_Female_Gnome_ERROR_FULL_MINIONS_02	Nie mogę mieć już więcej stronników.	
VO_GILA_900h_Female_Gnome_ERROR_GENERIC_01	Nie mogę tego zrobić.	
VO_GILA_900h_Female_Gnome_ERROR_HAND_FULL_01	Mam zbyt wiele kart!	
VO_GILA_900h_Female_Gnome_ERROR_I_ATTACKED_02	Nie mogę jeszcze atakować!	
VO_GILA_900h_Female_Gnome_ERROR_MINION_ATTACKED_01	Ten stronnik już atakował.	
VO_GILA_900h_Female_Gnome_ERROR_NEED_MANA_01	Nie mam dość many.	
VO_GILA_900h_Female_Gnome_ERROR_NEED_WEAPON_01	Nie mam broni.	
VO_GILA_900h_Female_Gnome_ERROR_PLAY_01	Nawet ja nie mogę tego zrobić.	
VO_GILA_900h_Female_Gnome_ERROR_STEALTH_01	Ten cel jest ukryty.	
VO_GILA_900h_Female_Gnome_ERROR_SUMMON_SICKNESS_01	Ten stronnik potrzebuje chwili.	
VO_GILA_900h_Female_Gnome_ERROR_TARGET_01	To nie jest odpowiedni cel.	
VO_GILA_900h_Female_Gnome_ERROR_TAUNT_01	Na drodze stoi stronnik z_Prowokacją!	
VO_GILA_900h_Female_Gnome_GG_01	Jaka dobra gra!	
VO_GILA_900h_Female_Gnome_Greetings_01	O, witaj. To znowu ty.	
VO_GILA_900h_Female_Gnome_LowCards_01	Nie zostało wiele kart...	
VO_GILA_900h_Female_Gnome_NoCards_01	Skończyły mi się karty!	
VO_GILA_900h_Female_Gnome_Oops_02	To chyba był błąd.	
VO_GILA_900h_Female_Gnome_Sorry_01	Eee, wybacz.	
VO_GILA_900h_Female_Gnome_Start_01	Twój czas się skończył.	
VO_GILA_900h_Female_Gnome_Thanks_01	Dziękuję.	
VO_GILA_900h_Female_Gnome_Thinking_02	Hmmm…	
VO_GILA_900h_Female_Gnome_Thinking_03	...muszę myśleć czterowymiarowo.	
VO_GILA_900h_Female_Gnome_Thinking_05	... trybiki się obracają...	
VO_GILA_900h_Female_Gnome_Threaten_01	Wymażę cię z_tej linii czasowej!	
VO_GILA_900h_Female_Gnome_Time_01	Jak to możliwe, że kończy mi się czas?	
VO_GILA_900h_Female_Gnome_Well_Played_01	Sama bym tego lepiej nie zrobiła!	
VO_GILA_900h_Female_Gnome_WOW_02	To niepojęte!	
VO_HERO_01_HAPPY_NEW_YEAR_06	Szczęśliwego Nowego Roku!	
VO_HERO_02_HAPPY_NEW_YEAR_07	Szczęśliwego Nowego Roku!	
VO_HERO_03_HAPPY_NEW_YEAR_06	Szczęśliwego Nowego Roku!	
VO_HERO_03a_Attack_15	Oto sprawiedliwość!	
VO_HERO_03a_CONCEDE_06	Sprytne posunięcie, poddaję się.	
VO_HERO_03a_ERROR_FULL_MINIONS_25	Mam za dużo stronników.	
VO_HERO_03a_ERROR_GENERIC_30	Nie mogę tego zrobić.	
VO_HERO_03a_ERROR_HAND_FULL_24	Mam pełną rękę!	
VO_HERO_03a_ERROR_I_ATTACKED_22	Już atakowałam.	
VO_HERO_03a_ERROR_JUST_PLAYED_23	Daj temu stronnikowi turę na przygotowanie.	
VO_HERO_03a_ERROR_MINION_ATTACKED_21	Ten stronnik już atakował.	
VO_HERO_03a_ERROR_NEED_MANA_20	Mam za mało many.	
VO_HERO_03a_ERROR_NEED_WEAPON_19	Potrzebuję broni.	
VO_HERO_03a_ERROR_PLAY_27	Nie mogę tego zagrać.	
VO_HERO_03a_ERROR_STEALTH_26	Nie mogę wybrać ukrytych stronników.	
VO_HERO_03a_ERROR_TARGET_28	To nie jest prawidłowy cel.	
VO_HERO_03a_ERROR_TAUNT_29	Na drodze stoi stronnik z_Prowokacją.	
VO_HERO_03a_FIRE_FESTIVAL	Świętujmy Festiwal Letniego Przesilenia!	
VO_HERO_03a_GREETINGS_03	Witaj!	
VO_HERO_03a_HALLOWS_END	Szczęśliwych Zaduszników!	
VO_HERO_03a_HAPPY_HOLIDAYS_52	Szczęśliwej Zimowej Uczty!	
VO_HERO_03a_HAPPY_NEW_YEAR_53	Szczęśliwego Nowego Roku!	
VO_HERO_03a_LOW_CARDS_17	Już prawie nie mam kart!	
VO_HERO_03a_MIRROR_GREETINGS_04	Cóż za miła niespodzianka! Witaj!	
VO_HERO_03a_MIRROR_START_02	Jestem żelazną ręką sprawiedliwości!	
VO_HERO_03a_NO_CARDS_18	Skończyły mi się karty!	
VO_HERO_03a_NOBLEGARDEN	Radosnych Miłogrodów.	
VO_HERO_03a_OOPS_08	Błąd taktyczny.	
VO_HERO_03a_PICKED_11	W samą porę!	
VO_HERO_03a_PIRATE_DAY	Arrrr, dziś Dzień Pirata!	
VO_HERO_03a_SORRY_10	Wybacz.	
VO_HERO_03a_START_01	Nikt nie umknie przed moim gniewem!	
VO_HERO_03a_THANKS_09	Dziękuję.	
VO_HERO_03a_THINK1_12	Hmm...	
VO_HERO_03a_THINK2_13	Tak sobie myślę...	
VO_HERO_03a_THINK3_14	Myśl...	
VO_HERO_03a_THREATEN_05	Ściągasz na siebie mój gniew!	
VO_HERO_03a_TIMER_16	Żwawo!	
VO_HERO_03a_WELL_PLAYED_07	Niezłe zagranie.	
VO_HERO_03a_WOW_35	Niesamowite.	
VO_HERO_04_HAPPY_NEW_YEAR_15	Szczęśliwego Nowego Roku, czempionie!	
VO_HERO_05_HAPPY_NEW_YEAR_15	Szczęśliwego Nowego Roku!	
VO_HERO_06_HAPPY_NEW_YEAR_15	Szczęśliwego Nowego Roku!	
VO_HERO_07_HAPPY_NEW_YEAR_15	Szczęśliwego Nowego Roku!	
VO_HERO_08_HAPPY_NEW_YEAR_15	Szczęśliwego Nowego Roku!	
VO_HERO_08b_HAPPY_NEW_YEAR_53	Szczęśliwego Nowego Roku!	
VO_HERO_09_HAPPY_NEW_YEAR_15	Szczęśliwego Nowego Roku!	
VO_HERO_09a_Attack_15	Za Elunę!	
VO_HERO_09a_CONCEDE_06	Już po wszystkim. Wygrywasz.	
VO_HERO_09a_ERROR_FULL_MINIONS_25	Mam zbyt wielu stronników.	
VO_HERO_09a_ERROR_GENERIC_30	Nie mogę tego zrobić.	
VO_HERO_09a_ERROR_HAND_FULL_24	Mam pełną rękę!	
VO_HERO_09a_ERROR_I_ATTACKED_22	Już atakowałam.	
VO_HERO_09a_ERROR_JUST_PLAYED_23	Daj temu stronnikowi turę na przygotowanie.	
VO_HERO_09a_ERROR_MINION_ATTACKED_21	Ten stronnik już atakował.	
VO_HERO_09a_ERROR_NEED_MANA_20	Mam za mało many.	
VO_HERO_09a_ERROR_NEED_WEAPON_19	Potrzebuję broni.	
VO_HERO_09a_ERROR_PLAY_27	Nie mogę tego zagrać.	
VO_HERO_09a_ERROR_STEALTH_26	Nie mogę wybrać ukrytych stronników.	
VO_HERO_09a_ERROR_TARGET_28	To nie jest prawidłowy cel.	
VO_HERO_09a_ERROR_TAUNT_29	Na drodze stoi stronnik z Prowokacją.	
VO_HERO_09a_FIRE_FESTIVAL	Wesołego święta Letniego Przesilenia!	
VO_HERO_09a_GREETINGS_03	Niech ci się darzy.	
VO_HERO_09a_HALLOWS_END	Szczęśliwych Zaduszników!	
VO_HERO_09a_HAPPY_HOLIDAYS_52	Szczęśliwej Zimowej Uczty!	
VO_HERO_09a_HAPPY_NEW_YEAR_01	Szczęśliwego Nowego Roku!	
VO_HERO_09a_HAPPY_NEW_YEAR_LUNAR_53	Niech ci się darzy.	
VO_HERO_09a_LOW_CARDS_17	Nie mam już prawie kart.	
VO_HERO_09a_MIRROR_GREETINGS_04	I nawzajem.	
VO_HERO_09a_MIRROR_START_02	Bogini jest moją tarczą.	
VO_HERO_09a_NO_CARDS_18	Skończyły mi się karty!	
VO_HERO_09a_NOBLEGARDEN	Radosnych Miłogrodów.	
VO_HERO_09a_OOPS_08	To błąd.	
VO_HERO_09a_PICKED_11	Bogini wzywa!	
VO_HERO_09a_PIRATE_DAY	Słowo mocy: Arrrrr!	
VO_HERO_09a_SORRY_10	Wybacz mi.	
VO_HERO_09a_START_01	Eluno, daj mi siłę.	
VO_HERO_09a_START_MALFURION	Mój drogi Malfurion!	
VO_HERO_09a_THANKS_09	Dziękuję.	
VO_HERO_09a_THINK1_12	Hmm...	
VO_HERO_09a_THINK2_13	Tak sobie myślę...	
VO_HERO_09a_THINK3_14	Jaka jest wola Eluny...	
VO_HERO_09a_THREATEN_05	Pożałujesz tego!	
VO_HERO_09a_TIMER_16	Pośpiesz się!	
VO_HERO_09a_WELL_PLAYED_07	Niezłe zagranie.	
VO_HERO_09a_WOW_10	Znakomicie!	
VO_HERO_11_HAPPY_NEW_YEAR_20	Szczęśliwego Nowego Roku!	
VO_HERO_12_HAPPY_NEW_YEAR_20	Szczęśliwego Nowego Roku!	
VO_HERO_13_HAPPY_NEW_YEAR_20	Szczęśliwego Nowego Roku!	
VO_HERO_14_HAPPY_NEW_YEAR_20	Szczęśliwego Nowego Roku!	
VO_HERO_15_HAPPY_NEW_YEAR_24	<Szczęśliwego\nNowego Roku!>	
VO_HERO_16_Female_Dryad_Concede_01	Wszystkiego nie wygram.	
VO_HERO_16_Female_Dryad_ERROR_01	Nie mam broni.	
VO_HERO_16_Female_Dryad_ERROR_02	Potrzebuję więcej many.	
VO_HERO_16_Female_Dryad_ERROR_03	Ten stronnik nie może ponownie atakować!	
VO_HERO_16_Female_Dryad_ERROR_04	Już atakowałam.	
VO_HERO_16_Female_Dryad_ERROR_05	Ten stronnik nie może jeszcze atakować.	
VO_HERO_16_Female_Dryad_ERROR_06	Mam za dużo kart!	
VO_HERO_16_Female_Dryad_ERROR_07	Mam zbyt wielu stronników.	
VO_HERO_16_Female_Dryad_ERROR_08	Ten tchórzliwy stronnik się ukrywa.	
VO_HERO_16_Female_Dryad_ERROR_09	Nie mogę tego zrobić.	
VO_HERO_16_Female_Dryad_ERROR_10	To niemożliwe.	
VO_HERO_16_Female_Dryad_ERROR_11	Najpierw muszę zaatakować stronnika z Prowokacją!	
VO_HERO_16_Female_Dryad_ERROR_12	To się nie może stać.	
VO_HERO_16_Female_Dryad_FIRE_FESTIVAL_01	Uwielbiam festiwal ognia!	
VO_HERO_16_Female_Dryad_Greetings_01	Niech natura ci błogosławi.	
VO_HERO_16_Female_Dryad_HAPPY_HALLOWEEN_01	Szczęśliwych Zaduszników!	
VO_HERO_16_Female_Dryad_HAPPY_HOLIDAYS_01	Szczęśliwej Zimowej Uczty!	
VO_HERO_16_Female_Dryad_HAPPY_NEW_YEAR_01	Świętujmy Nowy Rok!	
VO_HERO_16_Female_Dryad_HAPPY_NOBLEGARDEN_01	Wesołych Miłogrodów!	
VO_HERO_16_Female_Dryad_LowCards_01	Kończą mi się karty!	
VO_HERO_16_Female_Dryad_MALFURION_START_01	Ishnu'alah, arcydruidzie.	
VO_HERO_16_Female_Dryad_MIRROR_GREETINGS_01	I nawzajem.	
VO_HERO_16_Female_Dryad_MIRROR_START_01	Za dzikie ziemie!	
VO_HERO_16_Female_Dryad_NoCards_01	Nie mam już kart!	
VO_HERO_16_Female_Dryad_Oops_02	Przeliczyłam się.	
VO_HERO_16_Female_Dryad_PIRATE_DAY_01	Arrr! Będę piratem!	
VO_HERO_16_Female_Dryad_Sorry_01	Muszę za to przeprosić.	
VO_HERO_16_Female_Dryad_Start_01	Las się broni.	
VO_HERO_16_Female_Dryad_Thanks_01	Doceniam twoje wysiłki.	
VO_HERO_16_Female_Dryad_Thinking_01	Zobaczmy...	
VO_HERO_16_Female_Dryad_Thinking_02	A może by tak...	
VO_HERO_16_Female_Dryad_Thinking_03	A gdyby...	
VO_HERO_16_Female_Dryad_Threaten_01	Cierp tak, jak cierpią dzikie ziemie!	
VO_HERO_16_Female_Dryad_Time_01	Czas ucieka.	
VO_HERO_16_Female_Dryad_Well_Played_01	Niezłe zagranie.	
VO_HERO_16_Female_Dryad_WOW_01	To było dzikie!	
VO_HERO_18_Female_Gnome_Concede_01	Nieźle! Tym razem wygrywasz.	
VO_HERO_18_Female_Gnome_ERROR_01	Nie potrzebuję przypadkiem broni?	
VO_HERO_18_Female_Gnome_ERROR_03	Nie mam dość many.	
VO_HERO_18_Female_Gnome_ERROR_04	Już atakowali!	
VO_HERO_18_Female_Gnome_ERROR_06	Nie mogę atakować dwa razy!	
VO_HERO_18_Female_Gnome_ERROR_07	Ciii, wciąż śpią.	
VO_HERO_18_Female_Gnome_ERROR_08	Hola, mam za dużo kart!	
VO_HERO_18_Female_Gnome_ERROR_10	Może być tylko siedmiu stronników.	
VO_HERO_18_Female_Gnome_ERROR_12	Korzystają z Ukrycia!	
VO_HERO_18_Female_Gnome_ERROR_14	Hmpf. Nie mogę tego zrobić.	
VO_HERO_18_Female_Gnome_ERROR_15	Nie mogę wskazać tego celu.	
VO_HERO_18_Female_Gnome_ERROR_17	Przeszkadza nam stronnik z_Prowokacją!	
VO_HERO_18_Female_Gnome_FIRE_FESTIVAL_01	Fajerwerki podczas Letniego Przesilenia są ekstra!	
VO_HERO_18_Female_Gnome_Greetings_01	Czółko!	
VO_HERO_18_Female_Gnome_HAPPY_HALLOWEEN_01	Zaduszniki! Straszne...	
VO_HERO_18_Female_Gnome_HAPPY_HOLIDAYS_01	Szczęśliwej Zimowej Uczty	
VO_HERO_18_Female_Gnome_HAPPY_NEW_YEAR_01	Szczęśliwego Nowego Roku!	
VO_HERO_18_Female_Gnome_HAPPY_NEW_YEAR_LUNAR_16	Szczęśliwego Nowego Roku!	
VO_HERO_18_Female_Gnome_LowCards_01	Kończą mi się karty!	
VO_HERO_18_Female_Gnome_MIRROR_START_01	Tak! Ale będzie czadowo!	
VO_HERO_18_Female_Gnome_NOBLEGARDEN	Uwielbiam Miłogrody!	
VO_HERO_18_Female_Gnome_NoCards_01	Skończyły mi się karty!	
VO_HERO_18_Female_Gnome_Oops_02	Oj!	
VO_HERO_18_Female_Gnome_PIRATE_DAY_01	Arrr! Haha! Będę piratem! ARRR!	
VO_HERO_18_Female_Gnome_Sorry_01	Ahh, wybacz...	
VO_HERO_18_Female_Gnome_Start_01	Zabawmy się! Haha!	
VO_HERO_18_Female_Gnome_Thanks_02	Och, dziękuję!	
VO_HERO_18_Female_Gnome_Thinking_01	Hmmmm…	
VO_HERO_18_Female_Gnome_Thinking_03	Hmmm... tam ti tam tam.	
VO_HERO_18_Female_Gnome_Thinking_04	Ciekawe, czy...	
VO_HERO_18_Female_Gnome_Threaten_01	Byłaby z ciebie słodziutka pacynka.	
VO_HERO_18_Female_Gnome_Time_01	Muszę się pospieszyć!	
VO_HERO_18_Female_Gnome_Well_Played_01	Łaał, dobre zagranie!	
VO_HERO_18_Female_Gnome_WOW_01	Ale czad!	
VO_ICC08_LichKing_Male_Human_YoungArthas_02	Nie znoszę grać ze sobą.	
VO_TBA01_4__Concede	*Warkot*	
VO_TBA01_4__Error_Full_Minions	*Warkot*	
VO_TBA01_4__Error_Generic	*Warkot*	
VO_TBA01_4__Error_Hand_Full	*Warkot*	
VO_TBA01_4__Error_I_Attacked	*Warkot*	
VO_TBA01_4__Error_Just_Played	*Warkot*	
VO_TBA01_4__Error_Minion_Attacked	*Warkot*	
VO_TBA01_4__Error_Need_Mana	*Warkot*	
VO_TBA01_4__Error_Need_Weapon	*Warkot*	
VO_TBA01_4__Error_Play	*Warkot*	
VO_TBA01_4__Error_Stealth	*Warkot*	
VO_TBA01_4__Good_Game	*Warkot*	
VO_TBA01_4__Greetings	Niech rozpocznie się gra!	
VO_TBA01_4__Low_Cards	*Warkot*	
VO_TBA01_4__No_Cards	*Warkot*	
VO_TBA01_4__Oops	Niedobrze!	
VO_TBA01_4__Sorry	Wybacz.	
VO_TBA01_4__Start	Ja tu rządzę!	
VO_TBA01_4__Thanks	Dziękuję.	
VO_TBA01_4__Threaten	Hahahaaa! Patrz! Drżyj! Oto prawdziwa moc NEFARIANA!	
VO_TBA01_4__Timer	*Warkot*	
VO_TBA01_4__Well_Played	Dobre zagranie.	
