TAG	TEXT	COMMENT
ChromaggusBoss_Death_1	Wrrrrrrrrrr!	
ChromaggusBoss_EmoteResponse_1	*Warkot*	
ChromaggusBoss_Start_1	Wrrr!	
GiantRat_LOOTA_BOSS_18h_DefeatPlayer	<Dziwne dźwięki>	
GiantRat_LOOTA_BOSS_18h_EmoteResponse	<Dziwne dźwięki>	
GILA_BOSS_65h_Gobbles_DefeatPlayer	Reeeaaaooo!	
GILA_BOSS_65h_Gobbles_EmoteResponse	Bahauaoowr!	
GILA_BOSS_65h_Gobbles_Intro	Uwaauuoooo!	
LOE_07_MINE_CART_EMOTES	*STUK*	
LOOTA_BOSS_21h_GnoshTheGreatWorm_EmoteResponse	<Ryk>	
LOOTA_BOSS_47h_Lava_FilledRoom_Emote	<Wulkaniczna\nfuria>	
LOOTA_BOSS_52h_TreasureVault_Emote	<Brzdęk>	
OnyxiaBoss_Death_1	Wrrrrrrrrrr!	
OnyxiaBoss_EmoteResponse_1	*Warkot*	
OnyxiaBoss_Start_1	Wrrr!	
POPUP_FROST_BRAWL	Zmęczenie! Ktokolwiek ma więcej zdrowia na koniec następnej tury, wygrywa grę.	
POPUP_FROST_BRAWL_ARMOR	W tej bójce nie można kryć się za pancerzem!	
TheMothergloop_LOOTA_BOSS_24h_EmoteResponse	<Nieprzyzwoite\nodgłosy>	
TrappedRoom_LOOTA_BOSS_48h_EmoteResponse	<Skrzypnięcie>	
VO_Ahune_Male_Elemental_Brawl_01	TAK! ROZBIĆ RAGNAROSA W PYŁ!	
VO_Ahune_Male_Elemental_Brawl_02	NO I KTO TU TERAZ RZĄDZI, OGNISTY PAJACU?!	
VO_Ahune_Male_Elemental_Brawl_03	TO DOPIERO ZEMSTA!	
VO_Ahune_Male_Elemental_Brawl_04	NO I ZA KIM TERAZ GANIAJĄ TŁUMY AWANTURNIKÓW, CO?!	
VO_Ahune_Male_Elemental_Brawl_05	NO I KTO JEST TERAZ ROBAKIEM, PAJACU?!	
VO_Ahune_Male_Elemental_Brawl_07	LODOWIEC SIĘ ROZTOPIŁ!	
VO_Ahune_Male_Elemental_Brawl_08	NO TO KTO SIĘ ZAJMIE TĄ BANDĄ DURNIÓW?	
VO_Ahune_Male_Elemental_Brawl_11	FANTASTYCZNY WYNIK!	
VO_Ahune_Male_Elemental_Brawl_15	RAGNAROS MUSI ZGINĄĆ BARDZIEJ!	
VO_Ahune_Male_Elemental_Brawl_16	OOO! NAPRAWDĘ NIE CIERPISZ RAGNAROSA!	
VO_Aran_Male_Shade_AranCrackle_01	Phi. Za moich czasów Trzask zawsze zadawał sześć punktów obrażeń.	
VO_Aran_Male_Shade_AranDeath_02	Tylko nie znowu...	
VO_Aran_Male_Shade_AranEmoteResponse_01	Poszli stąd!	
VO_Aran_Male_Shade_AranHeroPower_01	Płońcie, łobuzy!	
VO_Aran_Male_Shade_AranMedivhSkin_01	Medivh? Nie, nie zaczepiałem gości...	
VO_Aran_Male_Shade_AranOpen_01	Już ja was nauczę szacunku!	
VO_Aran_Male_Shade_AranSpell_03	Wracajcie w ciemność, gdzie wasze miejsce!	
VO_Aran_Male_Shade_AranSpell_04	Nasz pan jest potężny, a ja także dysponuję mocą!	
VO_Aran_Male_Shade_AranTrons_02	NIE! NIE! Co za hałas! Co za straszliwe powitania!	
VO_Aran_Male_Shade_AranTurn1_01	Żadnej głośnej muzyki w mojej wieży!	
VO_Aran_Male_Shade_AranTurn5_01	Nie jestem jakimś tam błaznem! Jestem Nielas Aran!	
VO_Barnes_Male_Human_FinalNazraTurn5_02	Pomocy! Banany nam się skończyły! Mukla rozniesie spiżarnię na strzępy!	
VO_Barnes_Male_Human_JulianneTurn5_01	Czym jest teatr bez przedstawienia? Czymże przedstawienie bez widowni?	
VO_Barnes_Male_Human_JulianneWin_01	Pierwszy akt zakończony! Zostały jeszcze dwa!	
VO_Barnes_Male_Human_Wing2Intro_02	Witam na naszej scenie! Nazywam się Barnes, inspicjent. Portale do Medivha są piętro wyżej, ale najpierw obejrzyj nasze przedstawienie!	
VO_Barnes_Male_Human_WolfBigMinion_01	Och, babciu. Jakich masz wielkich stronników!	
VO_Barnes_Male_Human_WolfClaws_01	Bez obaw, te ogromne szpony to tylko rekwizyty!	
VO_Barnes_Male_Human_WolfTurn5_01	Uwielbiam udział widowni! Pędź, miły gościu, pędź!	
VO_Barnes_Male_Human_WolfTurn9_01	Ha ha! Wspaniały występ! Wyszło lepiej niż z tym ogrem, którego ganialiśmy w ubiegłym tygodniu.	
VO_Barnes_Male_Human_WolfWin_01	Nareszcie! Wielki finał!	
VO_BigBadWolf_Male_Worgen_WolfBigMinion_01	Aby cię łatwiej zmiażdżyć!	
VO_BigBadWolf_Male_Worgen_WolfDeath_01	Dopadli mnie! Wrrrr!	
VO_BigBadWolf_Male_Worgen_WolfDireWolfAlpha_01	*Parsknięcie*	
VO_BigBadWolf_Male_Worgen_WolfDireWolfAlpha_02	*Skomle*	
VO_BigBadWolf_Male_Worgen_WolfEmoteResponse_01	Mmm... Przepysznie!	
VO_BigBadWolf_Male_Worgen_WolfOpen_01	Uciekaj, dziewczynko, uciekaj!	
VO_BigBadWolf_Male_Worgen_WolfScarletCrusader_01	Dokąd idziesz, czerwony płaszczyku?	
VO_BigBadWolf_Male_Worgen_WolfTurn1_01	Spójrz na swych stronników! Widzisz, jak przede mną truchleją?	
VO_BlackKing_Male_ChessPiece_ChessEmoteGreetings_01	Zawsze.	
VO_BlackKing_Male_ChessPiece_ChessEmoteOops_01	A może pułapka?	
VO_BlackKing_Male_ChessPiece_ChessEmoteSorry_01	Konieczna ofiara.	
VO_BlackKing_Male_ChessPiece_ChessEmoteThanks	Do usług.	
VO_BlackKing_Male_ChessPiece_ChessEmoteThanks_01	Do usług.	
VO_BlackKing_Male_ChessPiece_ChessEmoteThreaten_01	Widzę mata w trzech ruchach.	
VO_BlackKing_Male_ChessPiece_ChessEmoteWellPlayed_01	Jeszcze nie.	
VO_BlackKing_Male_ChessPiece_ChessEmoteWow_01	Naturalnie.	
VO_BlackKing_Male_ChessPiece_ChessOpen_01	Nikt nie przejdzie!	
VO_BOSS_AYA_Female_Pandaren_BC_0_Jade_Golem_02	Więcej golemów? EKSTRA!	
VO_BOSS_AYA_Female_Pandaren_BC_0_Jade_Golem_03	Hi hi hi hi! NAPRZÓD MOJA ARMIO!	
VO_BOSS_AYA_Female_Pandaren_BC_0_Jade_Golem_04	Jeszcze jeden! JESZCZE JEDEN!	
VO_BOSS_AYA_Female_Pandaren_BC_2_1st_Turn_Start_01	Gadżeton będzie mój!	
VO_BOSS_AYA_Female_Pandaren_BC_2_2nd_Turn_Start_01	Gadżeton należy do Nefrytowego Lotosu, a Lotos należy do mnie!	
VO_BOSS_AYA_Female_Pandaren_BC_2_Arms_Dealing1_01	Jeszcze więcej broni, jakie to oryginalne!	
VO_BOSS_AYA_Female_Pandaren_BC_2_Fill1_01	Uuu... To na pewno ci się spodoba!	
VO_BOSS_AYA_Female_Pandaren_BC_2_Fill2_01	Niee, podoba mi się tu! Chyba zostanę na dłużej!	
VO_BOSS_AYA_Female_Pandaren_BC_2_Goons_Win_01	Nie-nie-nie-nie! NIEDOBRZE!	
VO_BOSS_AYA_Female_Pandaren_BC_2_Goons_Winning_02	Może lepiej będzie jeśli SIĘ ZAMKNIESZ!	
VO_BOSS_AYA_Female_Pandaren_BC_2_Jade_Win_01	Nefrytowy Lotos zwycięża po raz kolejny. Jestem najlepsza!	
VO_BOSS_AYA_Female_Pandaren_BC_2_Lotus_Winning_01	Hi hi, graj dalej, graj dalej.	
VO_BOSS_AYA_Female_Pandaren_BC_3_1st_Turn_Start_01	Gadżeton jest obłędny! Musi być mój!	
VO_BOSS_AYA_Female_Pandaren_BC_3_1st_Turn_Start_02	He he he, z miłą chęcią!	
VO_BOSS_AYA_Female_Pandaren_BC_3_2nd_Turn_Start_01	Rety, wszyscy w Konfraterni to taaaacy nudziaaaarze...	
VO_BOSS_AYA_Female_Pandaren_BC_3_Fill1_01	Ładny mamy dzionek, co Kozaczku?	
VO_BOSS_AYA_Female_Pandaren_BC_3_Fill2_01	Ech, jejku, Kozaczku, wyluzuj trochę. Pobaw się.	
VO_BOSS_AYA_Female_Pandaren_BC_3_Jade_Golem3_01	Ha ha ha!	
VO_BOSS_AYA_Female_Pandaren_BC_3_Kabal_Winning_01	Głównie dlatego, że przynudzasz.	
VO_BOSS_AYA_Female_Pandaren_BC_3_Kabal_Wins_01	To niemożliwe! NIENIENIENIE!	
VO_BOSS_AYA_Female_Pandaren_BC_3_Lotus_Winning_01	Ojej, co się stało, Kozaczku? Wyglądasz, jakby ktoś cię obił!	
VO_BOSS_AYA_Female_Pandaren_BC_3_Lotus_Wins_01	Cóż, fajnie było. Dzięki za grę, Kozaczku!	
VO_BOSS_AYA_Female_Pandaren_BC_3_Potion1_02	Ble ble ble mikstury ble ble ble ble, chodź tutaj i WALCZ!	
VO_BOSS_AYA_Female_Pandaren_BC_3_Potion3_01	Fuj! To jest obrzydliwe!	
VO_BOSS_AYA_Female_Pandaren_Concede_01	Eee, nie umiesz się bawić...	
VO_BOSS_AYA_Female_Pandaren_Greetings_01	Hejka!	
VO_BOSS_AYA_Female_Pandaren_Oops_01	Ups!	
VO_BOSS_AYA_Female_Pandaren_START_01	Przygotować golemy!	
VO_BOSS_AYA_Female_Pandaren_Thanks_02	Dziękuję!	
VO_BOSS_AYA_Female_Pandaren_Threaten_02	Hmm. Teraz chyba musisz umrzeć.	
VO_BOSS_AYA_Female_Pandaren_Well_Played_01	To było czadowe!	
VO_BOSS_AYA_Female_Pandaren_Wow_02	Łooo!	
VO_BOSS_CHO_Male_Ogre_BC_1_1st_Turn_Start_01	POSĘPNE ZBIRY CZYNIĄ JĄ NIEBEZPIECZNĄ!	
VO_BOSS_CHO_Male_Ogre_BC_1_Fill2_01	BRAĆ ICH, CHŁOPCY!	
VO_BOSS_CHO_Male_Ogre_BC_2_Fill1_01	DZIEWCZYNA MA OBŁĘD W OCZACH.	
VO_BOSS_CHO_Male_Ogre_Concede_01	ZACZEKAJ! A NIE, PRZEGRAŁEM.	
VO_BOSS_CHO_Male_Ogre_Oops_02	POPEŁNIŁEM BŁĄD.	
VO_BOSS_CHO_Male_Ogre_Thanks_01	DZIĘKI!	
VO_BOSS_HAN_Male_Ogre_BC_0_Arms_Dealing_01	Cosik, eee, spadło z wozu, he he...	
VO_BOSS_HAN_Male_Ogre_BC_0_Arms_Dealing_02	Zbiry, łączcie się!	
VO_BOSS_HAN_Male_Ogre_BC_0_Arms_Dealing_03	Uzbrój tego Zbira i zabierz go stąd!	
VO_BOSS_HAN_Male_Ogre_BC_0_Arms_Dealing_04	Posępne Zbiry trzymają się razem!	
VO_BOSS_HAN_Male_Ogre_BC_1_1st_Turn_Start_01	To niebezpieczna okolica, Kozakusie.	
VO_BOSS_HAN_Male_Ogre_BC_1_2nd_Turn_Start_01	Gadżeton należy do Zbirów, capisce?	
VO_BOSS_HAN_Male_Ogre_BC_1_2nd_Turn_Start_02	Wszystko fajnie, ale Gadżeton należy do Zbirów.	
VO_BOSS_HAN_Male_Ogre_BC_1_Fill1_01	Weź te swoje mikstury i je sobie wsadź.	
VO_BOSS_HAN_Male_Ogre_BC_1_Fill2_01	Hej, Fu, zbierz Zbirów. Trzeba dać nauczkę temu trollowi.	test
VO_BOSS_HAN_Male_Ogre_BC_1_Goons_Win_01	To nic osobistego, Kozakusie. To czysty biznes.	
VO_BOSS_HAN_Male_Ogre_BC_1_Goons_Winning_01	O, wyglądasz, jakbyś miał wypadek, Kozakusie...	
VO_BOSS_HAN_Male_Ogre_BC_1_Kabal_Win_02	To jeszcze... nie... koniec... Kozakusie.	
VO_BOSS_HAN_Male_Ogre_BC_1_Kabal_Winning_02	Heh. Nie najgorzej, staruszku.	
VO_BOSS_HAN_Male_Ogre_BC_1_Potion1_01	A wiesz, nigdy nie przepadałem za miksturami...	
VO_BOSS_HAN_Male_Ogre_BC_1_Potion2_01	Au! Uważaj, gdzie tym rzucasz!	
VO_BOSS_HAN_Male_Ogre_BC_2_1st_Turn_Start_01	Gadżeton jest nasz! Zjeżdżaj, fajfusie!	
VO_BOSS_HAN_Male_Ogre_BC_2_1st_Turn_Start_04	Jako Posępne Zbiry, mamy coś do powiedzenia w tej sprawie...	
VO_BOSS_HAN_Male_Ogre_BC_2_Fill1_01	Nie podoba mi się to spojrzenie, Ayo.	
VO_BOSS_HAN_Male_Ogre_BC_2_Goons_Win_01	Zrób sobie przerwę, Ayo. Hehe. Dobrze ci zrobi.	
VO_BOSS_HAN_Male_Ogre_BC_2_Goons_Winning_01	Może jeszcze raz przemyślisz swoją sytuację?	
VO_BOSS_HAN_Male_Ogre_BC_2_Jade_Golem2_01	Zaczynam naprawdę mieć dość tych Lotosiarzy.	
VO_BOSS_HAN_Male_Ogre_BC_2_Lotus_Win_01	Uch. Gadżeton będzie... nasz...	
VO_BOSS_HAN_Male_Ogre_BC_2_Lotus_Winning_01	Uch, niech ktoś zabierze stąd tę smarkulę!	
VO_BOSS_HAN_Male_Ogre_Concede_01	Wiesz, to wszystko twoja wina.	
VO_BOSS_HAN_Male_Ogre_Greetings_01	Witaj w Gadżetonie, dzieciaku.	
VO_BOSS_HAN_Male_Ogre_INTRO_PACK_OPEN_7	Ho, ho, ho... A cóż to za przystojniak? Hehehe.	
VO_BOSS_HAN_Male_Ogre_Oops_01	Niedobrze.	
VO_BOSS_HAN_Male_Ogre_START_01	Teraz jesteście na naszym terenie!	
VO_BOSS_HAN_Male_Ogre_Thanks_01	Wyświadczasz nam wielką przysługę.	test
VO_BOSS_HAN_Male_Ogre_Threaten_01	Lepiej nie odmawiaj...	
VO_BOSS_HAN_Male_Ogre_Well_Played_02	Muszę powiedzieć, że robisz wrażenie, dzieciaku.	
VO_BOSS_HAN_Male_Ogre_WOW_01	Braaawo!	
VO_BOSS_KAZAKUS_Male_Troll_BC_0_Potion_01	Ach, to było odświeżające.	
VO_BOSS_KAZAKUS_Male_Troll_BC_0_Potion_02	Zbieraj oklep!	
VO_BOSS_KAZAKUS_Male_Troll_BC_0_Potion_04	Do dna... Hahaha!	
VO_BOSS_KAZAKUS_Male_Troll_BC_0_Potion_05	Jak ci to smakuje!?	
VO_BOSS_KAZAKUS_Male_Troll_BC_1_1st_Turn_Start_01	Gadżeton będzie mój, Sze’Fu!	
VO_BOSS_KAZAKUS_Male_Troll_BC_1_2nd_Turn_Start_01	Konfraternia jest wszędzie. Gadżeton się przed nami pokłoni.	
VO_BOSS_KAZAKUS_Male_Troll_BC_1_Arms_Dealing1_01	Phi, tchórzostwo typowe dla Zbirów. PRZESTAŃ SIĘ CHOWAĆ NA RĘCE!	
VO_BOSS_KAZAKUS_Male_Troll_BC_1_Fill1_01	Moja Konfraternia posiada nieograniczoną potęgę.	
VO_BOSS_KAZAKUS_Male_Troll_BC_1_Goons_Win_01	Wrócę tu, potężniejszy niż kiedykolwiek!	
VO_BOSS_KAZAKUS_Male_Troll_BC_1_Goons_Winning_01	Będziesz cierpieć, Sze'Fu!	
VO_BOSS_KAZAKUS_Male_Troll_BC_1_Kabal_Win_01	Mam władzę nad Gadżetonem!	
VO_BOSS_KAZAKUS_Male_Troll_BC_1_Kabal_Winning_01	Twój kres jest bliski, Sze’Fu!	
VO_BOSS_KAZAKUS_Male_Troll_BC_3_1st_Turn_Start_01	Jeśli chcesz, by miasto było twoje musisz mnie najpierw pokonać.	
VO_BOSS_KAZAKUS_Male_Troll_BC_3_Fill1_01	NIE NAZYWAJ MNIE TAK, AROGANCKA DZIEWUCHO!	
VO_BOSS_KAZAKUS_Male_Troll_BC_3_Fill2_01	Pokłoń się przed potęgą Konfraterni!	
VO_BOSS_KAZAKUS_Male_Troll_BC_3_Jade_Golem2_01	Arogancka dziewucho, śmiesz drwić z najpotężniejszego przywódcy w Gadżetonie?!	
VO_BOSS_KAZAKUS_Male_Troll_BC_3_Jade_Golem3_01	Niepokorna dziewucho! Mam już dość tych twoich głupich golemów.	
VO_BOSS_KAZAKUS_Male_Troll_BC_3_Kabal_Winning_01	Wyglądasz na zmęczoną, dziewucho! Hehe!	
VO_BOSS_KAZAKUS_Male_Troll_BC_3_Kabal_Winning_02	Co?! Bezczelny bachor! Będę twoją ZAGŁADĄ!	test
VO_BOSS_KAZAKUS_Male_Troll_BC_3_Kabal_Wins_01	Haha! Kolejny przeciwnik nie może się równać z potęgą Konfraterni!	
VO_BOSS_KAZAKUS_Male_Troll_BC_3_Lotus_Winning_01	Wredny bachor...	
VO_BOSS_KAZAKUS_Male_Troll_BC_3_Lotus_Wins_01	Głupiutka dziewucho, to jeszcze nie koniec!	
VO_BOSS_KAZAKUS_Male_Troll_BC_3_Potion1_01	Poczuj potęgę mikstur Konfraterni!	
VO_BOSS_KAZAKUS_Male_Troll_Concede_01	Te ulice... są... moje...	
VO_BOSS_KAZAKUS_Male_Troll_Greetings_02	Witajcie, głupcy!	test
VO_BOSS_KAZAKUS_Male_Troll_Mirror_Start_01	Sporo umiesz.	
VO_BOSS_KAZAKUS_Male_Troll_Oops_01	Drobna pomyłka...	
VO_BOSS_KAZAKUS_Male_Troll_START_01	Czuję zew many...	
VO_BOSS_KAZAKUS_Male_Troll_Thanks_01	Masz moją wdzięczność, sługo.	
VO_BOSS_KAZAKUS_Male_Troll_Threaten_01	MAM WŁADZĘ NAD GADŻETONEM!	
VO_BOSS_KAZAKUS_Male_Troll_Well_Played_02	Masz ogromny potencjał...	
VO_BOSS_KAZAKUS_Male_Troll_Wow_01	Co za moc!	
VO_BRANN_MITHRIL_ALT_02	Fascynujące. W tych mithrilowych runach zawarty jest kod strażników. Muszą pochodzić z czasów Tytanów!	
VO_BRANN_WIN_07_ALT_07	Zgubiliśmy ich! Nasz skarb jest w następnym pomieszczeniu!	
VO_BRM_027h_Death_63	Nie... NIEEEEE!	
VO_BRMA01_1_CARD_05	No dobra, czas na „gorące przywitanie”!	
VO_BRMA01_1_DEATH_09	Ej, ej. Co się dzieje? Nie podoba mi się, ale nic na to nie poradzę!	
VO_BRMA01_1_ETC_06	A teraz rozrywka na żywo! Oto Elitarny Taureński Czempion!	
VO_BRMA01_1_HERO_POWER_04	Hahahaha! W kupie siła!	
VO_BRMA01_1_RESPONSE_03	Hahaha... hik! Oj, pardonsik!	
VO_BRMA01_1_START_01	Witamy w karczmie pod Ponurym Opojem!	
VO_BRMA01_1_SUCCUBUS_08	Metreso Nagmaro, obsłuż gościa.	
VO_BRMA01_1_TURN1_02	Patrzajcie wszyscy, hahaha! Mamy gościa...	
VO_BRMA01_1_WARGOLEM_07	No, teraz to masz przerąbane! Falango, naprzód!	
VO_BRMA02_1_ALAKIR_34	Oto Władca Żywiołów, który uwielbia strącać muchy: Al’Akir!	
VO_BRMA02_1_ALEXSTRAZA_32	Życiodajna, królowa wszystkich smoków, wojowniczka areny Czarnorytnych... Alexstraza!	
VO_BRMA02_1_BEAST_22	Choć najbardziej gustuje w gnomach, dziś zrobi dla was wyjątek. Oto Bestia!	
VO_BRMA02_1_BOOM_28	Wszyscy opuścić strefę rażenia! Kolejnym zawodnikiem jest Doktor Huk!	
VO_BRMA02_1_CAIRNE_20	Wychowuje swego syna tak, by poszedł w jego ślady. Brawa! Oto KAIRN KRWAWE KOPYTO!	
VO_BRMA02_1_CHO_07	Czas na dobranockę w wykonaniu najmilszego z pandarenów: Wiedziciela Czo!	
VO_BRMA02_1_DEATH_38	Hjt! He? *Śmierć*	
VO_BRMA02_1_DEATHWING_35	Ooooo! Panie i panowie krasnoludy! Jedyny, niepowtarzalny... ŚMIERCIOSKRZYDŁY!	
VO_BRMA02_1_ETC_18	A teraz... Ryczący, mityczny, legendarny... Elitarny Taureński Czempion!	
VO_BRMA02_1_FEUGEN_15	Oklaski dla Feugena!	
VO_BRMA02_1_FOEREAPER_29	Oto wiejski tuning w najbardziej morderczym wydaniu! Dożynkarz 4000!	
VO_BRMA02_1_GEDDON_13	O! Temperatura na Arenie wzrasta! Przed wami: Baron Geddon!	
VO_BRMA02_1_GELBIN_21	Przywitajcie gościa prosto z Nowego Majsterkowa: przywódcę gnomów Gelbina Mekanownika!	
VO_BRMA02_1_GRUUL_31	Nie bez powodu nazywają go „Smokobójcą”! Jedyny w swoim rodzaju... Gruul!	
VO_BRMA02_1_HERO_POWER_05	Publiczność się niecierpliwi! Haha!	
VO_BRMA02_1_HOGGER_27	Swego czasu ten\n11-poziomowy gnol był chodzącą legendą. Przywitajmy Wyżera!	
VO_BRMA02_1_ILLIDAN_23	Kto ma podwójne bojowe glewie, temu niepotrzebne źrenice! Nadciąga Illidan Burzogniewny!	
VO_BRMA02_1_LEVIATHAN_12	Świeżo wyremontowany i gotowy do demolki! Płomienny Lewiatan!	
VO_BRMA02_1_LOATHEB_16	Zatkajcie nosy i powitajcie okropnego, odrażającego, obmierzłego Ohydziarza!	
VO_BRMA02_1_MAEXXNA_24	To wielka pajęczyca! A jak brzmi jej imię? Maexxna!	
VO_BRMA02_1_MILLHOUSE_09	O, litości! A tego kto wpuścił na Arenę?	
VO_BRMA02_1_MOGOR_25	Choć zasób słownictwa ma niewielki, szał jego jest ogromny! Oto Ogr Mogor!	
VO_BRMA02_1_MUKLA_10	A teraz bananowy monarcha we własnej osobie: Król Mukla!	
VO_BRMA02_1_NOZDORMU_36	Panie i pa... oj. Zabrakło czasu!	
VO_BRMA02_1_ONYXIA_33	Przybyła prosto z Pyłowego Bagniska i Zamku w Wichrogrodzie! Przygotuj się do spotkania z Onyxią!	
VO_BRMA02_1_PAGLE_08	Mistrz spinningu Nat Pagle właśnie wrócił z wyprawy na ryby!	
VO_BRMA02_1_RESPONSE_04	Nikt nie jest w stanie pokonać tych wszystkich legend!	
VO_BRMA02_1_SNEED_30	Nasz kolejny zawodnik siedzi za sterami starego szatkownika! Kto to może być?	
VO_BRMA02_1_STALAGG_14	Czy Stalag przetrwa na Arenie? Sprawdźmy!	
VO_BRMA02_1_START_01	Ktoś odważył się podjąć wyzwanie!	
VO_BRMA02_1_SYLVANAS_19	Płonie w niej odwieczna nienawiść – specjalnie dla was. Powitajmy Sylwanę Bieżywiatr!	
VO_BRMA02_1_THALNOS_06	Przywitajmy aplauzem kościotrupa w spódnicy: maga krwi Thalnosa!	
VO_BRMA02_1_THAURISSAN_37	Specjalnie dla was, prosto z następnej misji: Imperator Thaurissan!	
VO_BRMA02_1_TINKMASTER_11	Gromkie brawa dla wielkiego wynalazcy: Nadiskrownika Opiłka!	
VO_BRMA02_1_TOSHLEY_26	Powitajmy ciepło gnoma z odległej krainy. Oklaski dla Toshleya!	
VO_BRMA02_1_TURN1_02	Panie i panowie krasnoludy! Dziś czeka was wyborne przedstawienie!	
VO_BRMA02_1_TURN1_PT2_03	Legendarni bohaterowie z Azeroth kontra... jakiś awanturnik!	
VO_BRMA02_1_VOLJIN_17	Proszę o ciszę! Nadchodzi gość specjalny: wódz Hordy Vol’jin we własnej osobie!	
VO_BRMA03_1_CARD_04	Na potęgę płomiennego Ragnarosa! Mocy... przybywaj!	
VO_BRMA03_1_DEATH_09	Aaaaaaaaaa!	
VO_BRMA03_1_HERO_POWER_06	Giń!	
VO_BRMA03_1_MOIRA_DEATH_05	Nie! Moira! Zapłacisz za to!	
VO_BRMA03_1_RESPONSE_03	Zamknij gębę, bo ja ci ją zamknę!	
VO_BRMA03_1_START_01	Krasnoludy z Czarnorytnych są niezwyciężone!	
VO_BRMA03_1_TURN1_02	Ej! Łapy precz od mej małżonki!	
VO_BRMA03_1_VS_RAG_07	Nie! Ragnaros?! Znowu?	
VO_BRMA04_1_CARD_04	Sługo ognia... naprzód!	
VO_BRMA04_1_DEATH_06	Rrrrrrrrrrrrh!	
VO_BRMA04_1_HERO_POWER_05	Magma!	
VO_BRMA04_1_RESPONSE_03	Kamień bije wszystko.	
VO_BRMA04_1_START_01	Zmiażdżę cię.	
VO_BRMA04_1_TURN1_02	Skały i kamienie.	
VO_BRMA05_1_CARD_05	Czas ucieka, śmiertelniku!	
VO_BRMA05_1_DEATH_04	Ostatnie słowo należy do mnie...	
VO_BRMA05_1_HERO_POWER_06	Płoń!	
VO_BRMA05_1_RESPONSE_03	Armagedon!	
VO_BRMA05_1_START_01	Spłoniesz!	
VO_BRMA05_1_TURN1_02	Ragnaros zmieni cię w popiół!	
VO_BRMA06_1_DEATH_04	Przestań! Poddaję się!	
VO_BRMA06_1_RESPONSE_03	Myślisz, że zwycięstwo jest twoje? Zaraz ci pokażę, jak bardzo się mylisz!	
VO_BRMA06_1_START_01	Żywy Ogień strawi wszystko!	
VO_BRMA06_1_SUMMON_RAG_05	Oto Ragnaros! Był prastarą istotą już u zarania dziejów!	
VO_BRMA06_1_TURN1_02_ALT	Zgładzić ich!	
VO_BRMA06_3_INTRO_01	EGZEKUTUSIE! PRZEBUDZIŁEŚ MNIE PRZEDWCZEŚNIE!	
VO_BRMA06_3_RESPONSE_03	JAKIM PRAWEM OŚMIELACIE SIĘ TU WCHODZIĆ!	
VO_BRMA06_3_TURN1_02	NĘDZNI ŚMIERTELNICY! JAK ŚMIECIE WKRACZAĆ W MOJE KRÓLESTWO?	
VO_BRMA07_1_CARD_04	Czas coś zgnieść!	
VO_BRMA07_1_DEATH_06	Nieeeeeeee!	
VO_BRMA07_1_HERO_POWER_05	Ja zgniatam. Ty giniesz!	
VO_BRMA07_1_RESPONSE_03	Raaar!!! Zgniotę cię!	
VO_BRMA07_1_START_01	Zmiażdżę cię!	
VO_BRMA07_1_TURN1_02	Zmiażdżyć czy zgnieść? Oto jest pytanie!	
VO_BRMA08_1_CARD_05	Jestem obrońcą Iglicy!	
VO_BRMA08_1_DEATH_06	Rrh. Aah! Nieeeeee!	
VO_BRMA08_1_RESPONSE_04	Czemu??? Za co? Przecież tak cię lubiłem.	
VO_BRMA08_1_START_01	A ty co tu robisz!?	
VO_BRMA08_1_TURN1_03	Lordzie Nefarianie! Myślałem, że przysłano kogoś, kto pomógł nam i zgładził Ragnarosa!	
VO_BRMA08_1_TURN1_ALT_02	Jesteś tu, żeby mi pomóc zgładzić śmiertelników?	
VO_BRMA09_1_CARD_05	Iglica należy do nas!	
VO_BRMA09_1_DEATH_11	Aaaaaa!	
VO_BRMA09_1_HERO_POWER1_06	Otwórzcie wrota!	
VO_BRMA09_1_HERO_POWER2_07	Zabić tego na tyłach!	
VO_BRMA09_1_HERO_POWER3_08	Skupcie się na bohaterze, głupcy!	
VO_BRMA09_1_HERO_POWER4_09	Razem jesteśmy niepowstrzymani!	
VO_BRMA09_1_RESPONSE_04	Hahaha!	
VO_BRMA09_1_START_01	To my jesteśmy prawdziwą Hordą!	
VO_BRMA09_1_TURN1_03	Porywasz się na niewłaściwą górę!	
VO_BRMA09_1_TURN1_ALT_02	Nikt nie stanie nam na drodze! Giń!!!	
VO_BRMA10_1_DEATH_08	Rrrrrrrrrrrh!	
VO_BRMA10_1_EGG_DEATH_1_05	Głupcy! Te jaja są cenniejsze, niż wam się wydaje!	
VO_BRMA10_1_EGG_DEATH_2_06	Nie, kolejne rozbite! Zapłacicie mi głową za tę zbrodnię!	
VO_BRMA10_1_EGG_DEATH_3_07	Zapłacicie mi za to!	
VO_BRMA10_1_HERO_POWER_04	Łapy precz od tych jaj!	
VO_BRMA10_1_RESPONSE_03	Już ja cię usadzę!	
VO_BRMA10_1_START_01	Patrz i podziwiaj! Oto splugawione jaja naszego nowego szczepu smoków!	
VO_BRMA10_1_TURN1_02	Te jaja staną się przyczynkiem twojej zguby!	
VO_BRMA11_1_ALEXSTRAZA_07	Życiodajna!!! Pomóż mi!!! Pomocy!!!	
VO_BRMA11_1_CARD_04	W moich żyłach płynie gniew Czarnej Góry!	
VO_BRMA11_1_DEATH_ALT_08	Nareszcie koniec moich męczarni...	
VO_BRMA11_1_HERO_POWER_05	Aaahh! Zniszczenie!	
VO_BRMA11_1_KILL_PLAYER_06	Wybacz mi. Zawiodłem cię.	
VO_BRMA11_1_RESPONSE_03	Trzeba było uciekać zawczasu, śmiertelniku!	
VO_BRMA11_1_START_01	Uciekaj, zanim stracę nad sobą kontrolę!	
VO_BRMA11_1_TURN1_02	Za późno... Splugawienie Nefariana zebrało swe żniwo!	
VO_BRMA13_1_DEATH_ALT_23	Nie! NIEEE! Jeszcze tu wrócę!	
VO_BRMA13_1_DEATHWING_19	TATUŚ???	
VO_BRMA13_1_HP_DRUID_14	Druidzie, dzikie ostępy są teraz moim królestwem!	
VO_BRMA13_1_HP_GENERIC_18	Twoja magia należy do mnie!	
VO_BRMA13_1_HP_HUNTER_12	Łowca staje się zwierzyną!	
VO_BRMA13_1_HP_MAGE_11	Magowie zbyt lekkomyślnie igrają z magią.	
VO_BRMA13_1_HP_PALADIN_07	Paladynie, czyżby światłość cię opuściła?	
VO_BRMA13_1_HP_PRIEST_08	Kapłanie, teraz światłość jest moim sprzymierzeńcem!	
VO_BRMA13_1_HP_ROGUE_15	Przestań się chować w cieniu i stań do walki!	
VO_BRMA13_1_HP_SHAMAN_13	Szamanie, teraz JA władam żywiołami!	
VO_BRMA13_1_HP_WARLOCK_10	Czarnoksiężniku! Igrasz z magią, której nie jesteś w stanie pojąć!	
VO_BRMA13_1_HP_WARRIOR_09	Wojowniku! Siła okaże się twoją słabością!	
VO_BRMA13_1_RESPONSE_05	Ja tu rządzę!	
VO_BRMA13_1_START_01	Witaj w moim prywatnym sanktuarium, bohaterze.	
VO_BRMA13_1_TURN1_PT1_02	Hahahaaa! Patrz! Drżyj! Oto prawdziwa moc NEFARIANA!	
VO_BRMA13_1_TURN1_PT2_03	Nieskończona mana! Pancerne smocze łuski!	
VO_BRMA14_1_CARD_09	Przekierowywanie nadwyżek energii.	
VO_BRMA14_1_DEATH_08	Systemy obronne unicestwione. Wyłączanie awaryjne.	
VO_BRMA14_1_HP1_03	Jednostka Elektron aktywna.	
VO_BRMA14_1_HP2_04	Jednostka Toksytron aktywna.	
VO_BRMA14_1_HP3_05	Jednostka Arkanotron aktywna.	
VO_BRMA14_1_HP4_06	Jednostka Magmatron aktywna.	
VO_BRMA14_1_HP5_07	Jednostka obronna gotowa.	
VO_BRMA14_1_RESPONSE1_10	Bip, pip, bip.	
VO_BRMA14_1_RESPONSE2_11	Nawiązywanie połączenia...	
VO_BRMA14_1_RESPONSE3_12	Połączenie ustanowione. Pobieranie aktualizacji systemu.	
VO_BRMA14_1_RESPONSE4_13	Aktualizacja zainstalowana. Witaj. Witaj. Witaj.	
VO_BRMA14_1_RESPONSE5_14	Witaj. Witaj. Witaj.	
VO_BRMA14_1_START_01	Wykryto intruzję.	
VO_BRMA14_1_TURN1_02	Inicjowanie podstawowej matrycy obronnej.	
VO_BRMA15_1_CARD_05	Moje nieudane eksperymenty doprowadzą do twej zguby!	
VO_BRMA15_1_DEATH_04	Aaaaaaaaaaaa!	
VO_BRMA15_1_HERO_POWER_06	Dolewamy, mieszamy, podgrzewamy!	
VO_BRMA15_1_RESPONSE_03	Nic nie może się zmarnować!	
VO_BRMA15_1_START_01	Nikt nie może mi przeszkodzić.	
VO_BRMA15_1_TURN1_02	Nie mogę pozwolić, żeby mistrz czekał. Nie mogę go znowu zawieść!	
VO_BRMA16_1_CARD_04	Nie ukryjesz się!	
VO_BRMA16_1_DEATH_06	Rrrraaaaaaaah!	
VO_BRMA16_1_GONG1_10	Aaa!!! Ten dźwięk!!!	
VO_BRMA16_1_GONG2_11	Nieee! Byłem tak blisko!	
VO_BRMA16_1_GONG3_12	Moje uszy!	
VO_BRMA16_1_HERO_POWER_05	Zdradzają cię niepewny krok i ta ohydna woń...	
VO_BRMA16_1_RESPONSE_03	Powiedz coś, jestem coraz bliżej!	
VO_BRMA16_1_START_01	Słyszę bicie twego serca!	
VO_BRMA16_1_TRIGGER1_07	Aha! Słyszę cię...	
VO_BRMA16_1_TRIGGER2_08	Słyszę kroki...	
VO_BRMA16_1_TRIGGER3_09	Słyszę bicie twego serca... Nie umkniesz mi!	
VO_BRMA16_1_TURN1_02	Śmierć czai się w ciemności!	
VO_BRMA17_1_CARD_86	Umiesz pływać? A W PŁYNNEJ LAWIE?!	
VO_BRMA17_1_DEATH_97	Aaaaaaaaaa!	
VO_BRMA17_1_DEATH_HEROIC_98	NIEEEEEEEEEEEEE!	
VO_BRMA17_1_DEATHWING_88	TATUŚ???	
VO_BRMA17_1_HERO_POWER_87	Ożywię ich szkielety cienistym płomieniem!	
VO_BRMA17_1_NEF_AIR1_89	Patrz, jak z przestworzy spada na ciebie morze ognia! Na początek tylko 1 punkcik obrażeń.	
VO_BRMA17_1_NEF_AIR2_90	Dwie kule ognia! Spadną na ciebie niczym grom z jasnego nieba!	
VO_BRMA17_1_NEF_AIR3_91	Tym razem wystrzelę tylko jedną kulę ognia. Muszę zgromadzić kilka na WIELKI FINAŁ w ostatniej turze.	
VO_BRMA17_1_NEF_AIR4_92	Oho! Trzy kule ognia! Łap! Lecą!	
VO_BRMA17_1_NEF_AIR5_93	Od tej pory będę rzucał tylko 1 kulę ognia!	
VO_BRMA17_1_NEF_AIR6_94	Żartowałem, haha! CZTERY kule ognia! Hahahaha!	
VO_BRMA17_1_NEF_AIR7_95	Tym razem nie będę ciskał kul ognia, ale przygotuj się...	
VO_BRMA17_1_NEF_AIR8_96	DWADZIEŚCIA KUL OGNIA! BUAHAHAHAHA!!!	
VO_BRMA17_1_RESPONSE_85	Ach ci śmiertelnicy... Tak łatwo ich omamić.	
VO_BRMA17_1_RESURRECT1_82	Utopię cię w morzu ognia!	
VO_BRMA17_1_RESURRECT2_83	Hej, tam na dole! Niespodzianka z góry!	
VO_BRMA17_1_RESURRECT3_84	Patrz i podziwiaj moje ostateczne dzieło! Powstań, siostro! Powstań, Onyxio!	
VO_BRMA17_1_START_78	Udało ci się dotrzeć do wielkiego finału!	
VO_BRMA17_1_TRANSFORM1_80	Starałem się godnie cię ugościć, a ty nie chcesz mi się odwdzięczyć i zginąć!	
VO_BRMA17_1_TRANSFORM2_81	Dosyć tego udawania. Teraz po prostu... CIĘ ZABIJĘ!	
VO_BRMA17_1_TURN1_79	Moje najgenialniejsze dzieło już na ciebie czeka, śmiertelniku!	
VO_COOP02_00	Oczyszczę was z Klątwy Ciała!	
VO_COOP02_02	Pokonajcie razem Trybomistrza Mechazoda, aby wygrać!	
VO_COOP02_ABILITY_05	Zwiększyć szybkość taktowania!	
VO_COOP02_ABILITY_06	Wiedza szkodzi, Wiedzicielu Czo!	
VO_COOP03_01	Ja tu rządzę!	
VO_COOP03_02	Nie! NIEEE! Zniszczę cię!	
VO_COOP03_03	Ach ci śmiertelnicy... Tak łatwo ich omamić.	
VO_COOP03_04	Starałem się godnie cię ugościć, a ty nie chcesz mi się odwdzięczyć i zginąć!	
VO_COOP03_05	Dosyć tego udawania. Teraz po prostu... CIĘ ZABIJĘ!	
VO_COOP03_06	Kapłanie, teraz światłość jest moim sprzymierzeńcem!	
VO_COOP03_07	Szamanie, teraz JA władam żywiołami!	
VO_COOP03_08	Hahahaaa! Patrz! Drżyj! Oto prawdziwa moc NEFARIANA!	
VO_COOP03_09	Udało ci się dotrzeć do wielkiego finału!	
VO_Crone_Female_Troll_CroneDeath_02	Nie! Jeszcze cię dorwę...	
VO_Crone_Female_Troll_CroneEmoteResponse_02	Hahahahaha!	
VO_Crone_Female_Troll_CroneFlyingMonkeys_01	Przyprowadźta mi tę dziewuchę!	
VO_Crone_Female_Troll_CroneHeroPower_02	Hehehehe!	
VO_Crone_Female_Troll_CroneOpen_01	Hehehehe! Uciekajcie, ślicznoty!	
VO_Curator_Male_ArcaneGolem_CuratorArcaneGolem_01	Interesujące. Niesamowite podobieństwo.	
VO_Curator_Male_ArcaneGolem_CuratorBeasts_01	Niniejszy kustosz ma alergię na bestie.	
VO_Curator_Male_ArcaneGolem_CuratorDemons_01	Dla demonów nie ma miejsca w menażerii.	
VO_Curator_Male_ArcaneGolem_CuratorDragons_01	Tylko posprzątaj po swoim smoku.	
VO_Curator_Male_ArcaneGolem_CuratorEmoteResponse_01	Nie można wykonać twojej prośby.	
VO_Curator_Male_ArcaneGolem_CuratorHarrison_02	Wykryto szelmę! Harrison Jones nie ma wstępu.	
VO_Curator_Male_ArcaneGolem_CuratorMechs_01	Zmiana oprogramowania pomocników.	
VO_Curator_Male_ArcaneGolem_CuratorMedivhSkin_01	Fałszywy Medivh. Zdradziły cię rozgorączkowane oczy.	
VO_Curator_Male_ArcaneGolem_CuratorMurlocs_01	Małe rybostwory mają wstęp wolny.	
VO_Curator_Male_ArcaneGolem_CuratorPirates_01	Impreza dla piratów!	
VO_Curator_Male_ArcaneGolem_CuratorReno_02	Wykryto szelmę! Reno Jackson nie ma wstępu.	
VO_Curator_Male_ArcaneGolem_CuratorTurn1_01	Za menażerię odpowiada niniejszy kustosz.	
VO_Curator_Male_ArcaneGolem_CuratorTurn5_01	Proszę przestrzegać regulaminu galerii.	
VO_Curator_Male_ArcaneGolem_CuratorTurn9_01	Goście muszą pozostać w obrębie menażerii.	
VO_Curator_Male_ArcaneGolem_IllhoofKilrekResponse_01	Niniejszy kustosz o to nie dba. Przywoływanie jest zabronione.	
VO_Curator_Male_ArcaneGolem_IllhoofSenseDemons_01	Wykryto wiele demonów.	
VO_Curator_Male_ArcaneGolem_IllhoofTurn1_01	Obrzędy przywołania są zabronione.	
VO_Curator_Male_ArcaneGolem_IllhoofTurn5_01	Obrzędy szkodą okazom. Demon musi przestać.	
VO_Curator_Male_ArcaneGolem_IllhoofWin_01	Niniejszy kustosz dziękuje ci. Menażeria zostanie przywrócona do pierwotnego stanu.	
VO_Curator_Male_ArcaneGolem_NightbaneCorruption_01	Nie! Menażeria nie może paść ofiarą spaczenia!	
VO_Curator_Male_ArcaneGolem_NightbaneTour_01	Smok Pożeracz Nocy. Kiedyś był znany jako Arcanagos, ale nieokiełznana magia spaczyła mu umysł.	
VO_Curator_Male_ArcaneGolem_NightbaneTour_02	Na lewo popiersie Arana, na prawo Latarnia Mocy.	
VO_Curator_Male_ArcaneGolem_NightbaneTurn1_01	Wolnym okazom może się stać krzywda. Trzeba je odstawić do menażerii.	
VO_Curator_Male_ArcaneGolem_NightbaneTurn3_01	Te stworzenia trzeba uratować. Wtedy będziecie mogli iść dalej.	
VO_Curator_Male_ArcaneGolem_NightbaneUnstablePortal_01	Gość musi być delikatny. Ten smok obawia się niestabilnej magii.	
VO_Curator_Male_ArcaneGolem_NightbaneWin_01	Wymagana jest dalsza pomoc.	
VO_Curator_Neither_ArcaneGolem_CuratorDeath_04	Dezaktywacja...	
VO_Curator_Neither_ArcaneGolem_CuratorOpen_01	Nie dotykać eksponatów.	
VO_ELISE_LOE16_ALT_1_FIRST_HALF_02	Kiedy kostur się ładuje, Rafaam jest całkowicie niewrażliwy.	
VO_ELISE_LOE16_ALT_1_SECOND_HALF_03	Po naładowaniu będziemy mieli chwilę na atak, ale trzeba będzie się też zająć przyzwanym przez niego stworem!	
VO_ELISE_WEIRD_DECK_05	Przepraszamy za tę talię. Złożyliśmy ją na turniej w zeszłym roku i od tamtej pory niczego nie zmienialiśmy.	
VO_EMOTE_HERO_TBKTRAF_KT_DRAWING_BOARD	No i cały misterny plan…	
VO_EMOTE_HERO_TBKTRAF_KT_GLOAT	Módl się o litość!	
VO_EMOTE_HERO_TBKTRAF_KT_MINIONS_SERVANTS	Stronnicy, słudzy, żołnierze zimnej ciemności...	
VO_FP1_014t_EnterPlay_01	Teraz TY poczujesz ból!	
VO_FP1_031_Attack_07	Jak owce na rzeź!	
VO_FP1_031_EnterPlay_06	Pochłonie cię Plaga!	
VO_GIL_504_Female_Orc_TUT_LootSelect2_01	Kto śmie zabijać moje drogie potworzątka?	
VO_GIL_504_Female_Orc_TUT_Victory_Generic_01	Pozorne zwycięstwo. Ten las i ja to jedno, niełatwo nas powstrzymać.	
VO_GIL_504_Female_Orc_TUT_Victory1_01	Nie tak łatwo zwyciężyć w Wiedźmim Lesie. Czy pozostałym pójdzie równie dobrze?	
VO_GIL_504_Female_Orc_TUT_Victory2_01	Już dwóch bohaterów pokonało Wiedźmi Las, ale ciągle nie znaleźliście MNIE.	
VO_GIL_504_Female_Orc_TUT_Victory3_01	Jesteś coraz bliżej mnie. Czy ostatni czempion również zatriumfuje?	
VO_GIL_504_Female_Orc_TUT_Victory4_01	Dzisiaj ostateczne starcie. Znajdź mnie w samym sercu lasu i zadrżyj!	
VO_GIL_504_Female_Orc_UI_Monster_Azlina_02	Ach, Azalina. Zagubione biedactwo. Kiedyś się odnajdzie.	
VO_GIL_504_Female_Orc_UI_Monster_Baran_01	Beran miał takie łagodne usposobienie... Ale to jego oczy były mi potrzebne.	
VO_GIL_504_Female_Orc_UI_Monster_Brushwood_Cent_01	Niegdyś był potężnym druidem, ale jego wściekłość łatwo było wykorzystać.	
VO_GIL_504_Female_Orc_UI_Monster_Chupacabran_01	Czupakabran. Ach, jak ciężko musiałam o niego walczyć.	
VO_GIL_504_Female_Orc_UI_Monster_Cragtorr_01	Poznaj wściekłość umęczonej ziemi! Powstań, Kragtorze!	
VO_GIL_504_Female_Orc_UI_Monster_Crowskin_01	Glindo, skończ z nim raz na zawsze. Masz cały kult na jedno skinienie.	
VO_GIL_504_Female_Orc_UI_Monster_DrSezavo_01	Roznosicie paskudną chorobę zwaną życiem. Sezavo ma na nią doskonały lek.	
VO_GIL_504_Female_Orc_UI_Monster_Experiment3C_01	Hmm. A ten to nie wiem skąd się wziął. Serio.	
VO_GIL_504_Female_Orc_UI_Monster_Face_Collector_01	Twoja twarz będzie ozdobą jego kolekcji.	
VO_GIL_504_Female_Orc_UI_Monster_Gnarlroot_01	Pradawne duchy, usłyszcie me wezwanie! Na potęgę lasu, popiół z_nich zostanie.	
VO_GIL_504_Female_Orc_UI_Monster_Griselda_01	Gryzelda zapłaciła za swoje nieposłuszeństwo.	
VO_GIL_504_Female_Orc_UI_Monster_Groddo_01	Mój drogi strażnik bagna... Gdy zostawili mnie na śmierć, on czuwał nade mną.	
VO_GIL_504_Female_Orc_UI_Monster_Grubb_01	Nawet ja nie mogę okiełznać Gbbura.	
VO_GIL_504_Female_Orc_UI_Monster_Grum_01	Umęczona kniejo, przebudź moc listowia. Pozbaw ich domostwa, ziemi oraz zdrowia!	
VO_GIL_504_Female_Orc_UI_Monster_Gustave_01	Gustaw, mój pupilu! Zostaw trochę dla swojej pani.	
VO_GIL_504_Female_Orc_UI_Monster_Hannigul_01	Hanigul oczyścił kiedyś miasto z robactwa. Takiego jak ty.	
VO_GIL_504_Female_Orc_UI_Monster_Havnixx_01	Hav'nix słyszy twoje myśli. Karmi się strachem.	
VO_GIL_504_Female_Orc_UI_Monster_Infinite_Toki_01	Przeklęte, wiecznie kombinujące gnomy. Pora to zakończyć. Swoją drogą… wy się chyba znacie.	
VO_GIL_504_Female_Orc_UI_Monster_Ivan_01	Iwan był kiedyś jednym z was. Teraz jest mój.	
VO_GIL_504_Female_Orc_UI_Monster_Lord_Godfrey_01	Godfrydzie! Uszanuję naszą umowę – ten tutaj jest twój.	
VO_GIL_504_Female_Orc_UI_Monster_Lovers_01	Oto opowieść o miłości. Oto opowieść o duchach. Oto opowieść o twoim końcu.	
VO_GIL_504_Female_Orc_UI_Monster_Mistwraith_01	W ciemności nocy i w mroku lasu szepty odbijają się echem.	
VO_GIL_504_Female_Orc_UI_Monster_Mute_01	Minimum treści. Maksimum śmiertelności.	
VO_GIL_504_Female_Orc_UI_Monster_Niira_01	Nie ma czasu na gierki, Niro. Skończ_to!	
VO_GIL_504_Female_Orc_UI_Monster_Raeth_01	Nie wszyscy Porzuceni opuścili ten las. Niektórzy służą mnie.	
VO_GIL_504_Female_Orc_UI_Monster_Rancel_01	Trucizny Rancela pomogły wypaczyć ten las.	
VO_GIL_504_Female_Orc_UI_Monster_Sazzmi_01	Zostań na chwilę i posłuchaj. Zostań na zawsze.	
VO_GIL_504_Female_Orc_UI_Monster_Sephira_01	Siostry harpie pilnują ładu w moim lesie. Strzeż się ich skrzydeł i_szponów!	
VO_GIL_504_Female_Orc_UI_Monster_Shivers_01	Powstań, kapitanie! Zemsta jest na wyciągnięcie ręki. Oto i ona, szlachetna księżniczka Gilneas.	
VO_GIL_504_Female_Orc_UI_Monster_Shudderwock_01	Dreszczołak! Aż strach spuścić go z łańcucha... Ale jak miło popatrzeć!	
VO_GIL_504_Female_Orc_UI_Monster_Splintergraft_01	Zawyj, stary lesie, konarami czaruj. Szeleść gałęziami, wrogom śmierć podaruj...	
VO_GIL_504_Female_Orc_UI_Monster_Sthara_01	Gilneanie mnie pokochają... jak tylko Szatara ich do tego zmusi.	
VO_GIL_504_Female_Orc_UI_Monster_Vitus_01	Jeden z waszych, odrzucony! W moim lesie znalazł nowy dom...	
VO_GIL_504_Female_Orc_UI_Monster_Wharrgarbl_01	Uwielbiam murloki. Są jak żaby, tylko... mniej zwinne.	
VO_GIL_598_Female_Human_SpecialSylvanas_01	Podła wiedźmo! Zabiłaś mojego brata!	
VO_GIL_692_Male_Worgen_TUT_AdventureSelect_01	Bohaterowie! Kto z was ma na tyle odwagi, by wyruszyć do Wiedźmiego Lasu?	
VO_GIL_692_Male_Worgen_TUT_BossReveal1_01	Straszliwe potwory grasują w lasach wokół Gilneas. Dopadnij je wszystkie.	
VO_GIL_692_Male_Worgen_TUT_BossReveal2_01	Im dalej w las, tym potężniejsze napotkasz potwory.	
VO_GIL_692_Male_Worgen_TUT_BossReveal3_01	Złagata to nieczysta siła, która stoi za_Wiedźmim Lasem. Znajdź ją i_powstrzymaj.	
VO_GIL_692_Male_Worgen_TUT_BossReveal3ALT_01	Te monstra to robota Złagaty. Pokonaj je, a w końcu wpadniemy na jej trop!	
VO_GIL_692_Male_Worgen_TUT_CharacterSelect_01	Cóż za wyborna drużyna. Każdy z was wnosi na pole bitwy coś wyjątkowego.	
VO_GIL_692_Male_Worgen_TUT_Defeat1_01	Jeśli Wiedźmi Las cię zmoże, stracisz utworzoną talię.	
VO_GIL_692_Male_Worgen_TUT_FightBegin1Crowley_01	Crowley! Ustawiaj swoje działo tak, by w pełni wykorzystać jego siłę ognia.	
VO_GIL_692_Male_Worgen_TUT_FightBegin1Shaw_01	Polowanie ruszyło, Szaw. Pamiętaj, że sfora może dać ci przewagę nad przeciwnikami.	
VO_GIL_692_Male_Worgen_TUT_FightBegin1Tess_01	Musisz dać sobie radę sama. Przeszukaj pole bitwy – może znajdziesz przydatne zaklęcia.	
VO_GIL_692_Male_Worgen_TUT_FightBegin1Tess_02	Tylko ty mi zostałaś, Tess. Uważaj na siebie.	
VO_GIL_692_Male_Worgen_TUT_FightBegin1Toki_01	Toki, twoja zdolność manipulacji daje ci wyjątkową przewagę nad resztą.	
VO_GIL_692_Male_Worgen_TUT_FightBegin2_01	Te rzeczy są sprzeczne z naturą. Coś obraca ten las przeciwko nam!	
VO_GIL_692_Male_Worgen_TUT_LootSelect1_01	Rozbudowuj talię, aby móc zapuszczać się coraz głębiej w_Wiedźmi Las.	
VO_GIL_692_Male_Worgen_TUT_LootSelect2_02	Czy to ty za tym wszystkim stoisz, parchata wiedźmo?	
VO_GIL_692_Male_Worgen_TUT_TreasureSelect1_01	Szlachtuj potwory, by zebrać cenne łupy. Wybieraj nagrody rozważnie.	
VO_GIL_692_Male_Worgen_TUT_Victory_Final_01	Stało się! Las się uspokoił, a do naszego miasta na nowo zawitało światło.	
VO_GILA_400h_Male_Human_EVENT_HAGATHA_ALMOSTDEAD_02	Żywcem mnie nie weźmie.	
VO_GILA_400h_Male_Human_EVENT_HAGATHA_INTRO_01	Moje psy coś wywęszyły! Złagata jest tutaj!	
VO_GILA_400h_Male_Human_EVENT_HAGATHA_LOWHEALTH_01	Jest ranna. Idźcie za tropem, pieski.	
VO_GILA_400h_Male_Human_EVENT_HAGATHA_TURN4_01	Mam też psy.	
VO_GILA_400h_Male_Human_EVENT_IVAN_INTRO_01	Byłeś jednym z nas, Iwanie!	
VO_GILA_400h_Male_Human_EVENT_NEMESIS_INTRO_01	W końcu cię wytropiłem, Kruczoskóra!	
VO_GILA_400h_Male_Human_EVENT_NEMESIS_TURN2_01	Jak! Jak mogłaś stanąć po stronie Złagaty?	
VO_GILA_500h3_Female_Human_EVENT_HAGATHA_SUB_IN_01	Ukryjcie się! Dokończę to sama.	
VO_GILA_500h3_Female_Human_EVENT_HAGATHA_TURN2_01	Gilneas stawiło czoła gorszym plagom niż ty, Złagato.	
VO_GILA_500h3_Female_Human_EVENT_HAGATHA_TURN4_01	Odejdź stąd, wiedźmo!	
VO_GILA_500h3_Female_Human_EVENT_HAGATHA_WOUNDED_01	Opuść ten las, a pozwolę ci żyć.	
VO_GILA_500h3_Female_Human_EVENT_IVAN_INTRO_01	Iwan! Zapłacisz za swoje zbrodnie.	
VO_GILA_500h3_Female_Human_EVENT_NEMESIS_INTRO_01	Kapitan Dygot. Myślałam, żeś martwy.	
VO_GILA_500h3_Female_Human_EVENT_NEMESIS_TURN2_01	Dokończę dzieło mego ojca.	
VO_GILA_600h_Male_Worgen_EVENT_HAGATHA_SUB_IN_01	Mam cię na celowniku, Złagato.	
VO_GILA_600h_Male_Worgen_EVENT_HAGATHA_TURN2_01	Ta ziemia należy do Gilneas.	
VO_GILA_600h_Male_Worgen_EVENT_HAGATHA_TURN4_01	JA przynajmniej mam własny lud.	
VO_GILA_600h_Male_Worgen_EVENT_HAGATHA_WOUNDED_01	Spopielę każde drzewo. Po twoim lesie zostanie dziura w ziemi.	
VO_GILA_600h_Male_Worgen_EVENT_IVAN_INTRO_01	Znalazłem cię, zdradliwa glisto!	
VO_GILA_600h_Male_Worgen_EVENT_NEMESIS_INTRO_01	Godfryd, ty zdrajco! Nadszedł czas zapłaty.	
VO_GILA_600h_Male_Worgen_EVENT_NEMESIS_TURN02_01	Ty zgniłeś jeszcze za życia, Godfrydzie.	
VO_GILA_900h_Female_Gnome_EVENT_HAGATHA_ALMOST_DEAD_01	Czas uleczy wszystkie rany.	
VO_GILA_900h_Female_Gnome_EVENT_HAGATHA_SUB_IN_01	Odpocznij sobie, czas na mnie.	
VO_GILA_900h_Female_Gnome_EVENT_HAGATHA_TURN2_01	Poruszyłam niebo i ziemię, żeby cię wykończyć.	
VO_GILA_900h_Female_Gnome_EVENT_HAGATHA_WOUNDED_01	Twój czas dobiega końca, wiedźmo.	
VO_GILA_900h_Female_Gnome_EVENT_IVAN_INTRO_01	Masz przerąbane, Iwan. Wiem, jak to się skończy.	
VO_GILA_900h_Female_Gnome_EVENT_NEMESIS_INTRO_B_01	Czy to już... kiedyś się wydarzyło?	
VO_GILA_900h_Female_Gnome_EVENT_NEMESIS_TURN2_02	Co ona… Co ja… Co my wyrabiamy!?	
VO_GILA_900h_Female_Gnome_EVENT_NEMESIS_TURN6_01	Jesteś z_przyszłości? Która z_nas wygra?	
VO_GILA_BOSS_20h_MangyWolf_DefeatPlayer	Grrroowrooo!	
VO_GILA_BOSS_20h_MangyWolf_Emote	Grrrrrrhhh!	
VO_GILA_BOSS_20h_MangyWolf_Intro	Rwaaaaauuu!	
VO_GILA_BOSS_21h_Rottooth_Emote	Rooooooo!	
VO_GILA_BOSS_21h_Rottooth_Intro	Nrgruhh... HOOOO!	
VO_GILA_BOSS_21h_Rottooth_PlayerDefeat	Huff huff... RoOOoar!	
VO_GILA_BOSS_22h_Male_Undead_Death_01	<Zgon>	
VO_GILA_BOSS_22h_Male_Undead_DefeatPlayer_01	Trafiony, zatopiony.	
VO_GILA_BOSS_22h_Male_Undead_EmoteResponse_01	Gadaj se na zdrowie, zaraz dołączy reszta załogi.	
VO_GILA_BOSS_22h_Male_Undead_EmoteResponseTess_01	Błagaj se Kapitana Dygota, księżniczko!	
VO_GILA_BOSS_22h_Male_Undead_EventPlaysCoin_01	Wiedziałem, że coś tam pobrzękuje!	
VO_GILA_BOSS_22h_Male_Undead_EventPlaysShiv_01	To mi się podoba!	
VO_GILA_BOSS_22h_Male_Undead_Intro_01	Kapitan mówi, że mam cię „zniknąć”!	
VO_GILA_BOSS_22h_Male_Undead_IntroCrowley_01	Ty tu dowodzisz? Opłacalna robota?	
VO_GILA_BOSS_22h_Male_Undead_IntroTess_01	Zalazłaś kapitanowi za skórę, księżniczko.	
VO_GILA_BOSS_23h_Male_Ettin_DefeatPlayer_01	Wygrałem! Haha!\n(<i>A gdzie poleźli stronnicy?</i>)	
VO_GILA_BOSS_23h_Male_Ettin_EmoteResponse_02	Nie lubię cię! I on też!\n(<i>Ja cię lubię tylko ciutkę.</i>)	
VO_GILA_BOSS_23h_Male_Ettin_HeroPower_01	No to ziu!	
VO_GILA_BOSS_23h_Male_Ettin_HeroPower_02	Hop!	
VO_GILA_BOSS_23h_Male_Ettin_HeroPower_03	Hua!	
VO_GILA_BOSS_23h_Male_Ettin_HeroPower_04	I LECIMY!	
VO_GILA_BOSS_23h_Male_Ettin_HeroPower_05	Walimy!	
VO_GILA_BOSS_23h_Male_Ettin_Intro_01	Bedziesz dobrze frunąć!\n(<i>Jak ptaszek!</i>)	
VO_GILA_BOSS_24h_Male_Bogbeast_DefeatPlayer_01	Tonie w bagnie ten, kto wpadnie... Hrrghll.	
VO_GILA_BOSS_24h_Male_Bogbeast_EmoteResponse_01	Bulgoczemy, butwiejemy, bulgoczemy, butwiejemy...	
VO_GILA_BOSS_24h_Male_Bogbeast_EventPlaysSmallMinion_01	Muahahahaha!	
VO_GILA_BOSS_24h_Male_Bogbeast_EventPlaysSmallMinion_02	Muahahaha.	
VO_GILA_BOSS_24h_Male_Bogbeast_EventPlaysSmallMinion_03	Muahahahaha.	
VO_GILA_BOSS_24h_Male_Bogbeast_EventPlaysSmallMinion_04	Błąd. Hrmph.	
VO_GILA_BOSS_24h_Male_Bogbeast_HeroPower_01	Nigdy nie jestem sam.	
VO_GILA_BOSS_24h_Male_Bogbeast_HeroPower_02	W bagnie kryją się tajemnice.	
VO_GILA_BOSS_24h_Male_Bogbeast_HeroPower_04	Popatrz no, co wypłynęło. Hrmph.	
VO_GILA_BOSS_24h_Male_Bogbeast_Intro_01	To MOJE bagno! Hrmrr. Tylko martwi tu mieszkają.	
VO_GILA_BOSS_25h_Male_Dwarf_DefeatPlayerALT_01	Złagata nieźle za ciebie płaci, wiesz?	
VO_GILA_BOSS_25h_Male_Dwarf_EmoteResponse_01	Gadaj zdrów, ja idę na łów.	
VO_GILA_BOSS_25h_Male_Dwarf_EventPlayCompass_01	Kompas, że hej! Chyba se go wezmę.	
VO_GILA_BOSS_25h_Male_Dwarf_EventPlaysSecret_01	Ja też tak potrafię.	
VO_GILA_BOSS_25h_Male_Dwarf_EventPlaysSecret_02	Już widziałem coś takiego.	
VO_GILA_BOSS_25h_Male_Dwarf_EventPlaysSecret_03	Myślisz, że to niezła sztuczka, co?	
VO_GILA_BOSS_25h_Male_Dwarf_EventPlayToolsOfTheTrade_01	Niektóre z tych broni były moje, panienko.	
VO_GILA_BOSS_25h_Male_Dwarf_EventPlayTrapper_01	Gdzie mnie tu, z jakimiś amatorami.	
VO_GILA_BOSS_25h_Male_Dwarf_EventTokiAbility_01	Mówiłem, że ma być bez numerów, gnomko.	
VO_GILA_BOSS_25h_Male_Dwarf_HeroPower_01	Patrz jak leziesz.	
VO_GILA_BOSS_25h_Male_Dwarf_HeroPower_02	Patrz pod nogi. He he.	
VO_GILA_BOSS_25h_Male_Dwarf_HeroPower_03	Jestem zawsze o krok do przodu.	
VO_GILA_BOSS_25h_Male_Dwarf_HeroPower_04	He he. Nigdzie się nie uchowasz.	
VO_GILA_BOSS_25h_Male_Dwarf_Intro_01	Nieźle płacą za twoją głowę.	
VO_GILA_BOSS_25h_Male_Dwarf_IntroDarius_01	Zabrać ci działo, Crowley, i zostaje wydmuszka.	
VO_GILA_BOSS_25h_Male_Dwarf_IntroShaw_01	Nic nas nie łączy, Szaw. Ja nigdy nie staję po przegranej stronie.	
VO_GILA_BOSS_25h_Male_Dwarf_IntroTess_02	Jesteś na mojej liście, Szarogrzywa. A_potem wezmę się za twojego ojczulka!	
VO_GILA_BOSS_25h_Male_Dwarf_IntroToki_01	Tylko bez żadnych takich, gnomko!	
VO_GILA_BOSS_26h_Male_Tauren_Death_01	Moje... gnomy...	
VO_GILA_BOSS_26h_Male_Tauren_DeathToki_01	Cóż za... ironia!	
VO_GILA_BOSS_26h_Male_Tauren_DefeatPlayer_01	Chyba nie zmieścisz się w mojej torbie.	
VO_GILA_BOSS_26h_Male_Tauren_DefeatPlayerToki_01	Nie ma to jak rzadki gnom do kolekcji.	
VO_GILA_BOSS_26h_Male_Tauren_EmoteResponse_01	Moje gnomy, moje!	
VO_GILA_BOSS_26h_Male_Tauren_EmoteResponseToki_01	Hmm... Znowu mi się trafiła gaduła...	
VO_GILA_BOSS_26h_Male_Tauren_EventBurgle_01	Masz tam jakieś gnomy?	
VO_GILA_BOSS_26h_Male_Tauren_EventBurgle_03	Gnom wystaje ci z kieszeni?	
VO_GILA_BOSS_26h_Male_Tauren_EventPlayClockworkAssistant_01	Tandetna podróba.	
VO_GILA_BOSS_26h_Male_Tauren_EventPlayGattlingGunner_01	Ooo, takiego jeszcze nie widziałem.	
VO_GILA_BOSS_26h_Male_Tauren_EventPlaysClockwork_02	Stary model. Niewiele się takich uchowało.	
VO_GILA_BOSS_26h_Male_Tauren_EventPlaysGnome_01	Takiego już mam! ...gdzieś tam.	
VO_GILA_BOSS_26h_Male_Tauren_EventPlaysGnome_02	O, to gratka dla kolekcjonera!	
VO_GILA_BOSS_26h_Male_Tauren_EventPlaysGnome_05	Masz niezły gust.	
VO_GILA_BOSS_26h_Male_Tauren_EventPlaysGnome_06	Chętnie włączę do mojej kolekcji.	
VO_GILA_BOSS_26h_Male_Tauren_EventPlaysLeper_01	Ten to jest dosyć paskudny.	
VO_GILA_BOSS_26h_Male_Tauren_EventPlaysMillhouse_02	Ten to się nigdy nie zamyka!	
VO_GILA_BOSS_26h_Male_Tauren_EventPlaysThermaplugg_02	Kilka gnomów w cenie jednego!	
VO_GILA_BOSS_26h_Male_Tauren_EventSackOfGnomes_01	Już nie pamiętam, co tam powsadzałem.	
VO_GILA_BOSS_26h_Male_Tauren_EventSackOfGnomes_03	Tyle ich mam, że ciężko zliczyć!	
VO_GILA_BOSS_26h_Male_Tauren_EventSackOfGnomes_04	Co my tu mamy.	
VO_GILA_BOSS_26h_Male_Tauren_EventSackOfGnomes_05	To nie są perły mojej kolekcji.	
VO_GILA_BOSS_26h_Male_Tauren_EventSilence_03	Cicho tam...	
VO_GILA_BOSS_26h_Male_Tauren_Intro_02	Chcesz mi zabrać gnomy?	
VO_GILA_BOSS_26h_Male_Tauren_IntroToki_02	O, dołączysz do mojej kolekcji...	
VO_GILA_BOSS_27h_Male_Construct_Death_02	Nareszcie... udało nam się uciec!	
VO_GILA_BOSS_27h_Male_Construct_DefeatPlayer_01	To nie ciebie... chciałem zniszczyć!	
VO_GILA_BOSS_27h_Male_Construct_EmoteResponse_01	Buergh. Wybacz, czasem mi się wymsknie.	
VO_GILA_BOSS_27h_Male_Construct_EventPlayDrBoom_02	Doktor Huk?! Nie zabieraj mnie z powrotem do laboratorium!	
VO_GILA_BOSS_27h_Male_Construct_EventPlaySparePart_01	W laboratorium... było wiele takich części...	
VO_GILA_BOSS_27h_Male_Construct_EventPlayUnstablePortal_01	Laboratorium... w Burzy Otchłani...	
VO_GILA_BOSS_27h_Male_Construct_HeroPowerBeast_02	... jest we mnie bestia...	
VO_GILA_BOSS_27h_Male_Construct_HeroPowerDemon_01	... bezbrzeżna ciemność...	
VO_GILA_BOSS_27h_Male_Construct_HeroPowerDragon_01	... cóż za wspaniałe stworzenie...	
VO_GILA_BOSS_27h_Male_Construct_HeroPowerGeneric_01	... jeszcze jeden...	
VO_GILA_BOSS_27h_Male_Construct_HeroPowerMech_02	... mechaniczne serce!	
VO_GILA_BOSS_27h_Male_Construct_HeroPowerMurloc_01	... daj rybę...	
VO_GILA_BOSS_27h_Male_Construct_HeroPowerPirate_01	... arr...	
VO_GILA_BOSS_27h_Male_Construct_Intro_01	Brlleeaaaggg... Miło m-e-e-e-e.	
VO_GILA_BOSS_29h_Female_Satyr_DefeatPlayer_01	Ten las pulsuje własnym rytmem.	
VO_GILA_BOSS_29h_Female_Satyr_EmoteResponse_01	Onieśmielasz mnie...	
VO_GILA_BOSS_29h_Female_Satyr_EventPlaysEnchantingTune_01	Czy podoba ci się moja melodia?	
VO_GILA_BOSS_29h_Female_Satyr_EventPlaysEnchantingTune_02	Nie możemy się po prostu dogadać?	
VO_GILA_BOSS_29h_Female_Satyr_EventPlaysEnchantingTune_03	Usiądź przy mnie. Nie gryzę, naprawdę!	
VO_GILA_BOSS_29h_Female_Satyr_EventPlaysOldMilitiaHorn_01	Może duecik?	
VO_GILA_BOSS_29h_Female_Satyr_EventPlaysSmallMinion_01	Przeurocze z_ciebie stworzenie.	
VO_GILA_BOSS_29h_Female_Satyr_EventPlaysSmallMinion_02	Jakie urocze stworzenie! Prawie takie jak ja...	
VO_GILA_BOSS_29h_Female_Satyr_EventPlaysSmallMinion_03	Mogłabym cię schrupać!	
VO_GILA_BOSS_29h_Female_Satyr_HeroPower_01	Chodźcie ze mną, maleństwa.	
VO_GILA_BOSS_29h_Female_Satyr_HeroPower_02	Raz, dwa, trzy! Chodźcie i wy!	
VO_GILA_BOSS_29h_Female_Satyr_HeroPower_03	Tędy! No chodźcie. No chodźcie.	
VO_GILA_BOSS_29h_Female_Satyr_HeroPower_04	Podążajcie za moją melodią.	
VO_GILA_BOSS_29h_Female_Satyr_HeroPower_05	Zaopiekuję się wami. Zaufajcie mi!	
VO_GILA_BOSS_29h_Female_Satyr_Intro_01	Nareszcie! Mam słuchaczy.	
VO_GILA_BOSS_30h_Female_Gnome_DefeatPlayer_01	W życiu nie ma nic za darmo, złotko.	
VO_GILA_BOSS_30h_Female_Gnome_EmoteResponse_01	Ooo, teraz już za późno.	
VO_GILA_BOSS_30h_Female_Gnome_EventBloodMagic_01	Takie kruche. Takie delikatne.	
VO_GILA_BOSS_30h_Female_Gnome_EventBloodMagic_02	Weź gryzka.	
VO_GILA_BOSS_30h_Female_Gnome_EventBloodMagic_04	Ciao!	
VO_GILA_BOSS_30h_Female_Gnome_EventBloodMagic_05	Wszyscy są równi wobec mojej magii.	
VO_GILA_BOSS_30h_Female_Gnome_EventBloodMagic_06	Pyszne, prawda?	
VO_GILA_BOSS_30h_Female_Gnome_Intro_01	Może skosztujesz?	
VO_GILA_BOSS_31h_Male_Treant_Death_01	<Zgon>	
VO_GILA_BOSS_31h_Male_Treant_DefeatPlayer_01	Każdy jest mrówką w starciu z drzewem.	
VO_GILA_BOSS_31h_Male_Treant_Emote Response_01	Jak przygniecie cię drzewo, dalej będziesz tak kłapać?	
VO_GILA_BOSS_31h_Male_Treant_HeroPower_01	Zasmakuj wolności.	
VO_GILA_BOSS_31h_Male_Treant_HeroPower_02	Bądź jak drzazga.	
VO_GILA_BOSS_31h_Male_Treant_HeroPower_03	Naprzód, maleństwo.	
VO_GILA_BOSS_31h_Male_Treant_HeroPower_05	Kawałek mnie.	
VO_GILA_BOSS_31h_Male_Treant_Intro_01	Oj, dostaniesz tu z liścia.	
VO_GILA_BOSS_32h_Female_Sprite_Death_01	Też mi zabawa!	
VO_GILA_BOSS_32h_Female_Sprite_DefeatPlayer_01	No weź, pograjmy jeszcze trochę. Ojej. Ups.	
VO_GILA_BOSS_32h_Female_Sprite_EmoteResponse_01	No w porządku. Zagramy w to później!	
VO_GILA_BOSS_32h_Female_Sprite_EventPlaysAoEBuff_01	Nieźle ci idzie!	
VO_GILA_BOSS_32h_Female_Sprite_EventPlaysAoEBuff_02	Widzę, że zasady gry masz opanowane.	
VO_GILA_BOSS_32h_Female_Sprite_EventPlaysBigMinion_01	Ej! Oszukujesz!	
VO_GILA_BOSS_32h_Female_Sprite_EventPlaysBigMinion_02	Łaaaaaał!	
VO_GILA_BOSS_32h_Female_Sprite_HeroPower_01	No dalej, rośnij, rośnij!	
VO_GILA_BOSS_32h_Female_Sprite_HeroPower_02	No jeszcze trochę, dawaj!	
VO_GILA_BOSS_32h_Female_Sprite_HeroPower_03	No w górę, w górę - jeszcze trochę!	
VO_GILA_BOSS_32h_Female_Sprite_HeroPower_04	Niahaha, coś mi mówi, że wygrywam!	
VO_GILA_BOSS_32h_Female_Sprite_Intro_01	Chcesz w coś zagrać?	
VO_GILA_BOSS_33h_Male_Mech_Attack_01	Zaczynajmy.	
VO_GILA_BOSS_33h_Male_Mech_Death_01	Błąd krytyczny...	
VO_GILA_BOSS_33h_Male_Mech_DefeatPlayer_01	Błąd: nie wykryto celu. Powrót do trybu patrolowania.	
VO_GILA_BOSS_33h_Male_Mech_EmoteResponse_01	Tryb kosiarza zainicjowany.	
VO_GILA_BOSS_33h_Male_Mech_EventPlayHarvestGolem_01	Uwaga: cel nie ma duszy.	
VO_GILA_BOSS_33h_Male_Mech_EventWeaponKill_01	Zebrano plony.	
VO_GILA_BOSS_33h_Male_Mech_EventWeaponKill_02	Zutylizowano jednostkę.	
VO_GILA_BOSS_33h_Male_Mech_EventWeaponKill_03	Usunięto przeciwnika.	
VO_GILA_BOSS_33h_Male_Mech_HeroPower_01	Rozpoczęto żniwa.	
VO_GILA_BOSS_33h_Male_Mech_HeroPower_02	Zebrano pożywienie.	
VO_GILA_BOSS_33h_Male_Mech_HeroPower_03	Uzupełniono zasoby.	
VO_GILA_BOSS_33h_Male_Mech_HeroPower_04	Poddano recyklingowi.	
VO_GILA_BOSS_33h_Male_Mech_Intro_01	Aktywacja żniw.	
VO_GILA_BOSS_34h_Male_Demon_DefeatPlayer_01	Twoja dusza jest... potężna! Bedę ucztować tygodniami!	
VO_GILA_BOSS_34h_Male_Demon_EmoteResponse_01	Oby twoja dusza okazała się mniej... gadatliwa.	
VO_GILA_BOSS_34h_Male_Demon_HeroPower_01	Delicje...	
VO_GILA_BOSS_34h_Male_Demon_HeroPower_02	Prawdziwy przysmak.	
VO_GILA_BOSS_34h_Male_Demon_HeroPower_03	Wyglądasz nieco blado.	
VO_GILA_BOSS_34h_Male_Demon_HeroPower_04	Niech no zdejmę ten ciężar z twoich barków.	
VO_GILA_BOSS_34h_Male_Demon_HeroPower_05	Dusza to potworne brzemię.	
VO_GILA_BOSS_34h_Male_Demon_Intro_01	Wkrótce zostanie po tobie pusta powłoka.	
VO_GILA_BOSS_35h_Male_Beast_DefeatPlayer	Aaagheaa!	
VO_GILA_BOSS_35h_Male_Beast_EmoteResponse	Aoor aagh harahrahgh!	
VO_GILA_BOSS_35h_Male_Beast_Intro	Rrghaghaogh!	
VO_GILA_BOSS_36h_Female_Human_Death_01	Ożeż kum kum!	
VO_GILA_BOSS_36h_Female_Human_DefeatPlayer_01	Księciem to ty nie jesteś!	
VO_GILA_BOSS_36h_Female_Human_Emote Response_01	Koniec gadki szmatki. Dawaj całusa, dziubeńku!	
VO_GILA_BOSS_36h_Female_Human_EventHex_01	Ojejku! Jestem... zauroczona!	
VO_GILA_BOSS_36h_Female_Human_EventHex_02	Ahh. Wiem jak to jest.	
VO_GILA_BOSS_36h_Female_Human_HeroPower_01	Buuuzi. Mmmmm.	
VO_GILA_BOSS_36h_Female_Human_HeroPower_02	<Buziak>	
VO_GILA_BOSS_36h_Female_Human_HeroPower_03	Mua!	
VO_GILA_BOSS_36h_Female_Human_Intro_01	O nie, znowu to samo.	
VO_GILA_BOSS_37h_Male_Murloc_DefeatPlayer_01	...	
VO_GILA_BOSS_37h_Male_Murloc_EmoteResponse_01	…!	
VO_GILA_BOSS_37h_Male_Murloc_EventPlayMurlocHolmes_02	…? …!	
VO_GILA_BOSS_37h_Male_Murloc_EventPlayPlague_01	…!	
VO_GILA_BOSS_37h_Male_Murloc_EventPlayPlague_02	…!	
VO_GILA_BOSS_37h_Male_Murloc_EventPlayPlague_07	…!	
VO_GILA_BOSS_37h_Male_Murloc_HeroPower_01	…	
VO_GILA_BOSS_37h_Male_Murloc_HeroPower_02	…	
VO_GILA_BOSS_37h_Male_Murloc_HeroPower_03	…!	
VO_GILA_BOSS_37h_Male_Murloc_HeroPower_04	…	
VO_GILA_BOSS_37h_Male_Murloc_Intro_01	…	
VO_GILA_BOSS_38h_Male_Goblin_Death_01	Nigdy... już.	
VO_GILA_BOSS_38h_Male_Goblin_DefeatPlayer_01	Kruk zakrakał. Kraaa.	
VO_GILA_BOSS_38h_Male_Goblin_EmoteResponse_01	Tak nie przywołasz żadnego ptaka!	
VO_GILA_BOSS_38h_Male_Goblin_EventBirdDead_01	Ty... ty potworze!	
VO_GILA_BOSS_38h_Male_Goblin_EventBirdDead_02	Zrobił ci co ten ptaszek?!	
VO_GILA_BOSS_38h_Male_Goblin_EventBirdDead_03	Eeoo. Dlaczego?! To tylko ptaki!	
VO_GILA_BOSS_38h_Male_Goblin_EventPlayBird_01	Leć, zakosztuj wolności!	
VO_GILA_BOSS_38h_Male_Goblin_EventPlayBird_02	Ptak jak malowany!	
VO_GILA_BOSS_38h_Male_Goblin_EventPlayBird_03	No kto jest ślicznym ptaszkiem?	
VO_GILA_BOSS_38h_Male_Goblin_EventPlayBird_04	Czasem chciałbym być ptakiem.	
VO_GILA_BOSS_38h_Male_Goblin_EventPlayerPlayBird_01	Piękne stworzenie.	
VO_GILA_BOSS_38h_Male_Goblin_EventPlayerPlayBird_02	Walczę w ptasiej sprawie!	
VO_GILA_BOSS_38h_Male_Goblin_EventPlayNestingRoc_01	Tego tu... nie chciałem przyzwać.	
VO_GILA_BOSS_38h_Male_Goblin_EventPlayNestingRoc_02	Ech... No niby też ptak.	
VO_GILA_BOSS_38h_Male_Goblin_HeroPower_01	Kraa! Kraa!	
VO_GILA_BOSS_38h_Male_Goblin_HeroPower_02	Kraaa!	
VO_GILA_BOSS_38h_Male_Goblin_HeroPower_03	Kraa! Kraa! Kraa!	
VO_GILA_BOSS_38h_Male_Goblin_Intro_01	Ach, być wolnym jak ptak!	
VO_GILA_BOSS_40h_Female_Treant_Death_01	Drzewo padło!	
VO_GILA_BOSS_40h_Female_Treant_DefeatPlayer_01	To dopiero początek mojej wycinki.	
VO_GILA_BOSS_40h_Female_Treant_EmoteResponse_01	Ciachu. Ciachu!	
VO_GILA_BOSS_40h_Female_Treant_EventPlaysAxe_01	Tak wielu z nas ściętych w kwiecie wieku.	
VO_GILA_BOSS_40h_Female_Treant_EventPlaysAxe_02	Jak wiele musimy jeszcze wycierpieć?	
VO_GILA_BOSS_40h_Female_Treant_EventPlaysWoodsmansAxe_01	Ohydztwo.	
VO_GILA_BOSS_40h_Female_Treant_HeroPower_01	Las upomina się o swoje.	
VO_GILA_BOSS_40h_Female_Treant_HeroPower_02	Ten las ma duszę.	
VO_GILA_BOSS_40h_Female_Treant_HeroPower_03	Nadszedł nasz czas.	
VO_GILA_BOSS_40h_Female_Treant_HeroPower_04	Poznasz smak naszej nienawiści.	
VO_GILA_BOSS_40h_Female_Treant_Intro_01	Zapłacisz za zbrodnie swego ludu.	
VO_GILA_BOSS_41h_Female_HumanGhost_Death_01	Mój ukochany...	
VO_GILA_BOSS_41h_Female_HumanGhost_DefeatPlayer_01	Nic nas nie rozdzieli.	
VO_GILA_BOSS_41h_Female_HumanGhost_EmoteResponse_01	Zostaw nas w spokoju.	
VO_GILA_BOSS_41h_Female_HumanGhost_EventFatigue_01	Ukochany, gdzie się podziałeś!?	
VO_GILA_BOSS_41h_Female_HumanGhost_EventFatigue_02	Nie czuję już jego obecności...	
VO_GILA_BOSS_41h_Female_HumanGhost_EventFatigueDeath_01	Czy nareszcie... jesteśmy wolni? Dziękuję ci!	
VO_GILA_BOSS_41h_Female_HumanGhost_EventPlayRin_01	Czy to ona nas wyzwoli?	
VO_GILA_BOSS_41h_Female_HumanGhost_EventShuffle_01	Ty… nas rozumiesz, prawda?	
VO_GILA_BOSS_41h_Female_HumanGhost_EventShuffle_02	Razem… po wsze czasy.	
VO_GILA_BOSS_41h_Female_HumanGhost_EventShuffle_03	Jesteś jak my.	
VO_GILA_BOSS_41h_Female_HumanGhost_HeroPower_01	Nigdy nie odpuszczę.	
VO_GILA_BOSS_41h_Female_HumanGhost_HeroPower_02	Wróć do mnie! Wróć do mnie!	
VO_GILA_BOSS_41h_Female_HumanGhost_HeroPower_03	Nie odchodź!	
VO_GILA_BOSS_41h_Female_HumanGhost_HeroPower_04	Na zawsze będziesz blisko.	
VO_GILA_BOSS_41h_Female_HumanGhost_Intro_01	Wkrótce znów będziemy razem, ukochany.	
VO_GILA_BOSS_41h_Male_NightElf_Death_01	Nie...	
VO_GILA_BOSS_41h_Male_NightElf_DefeatPlayer_01	Nie przydasz się w Wiedźmim Lesie.	
VO_GILA_BOSS_41h_Male_NightElf_EmoteResponse_02	Twoje słowa mnie nie zwiodą.	
VO_GILA_BOSS_41h_Male_NightElf_EventHack_01	Czterdzieści uderzeń!	
VO_GILA_BOSS_41h_Male_NightElf_EventHack_02	Pomsta.	
VO_GILA_BOSS_41h_Male_NightElf_EventHack_03	Uciekaj… z tego… lasu!	
VO_GILA_BOSS_41h_Male_NightElf_HeroPower_01	Zwyciężą najsilniejsi!	
VO_GILA_BOSS_41h_Male_NightElf_HeroPower_02	Korzeniem i_łodygą.	
VO_GILA_BOSS_41h_Male_NightElf_HeroPower_03	Poddaj próbie swą siłę!	
VO_GILA_BOSS_41h_Male_NightElf_HeroPower_04	Poradź sobie.	
VO_GILA_BOSS_41h_Male_NightElf_Intro_01	Zawróć, intruzie.	
VO_GILA_BOSS_42h_Male_Ogre_DefeatPlayer_01	No i widzisz? Bo ja nie.	
VO_GILA_BOSS_42h_Male_Ogre_EmoteResponse_01	Ty gadaj, ja deptam!	
VO_GILA_BOSS_42h_Male_Ogre_EventHeroPowerEnemy_01	A masz!	
VO_GILA_BOSS_42h_Male_Ogre_EventHeroPowerEnemy_02	Pac!	
VO_GILA_BOSS_42h_Male_Ogre_EventHeroPowerEnemy_03	Zawsze w cel!	
VO_GILA_BOSS_42h_Male_Ogre_EventHeroPowerFriendly_01	Eee… coś nie wyszło.	
VO_GILA_BOSS_42h_Male_Ogre_EventHeroPowerFriendly_02	He he hee, coś tu chrupło.	
VO_GILA_BOSS_42h_Male_Ogre_Intro_01	E… kto tam? Czuję nosem!	
VO_GILA_BOSS_43h_Male_HumanGhost_DefeatPlayer_01	Aaaaee. No to kopiemy.	
VO_GILA_BOSS_43h_Male_HumanGhost_EmoteResponse_01	Wracaj do domu.	
VO_GILA_BOSS_43h_Male_HumanGhost_EventPlaysDeathrattle_01	Najpierw agonia, potem grób.	
VO_GILA_BOSS_43h_Male_HumanGhost_EventPlaysDeathrattle_02	Nawet trupy snują opowieści.	
VO_GILA_BOSS_43h_Male_HumanGhost_EventPlaysDeathrattle_03	Dostrzegam między nami podobieństwo.	
VO_GILA_BOSS_43h_Male_HumanGhost_EventPlaysDeathrattle_04	Właź do trumny. Znajdziesz spokój.	
VO_GILA_BOSS_43h_Male_HumanGhost_EventPlaysDeathrattle_05	Dla tego stronnika będzie płytki grób.	
VO_GILA_BOSS_43h_Male_HumanGhost_EventPlayStrokeOfMidnight_01	Jakże tęskniłem za biciem dzwonów.	
VO_GILA_BOSS_43h_Male_HumanGhost_Intro_01	Lepiej nie wychodzić po zmroku.	
VO_GILA_BOSS_44h_Male_Troll_Death_01	<Zgon>	
VO_GILA_BOSS_44h_Male_Troll_DefeatPlayer_02	Lepiej zapobiegać niż zdechnąć!	
VO_GILA_BOSS_44h_Male_Troll_EmoteResponse_01	Doktorek zawsze ma rację.	
VO_GILA_BOSS_44h_Male_Troll_EventHeals_01	Aaaa...	
VO_GILA_BOSS_44h_Male_Troll_EventHeals_02	Dobre to było.	
VO_GILA_BOSS_44h_Male_Troll_EventHeals_04	Hahahahaha! Hmmm...	
VO_GILA_BOSS_44h_Male_Troll_EventPlayerHeals_03	Ej, wszystko ci się pokićkało.	
VO_GILA_BOSS_44h_Male_Troll_EventPlayerHeals_04	Ja się tym zajmę.	
VO_GILA_BOSS_44h_Male_Troll_EventPlaysBandages_01	Profesjonalna robota!	
VO_GILA_BOSS_44h_Male_Troll_HeroPower_01	Może tycio cię dziabnąć.	
VO_GILA_BOSS_44h_Male_Troll_HeroPower_02	Boisz się igieł? Ha ha... Jak wszyscy.	
VO_GILA_BOSS_44h_Male_Troll_HeroPower_03	Szybko i bezboleśnie. Tak jakby.	
VO_GILA_BOSS_44h_Male_Troll_HeroPower_04	Pseudomedycyna? Wypraszam sobie!	
VO_GILA_BOSS_44h_Male_Troll_HeroPower_05	Fajno. No i pięknie.	
VO_GILA_BOSS_44h_Male_Troll_HeroPower_06	Może trochę zapiec.	
VO_GILA_BOSS_44h_Male_Troll_Intro_01	Wejdź! Usiądź se! Pokaż, gdzie ma zaboleć.	
VO_GILA_BOSS_45h_Female_Human_Death_02	<Zgon>	
VO_GILA_BOSS_45h_Female_Human_DefeatPlayer_01	A byłby z ciebie taki wartościowy nabytek.	
VO_GILA_BOSS_45h_Female_Human_EmoteResponse_01	Porozmawiajmy o tym. Najlepiej przy drinku.	
VO_GILA_BOSS_45h_Female_Human_EventDrawsExtraCards_01	Tak... Pijmy!	
VO_GILA_BOSS_45h_Female_Human_EventDrawsExtraCards_02	Jak ci smakuje?	
VO_GILA_BOSS_45h_Female_Human_EventDrawsExtraCards_03	Pij do dna. No dalej.	
VO_GILA_BOSS_45h_Female_Human_EventFirstDamage_01	To znaczy, że się nie przyłączysz?	
VO_GILA_BOSS_45h_Female_Human_EventPlayHallowedWater_01	Uświęcona woda? Ble, nigdy jej nie znosiłam.	
VO_GILA_BOSS_45h_Female_Human_EventPlaysAcolyte_01	O... Ten mi się podoba.	
VO_GILA_BOSS_45h_Female_Human_EventPlaysHoarder_01	Napijesz się, jak sobie pójdzie.	
VO_GILA_BOSS_45h_Female_Human_EventPlaysNovice_01	Nadciąga świeża nowicjuszka. Uczcijmy jej przybycie!	
VO_GILA_BOSS_45h_Female_Human_Intro_01	Z nami nie wygrasz. Ale możesz dołączyć.	
VO_GILA_BOSS_46h_Male_Worgen_DefeatPlayer_01	Przeżyją najsilniejsi.	
VO_GILA_BOSS_46h_Male_Worgen_EmoteResponse_01	To cuchnie twój strach. Czujesz?	
VO_GILA_BOSS_46h_Male_Worgen_EventPlayBloodMoon_01	AUUUUUU!	
VO_GILA_BOSS_46h_Male_Worgen_EventPlaysWorgen_01	Żałosne.	
VO_GILA_BOSS_46h_Male_Worgen_EventPlaysWorgen_03	Słabeusz.	
VO_GILA_BOSS_46h_Male_Worgen_EventPlaysWorgen_06	Jesteś niczym.	
VO_GILA_BOSS_46h_Male_Worgen_EventPlayTrapper_02	Otwórz się na wściekłość!	
VO_GILA_BOSS_46h_Male_Worgen_Intro_01	Ciągle chcesz mnie upolować?	
VO_GILA_BOSS_47h_Male_Monster_Death_01	Coś buchło... i jest truchło!	
VO_GILA_BOSS_47h_Male_Monster_DefeatPlayer_01	Bohater zgubiony to las wzmocniony.	
VO_GILA_BOSS_47h_Male_Monster_EmoteResponse_01	Gada, beczy to stworzenie, będzie z niego pożywienie!	
VO_GILA_BOSS_47h_Male_Monster_HeroPower_01	Szast i prast jeszcze raz!	
VO_GILA_BOSS_47h_Male_Monster_HeroPower_02	Przyjmij razy na dwa razy.	
VO_GILA_BOSS_47h_Male_Monster_HeroPower_03	I cup, i łup! I raz, i dwa!	
VO_GILA_BOSS_47h_Male_Monster_IntroALT_01	Po cóż idziesz w las przeklęty? Tam Dreszczołak czyha zawzięty.	
VO_GILA_BOSS_48h_Female_Gnome_Death_01	To cię zaboli bardziej... niż mnie!	
VO_GILA_BOSS_48h_Female_Gnome_DefeatPlayer_01	No i po MNIE. Chwileczkę – czy to paradoks?	
VO_GILA_BOSS_48h_Female_Gnome_EmoteResponse_01	Wiedziałam, że to powiem.	
VO_GILA_BOSS_48h_Female_Gnome_EventAlt_01	Nie! Robimy to jeszcze raz.	
VO_GILA_BOSS_48h_Female_Gnome_EventAlt_02	To chyba szło jakoś... tak!	
VO_GILA_BOSS_48h_Female_Gnome_EventAlt_03	Stop! Przewijamy.	
VO_GILA_BOSS_48h_Female_Gnome_EventPlayerAltTime_01	A to nowość.	
VO_GILA_BOSS_48h_Female_Gnome_EventPlayerAltTime_02	Łał, naprawdę zamotałyśmy linię czasową.	
VO_GILA_BOSS_48h_Female_Gnome_EventPlayerTimeWarp_01	Strasznie się wszystko zamotało.	
VO_GILA_BOSS_48h_Female_Gnome_EventPlayerTimeWarp_02	Uwaga na przyszłość: lepiej unikać tej walki.	
VO_GILA_BOSS_48h_Female_Gnome_EventPlayerTimeWarpToki_01	Chwila, nie powinnaś tego jeszcze umieć!	
VO_GILA_BOSS_48h_Female_Gnome_EventPlayerTimeWarpToki_02	Pamiętam, jak to robiłam ostatnim razem!	
VO_GILA_BOSS_48h_Female_Gnome_EventTimeWarp_01	Za parę lat się tego nauczysz.	
VO_GILA_BOSS_48h_Female_Gnome_EventTimeWarp_02	Ciężko było to opanować.	
VO_GILA_BOSS_48h_Female_Gnome_EventTurn2_01	Muszę się powstrzymać! Zanim będzie za późno!	
VO_GILA_BOSS_48h_Female_Gnome_EventTurn4_01	Nie ma szans, żebyś wygrała! Pamiętam każde moje posunięcie!	
VO_GILA_BOSS_48h_Female_Gnome_EventTurn6_01	Obie pożałujemy tego, co zaraz zrobisz. Chyba że cię powstrzymam!	
VO_GILA_BOSS_48h_Female_Gnome_HeroPower_01	Czas trochę przyspieszyć!	
VO_GILA_BOSS_48h_Female_Gnome_HeroPower_02	Tik-tak, tik-tak!	
VO_GILA_BOSS_48h_Female_Gnome_HeroPower_03	Załatwmy to w końcu.	
VO_GILA_BOSS_48h_Female_Gnome_Intro_01	Aa, znowu się spotykamy! Po raz pierwszy!	
VO_GILA_BOSS_48h_Female_Gnome_Intro_02	Znowu ja? Walczymy już drugi raz.	
VO_GILA_BOSS_48h_Female_Gnome_Intro_03	To nasza trzecia walka. Poddaj się wreszcie!	
VO_GILA_BOSS_48h_Female_Gnome_Intro_04	Ciągle... wracasz! Daj już spokój!	
VO_GILA_BOSS_48h_Female_Gnome_Intro_05	Ile jeszcze razy mamy się tak bawić?	
VO_GILA_BOSS_48h_Female_Gnome_PlayerHeroPower_01	Czemu uznałam, że to był dobry pomysł?	
VO_GILA_BOSS_48h_Female_Gnome_PlayerHeroPower_02	A kiedyś miałam się za taką mądrą.	
VO_GILA_BOSS_48h_Female_Gnome_PlayerHeroPower_03	Znowu to?!	
VO_GILA_BOSS_48h_Female_Gnome_PlayerHeroPower_04	NAPRAWDĘ działam sobie na nerwy.	
VO_GILA_BOSS_49h_Female_Undead_Death_01	Zgniłe... serce...	
VO_GILA_BOSS_49h_Female_Undead_DefeatPlayer_01	Trzeba było do nas dołączyć...	
VO_GILA_BOSS_49h_Female_Undead_EmoteResponse_01	Dołącz do naszego kultu. W piątki mamy bingo z wyjątkowymi nagrodami.	
VO_GILA_BOSS_49h_Female_Undead_EventFaithfulDies_01	Chciałam zrobić użytek z tego stronnika!	
VO_GILA_BOSS_49h_Female_Undead_EventFaithfulDies_02	Kontrolowanie umysłów to ciężka sprawa.	
VO_GILA_BOSS_49h_Female_Undead_EventFaithfulDies_03	Nie zapomnę cię... jak ci tam było!	
VO_GILA_BOSS_49h_Female_Undead_EventPact_01	Dołącz do nas...	
VO_GILA_BOSS_49h_Female_Undead_EventPact_02	Znów ktoś do nas dołącza!	
VO_GILA_BOSS_49h_Female_Undead_EventPact_03	Tak, chodź do mnie...	
VO_GILA_BOSS_49h_Female_Undead_EventPact_05	Mój kult rośnie w siłę.	
VO_GILA_BOSS_49h_Female_Undead_EventPlayBird_01	Smoczy kieł\ni kolec róży!\nSowi lot\ni ogon szczurzy!	
VO_GILA_BOSS_49h_Female_Undead_EventPlayCauldron_01	Dalej! żwawo! Hasa! Hej! Buchaj, ogniu! Kotle, wrzej!	
VO_GILA_BOSS_49h_Female_Undead_EventPlayDragon_01	Łuska smocza i ząb wilka, korzeńcowych ziaren kilka.	
VO_GILA_BOSS_49h_Female_Undead_EventPlayFaithful_01	Chodźcie, moje dzieci.	
VO_GILA_BOSS_49h_Female_Undead_EventPlayFaithful_02	Zbliżcie się, wierni...	
VO_GILA_BOSS_49h_Female_Undead_EventPlayFaithful_03	Daj mi swoje życie.	
VO_GILA_BOSS_49h_Female_Undead_EventPlayFaithful_04	Moi drodzy poplecznicy.	
VO_GILA_BOSS_49h_Female_Undead_EventPlayFaithful_05	Ukorz się ostatni raz!	
VO_GILA_BOSS_49h_Female_Undead_EventPlayHex_01	Żabie oko, łapki jeża, mgiełka i puch nietoperza.	
VO_GILA_BOSS_49h_Female_Undead_EventPlaySnake_01	Węża truciciela szczęka niech w ukropie tym rozmięka.	
VO_GILA_BOSS_49h_Female_Undead_EventPlayTreant_01	By zaś zakląć duchy wszelkie, wrzuć do kotła gałąź z sękiem.	
VO_GILA_BOSS_49h_Female_Undead_EventTurn02_01	Gdybyś tylko znał jej potęgę, kładłbyś uszy po sobie jak te twoje kundle.	
VO_GILA_BOSS_49h_Female_Undead_Intro_02	Wytropiłeś... Uehyhyhyhy. Raczej dałeś się zwabić.	
VO_GILA_BOSS_50h_Male_Spirit_DefeatPlayer_01	Lepiej się wypalić niż rozpłynąć w powietrzu...	
VO_GILA_BOSS_50h_Male_Spirit_EmoteResponse_01	Oddychaj...	
VO_GILA_BOSS_50h_Male_Spirit_EventPlaysEcho_01	Tak...	
VO_GILA_BOSS_50h_Male_Spirit_EventPlaysEcho_02	Jeszcze raz...	
VO_GILA_BOSS_50h_Male_Spirit_EventPlaysEcho_03	Więcej...!	
VO_GILA_BOSS_50h_Male_Spirit_EventPlaysEcho_04	Hahahahahaha	
VO_GILA_BOSS_50h_Male_Spirit_Intro_01	Mgła wzywa...	
VO_GILA_BOSS_51h_Male_Undead_Death_01	<Zgon>	
VO_GILA_BOSS_51h_Male_Undead_DefeatPlayer_01	Pozwolisz, że zaopiekuję się twoim tragicznie osieroconym złotem?	
VO_GILA_BOSS_51h_Male_Undead_EmoteResponse_01	Zawrzyj gębę.	
VO_GILA_BOSS_51h_Male_Undead_EventPlayCoinPouch_01	No już, dawaj to.	
VO_GILA_BOSS_51h_Male_Undead_EventPlayMinion_01	Hej! A podatek gdzie?	
VO_GILA_BOSS_51h_Male_Undead_EventPlayMinion_03	Słono za to zapłacisz.	
VO_GILA_BOSS_51h_Male_Undead_EventPlayMinion_04	Zapłacisz za to. I to niedługo.	
VO_GILA_BOSS_51h_Male_Undead_HeroPower_01	Kropla w morzu.	
VO_GILA_BOSS_51h_Male_Undead_HeroPower_02	Długi trzeba spłacać.	
VO_GILA_BOSS_51h_Male_Undead_HeroPower_03	Cóż za szkoda.	
VO_GILA_BOSS_51h_Male_Undead_HeroPower_04	Pokaż, co masz w kieszeniach.	
VO_GILA_BOSS_51h_Male_Undead_Intro_01	Wyglądasz mi na dłużnika.	
VO_GILA_BOSS_52h_Male_Human_DefeatPlayerALT_02	Za nic nie wrócę do więźnia! Nie dzisiaj!	
VO_GILA_BOSS_52h_Male_Human_EmoteResponse_02	Nie ma co tam zaglądać, tylko dym i popiół. Hehe.	
VO_GILA_BOSS_52h_Male_Human_EventPlayRoyalGift_02	Oooo, błyskotka! Położyłbym na tym łapy.	
VO_GILA_BOSS_52h_Male_Human_EventPlayStealth_02	Podwójne standardy!	
VO_GILA_BOSS_52h_Male_Human_EventPlayStealth_03	I niby skradanie ze MNIE czyni złodzieja.	
VO_GILA_BOSS_52h_Male_Human_EventTransform_01	Przegięła się pała goryczy...	
VO_GILA_BOSS_52h_Male_Human_HeroPower_01	Nikt nic nie widzi!	
VO_GILA_BOSS_52h_Male_Human_HeroPower_02	Kto się skrada? Ja się skradam? Gdzie tam…	
VO_GILA_BOSS_52h_Male_Human_HeroPower_03	Jak tak patrzę, to mnie widać. A jak tak, to już nie.	
VO_GILA_BOSS_52h_Male_Human_HeroPower_04	Ociupinka sadzy.	
VO_GILA_BOSS_52h_Male_Human_HeroPower_05	Moc, aż się kurzy!	
VO_GILA_BOSS_52h_Male_Human_IntroALT_02	Włamywacz?! Że niby ja? Ależ skąd...	
VO_GILA_BOSS_52h2_Male_Worgen_EmoteResponse_02	No i popatrz, do czego mnie zmuszasz!	
VO_GILA_BOSS_52h2_Male_Worgen_HeroPower_01	AUUUUUU!	
VO_GILA_BOSS_52h2_Male_Worgen_HeroPower_02	Na nich!	
VO_GILA_BOSS_52h2_Male_Worgen_HeroPower_03	Obudź w sobie bestię!	
VO_GILA_BOSS_54h_Male_Golem_DefeatPlayer_01	Został proch i pył.	
VO_GILA_BOSS_54h_Male_Golem_EmoteResponse_01	Nie rusza mnie to.	
VO_GILA_BOSS_54h_Male_Golem_HeroPower_01	Wszyscy staną się częścią lasu.	
VO_GILA_BOSS_54h_Male_Golem_HeroPower_02	Wiedźmi Las pochłonie wszystko.	
VO_GILA_BOSS_54h_Male_Golem_HeroPower_03	Niechaj ziemia przyjmie nasiona.	
VO_GILA_BOSS_54h_Male_Golem_HeroPower_04	Uścisk Złagaty daje nam siłę.	
VO_GILA_BOSS_54h_Male_Golem_HeroPower_05	Niechaj dokona się wola Złagaty.	
VO_GILA_BOSS_54h_Male_Golem_Intro_01	Kamień wprost się toczy, po drodze nie zboczy.	
VO_GILA_BOSS_55h_Female_NightElf_Death_01	Któż je ocali?	
VO_GILA_BOSS_55h_Female_NightElf_DefeatPlayer_01	Już dobrze. Poprowadzę twoją duszę w bezpieczne miejsce...	
VO_GILA_BOSS_55h_Female_NightElf_EmoteResponse_01	Ciiii. Nie przy ognikach!	
VO_GILA_BOSS_55h_Female_NightElf_EventAssimilation_01	Wszystko co twoje, i nam przynależy. I_będzie nasze.	
VO_GILA_BOSS_55h_Female_NightElf_EventAssimilation_02	Chcę dostać ich ciała!	
VO_GILA_BOSS_55h_Female_NightElf_EventAssimilation_03	Oto nasza szansa!	
VO_GILA_BOSS_55h_Female_NightElf_EventKillsWisp_02	Nie!	
VO_GILA_BOSS_55h_Female_NightElf_EventKillsWisp_03	Przestań!	
VO_GILA_BOSS_55h_Female_NightElf_EventKillsWisp_04	Moje dzieci!	
VO_GILA_BOSS_55h_Female_NightElf_EventPlayCartographer_01	To kartografka! Na pewno wie, jak się stąd wydostać.	
VO_GILA_BOSS_55h_Female_NightElf_EventPlayCompass_01	Może kompas wskaże nam drogę do domu!	
VO_GILA_BOSS_55h_Female_NightElf_HeroPower_01	Chodźcie, dzieci.	
VO_GILA_BOSS_55h_Female_NightElf_HeroPower_02	Aaa, tutaj jesteście.	
VO_GILA_BOSS_55h_Female_NightElf_HeroPower_03	No pokażcie się, śmiało...	
VO_GILA_BOSS_55h_Female_NightElf_Intro_01	Klątwa Złagaty pożera wszystko. Muszę ocalić moje dzieci!	
VO_GILA_BOSS_56h_Male_Elemental_DefeatPlayer_01	Skąd ten smutek na twarzy? Cóż zrobić.	
VO_GILA_BOSS_56h_Male_Elemental_EmoteResponse_01	Sam bym tego lepiej nie ujął.	
VO_GILA_BOSS_56h_Male_Elemental_EventTransformFace_02	Ooo, idealna maska.	
VO_GILA_BOSS_56h_Male_Elemental_HeroPower_01	Nowa maska, nowa twarz.	
VO_GILA_BOSS_56h_Male_Elemental_HeroPower_02	Nowa twarz, nowy ja.	
VO_GILA_BOSS_56h_Male_Elemental_HeroPower_03	Nowy ja, nowe życie.	
VO_GILA_BOSS_56h_Male_Elemental_HeroPower_05	Ciągła zmiana, ciągła przemiana.	
VO_GILA_BOSS_56h_Male_Elemental_HeroPower_07	W nas jeden i wszyscy.	
VO_GILA_BOSS_56h_Male_Elemental_HeroPower_09	Pamiętasz w ogóle, kim jesteś?	
VO_GILA_BOSS_56h_Male_Elemental_HeroPower_10	Maska to wszystko, czego mi trzeba.	
VO_GILA_BOSS_56h_Male_Elemental_IntroALT_02	Ty i ja tak bardzo się nie różnimy.	
VO_GILA_BOSS_57h_Male_Undead_DefeatPlayer_01	Jeszcze tu wrócisz jak nadejdzie pora.	
VO_GILA_BOSS_57h_Male_Undead_EmoteResponse_01	Przekażę twoje pozdrowienia Mrocznej Pani.	
VO_GILA_BOSS_57h_Male_Undead_EventDesecrate_01	Niech pochłonie cię zaraza.	
VO_GILA_BOSS_57h_Male_Undead_EventDesecrate_02	Szykuję dół.	
VO_GILA_BOSS_57h_Male_Undead_EventDesecrate_03	Zaraza przejdzie dalej.	
VO_GILA_BOSS_57h_Male_Undead_EventDesecrate_04	Wkrótce dołączysz do reszty.	
VO_GILA_BOSS_57h_Male_Undead_EventPlayHolyBook_01	Święte księgi cię nie uratują.	
VO_GILA_BOSS_57h_Male_Undead_EventShallowGraves_01	Powstań!	
VO_GILA_BOSS_57h_Male_Undead_EventShallowGraves_02	Powróć!	
VO_GILA_BOSS_57h_Male_Undead_EventShallowGraves_03	Mroczna Pani wzywa!	
VO_GILA_BOSS_57h_Male_Undead_HeroPower_01	Profanacja.	
VO_GILA_BOSS_57h_Male_Undead_HeroPower_02	Mięso armatnie.	
VO_GILA_BOSS_57h_Male_Undead_HeroPower_03	Wdychaj miazmaty.	
VO_GILA_BOSS_57h_Male_Undead_HeroPower_04	Coraz więcej zepsucia.	
VO_GILA_BOSS_57h_Male_Undead_Intro_01	Witaj! Pokażę ci, co tam odkopałem.	
VO_GILA_BOSS_58h_Male_Giant_Death_01	<Zgon>	
VO_GILA_BOSS_58h_Male_Giant_DefeatPlayer_01	Dobre miasteczko. DO DEPTANIA!	
VO_GILA_BOSS_58h_Male_Giant_DefeatPlayer_02	Rozruszam to miasteczko!	
VO_GILA_BOSS_58h_Male_Giant_EmoteResponse_01	Zara ci depne!	
VO_GILA_BOSS_58h_Male_Giant_EventBigWeapon_01	Ty też miażdżysz?!	
VO_GILA_BOSS_58h_Male_Giant_EventMinionReturn_01	Tu jesteś!	
VO_GILA_BOSS_58h_Male_Giant_EventMinionReturn_02	Ktoś tu wrócił!	
VO_GILA_BOSS_58h_Male_Giant_EventMinionReturn_03	To znowu ty.	
VO_GILA_BOSS_58h_Male_Giant_HeroPower_01	Uciekaaaaać!	
VO_GILA_BOSS_58h_Male_Giant_HeroPower_02	Uch... BUUU!	
VO_GILA_BOSS_58h_Male_Giant_HeroPower_03	Huhuhu. Gdzie się chowasz...?	
VO_GILA_BOSS_58h_Male_Giant_HeroPower_04	Stał płotek, ale podeptał Gniotek! Buahahaha!	
VO_GILA_BOSS_58h_Male_Giant_HeroPower_05	Możesz uciekać i... MOŻESZ się schować?	
VO_GILA_BOSS_58h_Male_Giant_Intro_01	Taaaaaa, miażdzyć!	
VO_GILA_BOSS_59h_Male_Undead_DefeatPlayer_01	A jednak zwykły z ciebie kundel.	
VO_GILA_BOSS_59h_Male_Undead_DefeatPlayer_02	Bywaj, stary druhu.	
VO_GILA_BOSS_59h_Male_Undead_DefeatPlayer_03	Ktoś taki miałby położyć mi kres? Żenujące.	
VO_GILA_BOSS_59h_Male_Undead_EmoteResponse_01	Przychodzisz z działem na dżentelmeński pojedynek?\nI kto tu jest tchórzem?	
VO_GILA_BOSS_59h_Male_Undead_EventDeadlyShot_01	Strzał w dziesiątkę!	
VO_GILA_BOSS_59h_Male_Undead_EventDeadlyShot_02	No co? To zabójstwo z litości.	
VO_GILA_BOSS_59h_Male_Undead_EventQuickShot_01	Chowam parę asów w rękawie.	
VO_GILA_BOSS_59h_Male_Undead_EventQuickShot_02	Pif-paf. Hahahahaha.	
VO_GILA_BOSS_59h_Male_Undead_EventTurn02_01	Mówiłem Szarogrzywemu, żeby dał ci zgnić w tym więzieniu.	
VO_GILA_BOSS_59h_Male_Undead_HeroPowerKills_01	Jak stare, dobre czasy.	
VO_GILA_BOSS_59h_Male_Undead_HeroPowerKills_02	Zapomniałem, jakie to uczucie!	
VO_GILA_BOSS_59h_Male_Undead_HeroPowerKills_03	Ahahahahahahaha!	
VO_GILA_BOSS_59h_Male_Undead_HeroPowerKills_04	Ahahahaha. Uwielbiam patrzeć, jak płonie świat.	
VO_GILA_BOSS_59h_Male_Undead_HeroPowerKills_05	Gdybym mógł tak urządzić każdego worgena!	
VO_GILA_BOSS_59h_Male_Undead_Intro_01	Twoja wyprawa zakończy się cierpieniem!	
VO_GILA_BOSS_59h_Male_Undead_IntroCrowley_01	Śmiesz pouczać MNIE o lojalności, Crowley?	
VO_GILA_BOSS_60h_Male_HumanGhost_Death_02	Marynarz... za burtą...	
VO_GILA_BOSS_60h_Male_HumanGhost_DefeatPlayer_01	Witaj na pokładzie. Już tu zostaniesz! Ghehehehehehe!	
VO_GILA_BOSS_60h_Male_HumanGhost_EmoteResponseTess_01	Mam nadzieję, że wierzysz w historie o duchach, panienko. Jesteś w jednej z nich.	
VO_GILA_BOSS_60h_Male_HumanGhost_EventBigWeapon_01	Ostra jak brzytwa.	
VO_GILA_BOSS_60h_Male_HumanGhost_EventBigWeapon_02	Co za ślicznotka.	
VO_GILA_BOSS_60h_Male_HumanGhost_EventBigWeapon_03	Widział kto taką urodną klingę?	
VO_GILA_BOSS_60h_Male_HumanGhost_EventPlayerKingsblade_01	Co? Musisz mieć podróbę!	
VO_GILA_BOSS_60h_Male_HumanGhost_EventPlayKingsblade_01	Przemierzyłem cały świat, by znaleźć tę ślicznotkę.	
VO_GILA_BOSS_60h_Male_HumanGhost_EventPlayKingsblade_02	Zawsze do mnie wraca.	
VO_GILA_BOSS_60h_Male_HumanGhost_EventPlayKragg_02	Zamieniłeś morze na przestworza? Dureń z ciebie.	
VO_GILA_BOSS_60h_Male_HumanGhost_EventPlayPatches_02	Toż to Kaprawe Oczko! Nie miałeś aby więcej oczu?	
VO_GILA_BOSS_60h_Male_HumanGhost_EventPlayTuskarrRaider_01	Kiedyś, żeby być piratem trzeba było się wykazać. Tfu.	
VO_GILA_BOSS_60h_Male_HumanGhost_EventTurn2_01	Jak wcielę cię do mojej załogi\nto dopiero będzie zemsta!	
VO_GILA_BOSS_60h_Male_HumanGhost_HeroPower_01	Moje ostrze do mnie śpiewa, a ja odpowiadam!	
VO_GILA_BOSS_60h_Male_HumanGhost_HeroPower_07	Pokonamy fale!	
VO_GILA_BOSS_60h_Male_HumanGhost_IntroTess_01	A niech mnie! To królewska córka we własnej osobie.	
VO_GILA_BOSS_61h_Female_Orc_DefeatPlayer_01	Ten las i ja jesteśmy jednością. Nigdy nie zginę.	
VO_GILA_BOSS_61h_Female_Orc_EmoteResponse_01	Spójrz w swoje odbicie, a zobaczysz, kto przyniesie ci zgubę.	
VO_GILA_BOSS_61h_Female_Orc_EmoteResponseCrowley_01	Leczysz jakieś kompleksy, Crowley? Hmmm?	
VO_GILA_BOSS_61h_Female_Orc_EmoteResponseShaw_01	Ciągłe wycie i ujadanie. Nauczyłeś się od swoich psów?	
VO_GILA_BOSS_61h_Female_Orc_EmoteResponseTess_01	Czy twoi rodzice mieli też dzieci, które kochali?	
VO_GILA_BOSS_61h_Female_Orc_EmoteResponseToki_01	Jak udało ci się umknąć przed Gnomokradem?	
VO_GILA_BOSS_61h_Female_Orc_EventCannonKill_01	Rzucam klątwę na to działo!	
VO_GILA_BOSS_61h_Female_Orc_EventCannonKill_02	Jesteś głośny. Ale niezbyt mądry.	
VO_GILA_BOSS_61h_Female_Orc_EventCannonKill_03	Ciało gnije, a żelazo rdzewieje.	
VO_GILA_BOSS_61h_Female_Orc_EventCannonKill_04	Głośno szczekasz, kundlu.	
VO_GILA_BOSS_61h_Female_Orc_EventCrowleyHagathaLow_01	Dopóki żyje ten las, żyję i ja...	
VO_GILA_BOSS_61h_Female_Orc_EventCrowleyLow_01	Pogrzebię cię z twoim działem, Crowley.	
VO_GILA_BOSS_61h_Female_Orc_EventCrowleyTurn2_01	Porzuciliście tę ziemię! Ja ją przejęłam!	
VO_GILA_BOSS_61h_Female_Orc_EventCrowleyTurn4_01	Nawet własny lud ma cię za wyrzutka.	
VO_GILA_BOSS_61h_Female_Orc_EventShawHoundKill_01	Zły pies.	
VO_GILA_BOSS_61h_Female_Orc_EventShawHoundKill_02	Zawszone kundle.	
VO_GILA_BOSS_61h_Female_Orc_EventShawLow_01	Dopadła cię klątwa Wiedźmiego Lasu.	
VO_GILA_BOSS_61h_Female_Orc_EventShawTurn2_01	Wszystkie stworzenia w tym lesie są moje...	
VO_GILA_BOSS_61h_Female_Orc_EventShawTurn2_02	Gdy tylko poczują mój dotyk.	
VO_GILA_BOSS_61h_Female_Orc_EventShawTurn4_01	Masz przeciwko sobie tysiące mrocznych duchów.	
VO_GILA_BOSS_61h_Female_Orc_EventSummonCrowskin_01	Mój kult nigdy nie umrze.	
VO_GILA_BOSS_61h_Female_Orc_EventSummonGodfrey_01	Godfrydzie, duchy tego lasu znów cię wzywają...	
VO_GILA_BOSS_61h_Female_Orc_EventTessHagathaLow_01	Ja i ten las to jedno.	
VO_GILA_BOSS_61h_Female_Orc_EventTessLow_01	Twoje szczątki nakarmią ten las.	
VO_GILA_BOSS_61h_Female_Orc_EventTessScavenges_01	Nic ci nie pomoże.	
VO_GILA_BOSS_61h_Female_Orc_EventTessScavenges_02	Szukaj dalej, księżniczko.	
VO_GILA_BOSS_61h_Female_Orc_EventTessScavenges_03	Grzebiesz w_śmieciach. Szlachetnie…	
VO_GILA_BOSS_61h_Female_Orc_EventTessScavenges_04	Nie znajdziesz ratunku wśród tych szpargałów.	
VO_GILA_BOSS_61h_Female_Orc_EventTessTurn2_01	Ten las pochłonie twoje miasto.	
VO_GILA_BOSS_61h_Female_Orc_EventTessTurn4_01	Ta ziemia była MARTWA! Przywróciłam ją do życia. Jest MOJA!	
VO_GILA_BOSS_61h_Female_Orc_EventTokiHagathaLow_01	Duchy lasu wezmą mnie w opiekę...	
VO_GILA_BOSS_61h_Female_Orc_EventTokiHeroPower_01	... co tu się stało?	
VO_GILA_BOSS_61h_Female_Orc_EventTokiHeroPower_03	Pozwalasz sobie na zbyt dużo.	
VO_GILA_BOSS_61h_Female_Orc_EventTokiHeroPower_04	Duchy widzą, co robisz.	
VO_GILA_BOSS_61h_Female_Orc_EventTokiHeroPower_05	Pewnego dnia zapłacisz za swoje sztuczki.	
VO_GILA_BOSS_61h_Female_Orc_EventTokiLow_01	Skończyły ci się sztuczki, gnomko.	
VO_GILA_BOSS_61h_Female_Orc_EventTokiTurn2_01	I tak jesteś takim samym dziwadłem jak ja, gnomko.	
VO_GILA_BOSS_61h_Female_Orc_EventTokiTurn4_01	Sądzisz, że twoich machinacji nie widać? Ja widzę wszystko.	
VO_GILA_BOSS_61h_Female_Orc_Intro_01	Jestem bijącym sercem tego lasu.	
VO_GILA_BOSS_61h_Female_Orc_IntroCrowley_01	Błoga cisza zapadnie, gdy w końcu uciszę to działo.	
VO_GILA_BOSS_61h_Female_Orc_IntroShaw_01	Twoje kundle zwrócą się przeciwko swemu panu.	
VO_GILA_BOSS_61h_Female_Orc_IntroTess_01	Lepiej zawróć, „księżniczko”. Powiedz ojcu, że nadzieja umarła.	
VO_GILA_BOSS_61h_Female_Orc_IntroToki_01	Zmieniasz swój los, ale drzewa i gwiazdy wszystko pamiętają.	
VO_GILA_BOSS_62h_GustaveTheGutRipper_Emote	Oooooorrrrgh!	
VO_GILA_BOSS_62h_GustaveTheGutRipper_Intro	Whrraaaaa!	
VO_GILA_BOSS_62h_GustaveTheGutRipper_PlayerDefeat	Mragrararuh!	
VO_GILA_BOSS_63h_Female_Harpy_Death_01	Moje... jaja!	
VO_GILA_BOSS_63h_Female_Harpy_DefeatPlayer_01	Siostry! Przynieście truchło do mojego gniazda.	
VO_GILA_BOSS_63h_Female_Harpy_EmoteResponse_01	Dalsza rozmowa na tym etapie zaburza dynamikę naszej relacji.	
VO_GILA_BOSS_63h_Female_Harpy_HeroPower_01	Moje!	
VO_GILA_BOSS_63h_Female_Harpy_HeroPower_02	Twoja magia tylko nasyca ten las mrokiem.	
VO_GILA_BOSS_63h_Female_Harpy_HeroPower_03	Rosnę w siłę, nie widzisz?	
VO_GILA_BOSS_63h_Female_Harpy_Intro_01	Dalej nie pójdziesz. Tako rzecze Złagata!	
VO_GILA_BOSS_64h_Male_Goblin_Death_01	Ch-chwila!	
VO_GILA_BOSS_64h_Male_Goblin_DefeatPlayer_01	Dziękuję, dziękuję! A co do mojej gaży...	
VO_GILA_BOSS_64h_Male_Goblin_EmoteResponse_01	Zawsze cieszy udział publiczności.	
VO_GILA_BOSS_64h_Male_Goblin_EvenPlayCursedCurio_01	Coś niesamowitego! Gdzie mogę takie dostać?	
VO_GILA_BOSS_64h_Male_Goblin_EventMCTech_01	Hej! To moja sztuczka!	
VO_GILA_BOSS_64h_Male_Goblin_EventMindControl_01	Robisz mi konkurencję, co?	
VO_GILA_BOSS_64h_Male_Goblin_HeroPowerHandBig_01	Ogarnia cię senność.	
VO_GILA_BOSS_64h_Male_Goblin_HeroPowerHandBig_03	Twoje powieki robią się coraz cięższe.	
VO_GILA_BOSS_64h_Male_Goblin_HeroPowerHandEmpty_01	Chrrr... Chrrr...	
VO_GILA_BOSS_64h_Male_Goblin_HeroPowerHandMedium_01	Spójrz mi w oczy.	
VO_GILA_BOSS_64h_Male_Goblin_HeroPowerHandMedium_02	Śledź wzrokiem mój zegarek... Moment... Co było dalej?	
VO_GILA_BOSS_64h_Male_Goblin_HeroPowerHandMedium_03	W lewo i w prawo. Patrz, jak się kołysze!	
VO_GILA_BOSS_64h_Male_Goblin_HeroPowerHandSmall_01	To co ja miałem zrobić?	
VO_GILA_BOSS_64h_Male_Goblin_HeroPowerHandSmall_02	Ogarnia cię... senność.	
VO_GILA_BOSS_64h_Male_Goblin_Intro_01	Ooo! Mamy ochotnika?	
VO_GILA_BOSS_66h_Female_Undead_DefeatPlayer_01	…	
VO_GILA_BOSS_66h_Female_Undead_EmoteResponse_02	…	
VO_GILA_BOSS_66h_Female_Undead_EventPlayHorn_02	…	
VO_GILA_BOSS_66h_Female_Undead_HeroPower_01	…	
VO_GILA_BOSS_66h_Female_Undead_HeroPower_02	…	
VO_GILA_BOSS_66h_Female_Undead_HeroPower_03	…	
VO_GILA_BOSS_66h_Female_Undead_Intro_01	…	
VO_GILA_BOSS_67h_Male_Undead_DefeatPlayer_01	Życie to jeden wielki wyścig szczurów.	
VO_GILA_BOSS_67h_Male_Undead_EmoteResponse_01	Tylko spróbuj pisnąć jeszcze raz!	
VO_GILA_BOSS_67h_Male_Undead_EventPlayRat_01	Zacne z nich pupile, prawda? A jak smakują w panierce!	
VO_GILA_BOSS_67h_Male_Undead_EventPlayRat_02	Takie z nich proste stworzonka. Podobne do ciebie.	
VO_GILA_BOSS_67h_Male_Undead_EventPlayRat_03	Lepiej uważaj, bo zębiska mają ostre.	
VO_GILA_BOSS_67h_Male_Undead_EventPlayRatTrap_01	Pudełko i patyk? Finezji to w tym nie ma!	
VO_GILA_BOSS_67h_Male_Undead_Intro_01	Mam cię! Zawsze miałem nosa do szczurów.	
VO_GILA_BOSS_68h_Male_Undead_DefeatPlayer_01	Udało ci się przetrwać tak długo! Ciekawy przypadek do analizy.	
VO_GILA_BOSS_68h_Male_Undead_EmoteResponse_01	Wiesz, jak trudno jest upichcić zarazę?	
VO_GILA_BOSS_68h_Male_Undead_EventPlayPoison_01	Hej! Nie podkradaj mi pomysłów!	
VO_GILA_BOSS_68h_Male_Undead_EventPlayPoison_02	O, trucizna!	
VO_GILA_BOSS_68h_Male_Undead_EventPlayPoison_03	To mi się podoba.	
VO_GILA_BOSS_68h_Male_Undead_EventPlayPoison_04	Mogę pożyczyć? Zaraz oddam.	
VO_GILA_BOSS_68h_Male_Undead_Intro_01	Wynoście zmarłych! Zrobię z nich użytek.	
VO_HeadlessHorseman_Male_Human_HallowsEve_01	Tu jestem! Gdzie polazło to bezmyślne ciało?!	
VO_HeadlessHorseman_Male_Human_HallowsEve_02	Żałosny kundelku! Za czym tak gonisz? To bez znaczenia... bo i tak spłoniesz!	
VO_HeadlessHorseman_Male_Human_HallowsEve_04	Ciemność już zapadła. Ogień wszystko trawi. Próżny jest twój sprzeciw, gdy los się objawi.	
VO_HeadlessHorseman_Male_Human_HallowsEve_07	Po moim płomieniu nie został ni ślad. Poślę cię w ciemności celnym kopem w zad!	
VO_HeadlessHorseman_Male_Human_HallowsEve_08	Od chęci krwi mej rozlania odebrało ci mowę! Jednak by mnie pokonać, zabić musisz głowę!	
VO_HeadlessHorseman_Male_Human_HallowsEve_10	HAHAHAHAHHA AHAHAAAAAA!	
VO_HeadlessHorseman_Male_Human_HallowsEve_11	AAAAAHAHAHA HAHHAAHAH!	
VO_HeadlessHorseman_Male_Human_HallowsEve_12	Już wybiły dzwony, przytulcie swe dziatki! Ostatnie uściski dla ojca i matki!	
VO_HeadlessHorseman_Male_Human_HallowsEve_13	Nadszedł marny człeku, czas twego rozliczenia.  Próżne twoje płacze i żałosne biadolenia.	
VO_HeadlessHorseman_Male_Human_HallowsEve_17	HAHAHAHAahaha....	
VO_HRW_DEBUG_01	1	
VO_HRW_DEBUG_02	2	
VO_HRW_DEBUG_03	3	
VO_HRW_DEBUG_04	4	
VO_HRW_DEBUG_05	5	
VO_HRW_TEST_00	Oczyszczę was z Klątwy Ciała!	
VO_HRW_TEST_01	Dobra robota! Razem pokonaliście bossa.\n\nObaj gracze wygrywają!	
VO_HRW_TEST_02	Pokonajcie razem Trybomistrza Mechazoda, aby wygrać!	
VO_HRW_TEST_ABILITY_00	Ranię bohatera.	
VO_HRW_TEST_ABILITY_01	Niszczę stronnika z najwyższym atakiem.	
VO_HRW_TEST_ABILITY_02	Rzucam 3 bomby.	
VO_HRW_TEST_ABILITY_03	Ranię wszystkie pozosotałe postacie.	
VO_HRW_TEST_ABILITY_04	Otrzymuję 2 do ataku.	
VO_HRW_TEST_ABILITY_05	Zadaję obrażenia obu bohaterom.	
VO_HRW_TEST_ABILITY_06	Wyciszam Wiedziciela Czo. Permenentnie.	
VO_HRW_TEST_ABILITY_98	Plansza celu pełna. Oczyszczam planszę celu.	
VO_ICC_841_Female_Sanlayn_Death_02	Przecież tak dobrze nam szło!	
VO_ICC01_Jaina_Female_Human_DrawsRager_01	No nie, no po prostu no nie!	
VO_ICC01_Jaina_Female_Human_JainaDKIntro_05	Słyszę szepty... umarłych...	
VO_ICC01_Jaina_Female_Human_PostDeath_02	Musimy... walczyć dalej...	
VO_ICC01_LichKing_Male_Human_EmoteResponse_01	Te błagania o litość brzmią nieszczerze.	
VO_ICC01_LichKing_Male_Human_EndOfTurn2_01	Hahaha – TO się nazywa otwarcie!	
VO_ICC01_LichKing_Male_Human_EndOfTurn2_02	I to nawet nie jest moja agresywna talia.	
VO_ICC01_LichKing_Male_Human_Idle_01	Na co czekasz? Zakończ turę, abym ja mógł zakończyć twój żywot!	
VO_ICC01_LichKing_Male_Human_Intro_01	Wybieraj karty z rozmysłem, to ostatnia partia w twoim życiu.	
VO_ICC01_LichKing_Male_Human_JainaDKIntro_01	Powstań, czarodziejko. Jeszcze dużo pracy przed tobą.	
VO_ICC01_LichKing_Male_Human_JainaDKIntro_02	Dołącz do mnie. Żywi zadrżą przed tobą, a umarli usłuchają twych rozkazów.	
VO_ICC01_LichKing_Male_Human_JainaDKIntro_03	Wrogowie będą się ciebie lękać bardziej niż samej śmierci...	
VO_ICC01_LichKing_Male_Human_JainaDKintro_06	A teraz wymieć te bezwartościowe śmieci z moich progów.	
VO_ICC01_LichKing_Male_Human_PlaysFrostmourne_01	Wierz mi, twoja pozycja w rankingu POWAŻNIE UCIERPI.	
VO_ICC01_LichKing_Male_Human_Turn1_01	Moje karty są TAKIE DOBRE…	
VO_ICC01_LichKing_Male_Human_Turn11_01	Hordy nieumarłych czekają na twoje rozkazy.	
VO_ICC01_LichKing_Male_Human_Turn13_01	Spraw, żeby cierpieli.	
VO_ICC01_LichKing_Male_Human_Turn15_01	Litość to oznaka słabości.	
VO_ICC01_LichKing_Male_Human_Turn2_02	Podziwiaj moją potęgę.	
VO_ICC01_LichKing_Male_Human_Turn4_01	Nikt ci nie pomoże.	
VO_ICC01_LichKing_Male_Human_Turn4_02	Moja moc nie zna granic.	
VO_ICC01_LichKing_Male_Human_Turn5_01	Nikt mi się nie oprze.	
VO_ICC01_LichKing_Male_Human_Turn5_02	Ty też będziesz mi służyć.	
VO_ICC01_Tirion_Male_Human_AFKay_01	Halo, do walki!	
VO_ICC01_Tirion_Male_Human_EmoteResponse_02	Jesteś mi teraz zupełnie obca!	
VO_ICC01_Tirion_Male_Human_EndOfTurn4_01	Nie poddawaj się!	
VO_ICC01_Tirion_Male_Human_EndOfTurn4_02	Wierzę, że opatrzność obdarzy cię wielką mocą, teraz gdy jesteś w potrzebie.	
VO_ICC01_Tirion_Male_Human_EndOfTurn4_03	Musisz wierzyć, że opatrzność ci pomoże, teraz, gdy znajdujesz się w potrzebie.	
VO_ICC01_Tirion_Male_Human_Flavor01_01	Muszę znaleźć lepszych śmiałków...	
VO_ICC01_Tirion_Male_Human_Flavor02_01	Jaino, zamieniłaś się w potwora!	
VO_ICC01_Tirion_Male_Human_Flavor03_01	Król Lisz zapłaci za tę potworność!	
VO_ICC01_Tirion_Male_Human_JainaDKintro_05	Na Światłość… Czym się stałaś?	
VO_ICC01_Tirion_Male_Human_PauseDeath_02	Wstrzymaj się!	
VO_ICC01_Tirion_Male_Human_PostDeath_01	Odnajdź w sobie wolną wolę. Wyrwij się spod władzy Króla Lisza!	
VO_ICC01_Tirion_Male_Human_TerribleTank_01	Czemu nie prowokujesz?	
VO_ICC01_Tirion_Male_Human_Turn2_01	Bez obaw! Jesteśmy w drodze.	
VO_ICC01_Tirion_Male_Human_Turn3_01	Jesteśmy już prawie na miejscu. Jak sytuacja? Wszystko dobrze?	
VO_ICC01_Tirion_Male_Human_Turn6_01	Trzymaj się, zaraz będziemy gotowi, by...	
VO_ICC01_Tirion_Male_Human_Turn6_02	Co?!	
VO_ICC01_Tirion_Male_Human_Turn8_01	Stajesz do walki z najdzielniejszymi śmiałkami Azeroth!	
VO_ICC04_LichKing_Male_Human_BreathNoMinion_01	Chwila, Sindragosa nie zamroziła żadnego stronnika? Słabo.	
VO_ICC04_LichKing_Male_Human_Lose_01	Twoje zamarznięte truchło będzie przestrogą dla innych…	
VO_ICC04_LichKing_Male_Human_Turn5_01	Być może zastanawiasz się, jak można się pozbyć tych lodowych bloków.	
VO_ICC04_LichKing_Male_Human_Turn5_02	Odpowiedź brzmi: nie da się!	
VO_ICC04_LichKing_Male_Human_Win_02	TA TALIA MUSI ZOSTAĆ OCZYSZCZONA!	
VO_ICC04_Sindragosa_Female_Dragon_Bounce_01	Ej, oddawaj!	
VO_ICC04_Sindragosa_Female_Dragon_BreathNoRoomLeft_01	Więcej stronników już nie wystawisz.	
VO_ICC04_Sindragosa_Female_Dragon_Death_01	Arrrrrrrggg!	
VO_ICC04_Sindragosa_Female_Dragon_EmoteResponse_01	Mam dosyć tych gierek!	
VO_ICC04_Sindragosa_Female_Dragon_Intro_01	Tylko głupiec ośmieliłby się tu przyjść!	
VO_ICC04_Sindragosa_Female_Dragon_LichKing_01	Zostałam zdradzona!	
VO_ICC04_Sindragosa_Female_Dragon_Malygos_01	Malygos... moja dawna miłość!	
VO_ICC04_Sindragosa_Female_Dragon_PlayerPlaysMinion_02	Rozważnie wybieraj, kto ma zginąć. Śmierć pochwyci wszystkich w zimnym uścisku.	
VO_ICC04_Sindragosa_Female_Dragon_SecondBreath_01	Poczuj niezmierzoną moc mego pana i porzuć wszelką nadzieję!	
VO_ICC04_Sindragosa_Female_Dragon_Sindragosa_01	Nasza żałosna magia obraca się przeciwko nam!	
VO_ICC04_Sindragosa_Female_Dragon_Sindragosa_02	Nasza żałosna magia obraca się przeciwko nam!	
VO_ICC04_Sindragosa_Female_Dragon_TransformDK_01	Służę tylko jednemu panu!	
VO_ICC04_Sindragosa_Female_Dragon_UnchainedMagic_02	Twoja żałosna magia obraca się przeciwko tobie!	
VO_ICC04_Sindragosa_Female_Dragon_UnchainedMagic_04	Będziesz cierpieć!	
VO_ICC05_Lanathel_Female_Sanlayn_BiteOoze_01	Fuuu, nie wkładaj tego do buzi.	
VO_ICC05_Lanathel_Female_Sanlayn_BitePoisonous_01	Pamiętaj, żeby wypluć truciznę, jak już zrobisz swoje.	
VO_ICC05_Lanathel_Female_Sanlayn_BiteReminder_01	Nie zapominasz aby o czymś? W twoich żyłach płonie pragnienie!	
VO_ICC05_Lanathel_Female_Sanlayn_BiteReminderAcolyte_01	Nie wahaj się. Zaspokój głód! Pożyw się śpiącymi!	
VO_ICC05_Lanathel_Female_Sanlayn_BiteShell_01	Uwaga na zęby.	
VO_ICC05_Lanathel_Female_Sanlayn_BiteSpikes_01	Auć, to musiało boleć.	
VO_ICC05_Lanathel_Female_Sanlayn_BloodEssence_01	Robi się tu tłoczno.	
VO_ICC05_Lanathel_Female_Sanlayn_BloodEssence_02	Nie byli ci potrzebni, prawda?	
VO_ICC05_Lanathel_Female_Sanlayn_BloodEssence_03	Zamieszajmy trochę, hm?	
VO_ICC05_Lanathel_Female_Sanlayn_BloodPrince_01	Zdrajco krwi! Nie jesteś godzien kłów!	
VO_ICC05_Lanathel_Female_Sanlayn_BossBite_01	Poczuj mój głód!	
VO_ICC05_Lanathel_Female_Sanlayn_EmoteResponse_01	Czy ty mnie... podrywasz?	
VO_ICC05_Lanathel_Female_Sanlayn_Intro_01	Stając do tej walki, postępujesz... niemądrze.	
VO_ICC05_Lanathel_Female_Sanlayn_LichKing_01	Och… Ty!	
VO_ICC05_Lanathel_Female_Sanlayn_PlayerBiteAcolyte_01	Och, cóż za smakowita ironia!	
VO_ICC05_Lanathel_Female_Sanlayn_PlayerBloodBite_01	Za późno na to. Jestem już zgubiona!	
VO_ICC05_Lanathel_Female_Sanlayn_TransformDK_01	O proszę, wiedziałam, że się polubimy.	
VO_ICC05_Lanathel_Female_Sanlayn_Turn3_01	A może by tak pożywić się MOIM stronnikiem?	
VO_ICC05_Lanathel_Female_Sanlayn_Turn3_02	Tak słodko śpią... A jak słodko smakują!	
VO_ICC05_Lanathel_Female_Sanlayn_Wounded_01	Serio? Tylko na tyle cię stać?	
VO_ICC05_LichKing_Male_Human_BossBite_02	Aaa, ugryzienie San’layn.	
VO_ICC05_LichKing_Male_Human_BossBite_03	Strzeż się potwornego głodu. W każdej turze musisz się pożywić!	
VO_ICC05_LichKing_Male_Human_LichKing_02	Ten boss gryzie.	
VO_ICC05_LichKing_Male_Human_Lose_01	Co jest, nie chcesz gryźć własnych stronników? To Lodowa Korona, a_nie chatka w_górach z_kominkiem i_kakao!	
VO_ICC05_LichKing_Male_Human_Win_01	Lana'thel… Masz szczęście, że przy twojej randze nie możesz stracić gwiazdek.	
VO_ICC06_LichKing_Male_Human_LichKing_02	To nic osobistego, Kościejcu.	
VO_ICC06_LichKing_Male_Human_Win_01	To muszę teraz stworzyć nowego kościanego upiora... Tym razem ZŁOTEGO!	
VO_ICC06_Marrowgar_Male_BoneWraith_Alexstraza_01	Polizała mnie, widzieliście? Ta smoczyca mnie polizała!	
VO_ICC06_Marrowgar_Male_BoneWraith_AncientOne_01	Nie żałuję NICZEGO!	
VO_ICC06_Marrowgar_Male_BoneWraith_AuchenaiSoulpriest_01	Ha ha, mam teraz twoją kapłankę! Chwila. Nie. Idź sobie! Sio!	
VO_ICC06_Marrowgar_Male_BoneWraith_BigHeal_01	Śmierć jest wieczna i nie zna litości...	
VO_ICC06_Marrowgar_Male_BoneWraith_Bonespike_01	Jedyna ucieczka to śmierć!	
VO_ICC06_Marrowgar_Male_BoneWraith_Bonespike_02	Dostarczę memu panu twoje truchło.	
VO_ICC06_Marrowgar_Male_BoneWraith_Bonespike_03	Lubisz pieszczoty? Te oddzielą twoje kości od ścięgien.	
VO_ICC06_Marrowgar_Male_BoneWraith_Bonespike_04	Czas na żniwa.	
VO_ICC06_Marrowgar_Male_BoneWraith_Bonespike_05	Taki niebezpieczny. Taki cudowny!	
VO_ICC06_Marrowgar_Male_BoneWraith_BonespikePlayerHit_01	Aaa! Przeszywa mnie wściekłość mego pana!	
VO_ICC06_Marrowgar_Male_BoneWraith_BonespikeStolen_01	Aaa! Ty... rabusiu kości!	
VO_ICC06_Marrowgar_Male_BoneWraith_Bonestorm_01	Wir kości!	
VO_ICC06_Marrowgar_Male_BoneWraith_Bonestorm_02	Wir kooości!	
VO_ICC06_Marrowgar_Male_BoneWraith_Bonestorm_03	Wir koooości!	
VO_ICC06_Marrowgar_Male_BoneWraith_Bonestorm_04	WIR KOŚCI!	
VO_ICC06_Marrowgar_Male_BoneWraith_Bonestorm_05	WIR KOOOOOŚCI!	
VO_ICC06_Marrowgar_Male_BoneWraith_BonestormFast_01	Wir kości.	
VO_ICC06_Marrowgar_Male_BoneWraith_Death_01	I w proch się obrócę...	
VO_ICC06_Marrowgar_Male_BoneWraith_DKTransform_01	Tak! Pogódź się z losem. Usłuchaj wezwania swego pana!	
VO_ICC06_Marrowgar_Male_BoneWraith_EmoteResponse_01	Głupcze! Przecież nie mam uszu! Hahaha!	
VO_ICC06_Marrowgar_Male_BoneWraith_Idle_01	Hmmmm…	
VO_ICC06_Marrowgar_Male_BoneWraith_Intro_01	Nikt nie wejdzie do sanktuarium mego pana!	
VO_ICC06_Marrowgar_Male_BoneWraith_LichKing_01	Panie...	
VO_ICC06_Marrowgar_Male_BoneWraith_Skeleton_01	Co tam, klekoczący koleżko?	
VO_ICC07_LichKing_Male_Human_LichKing_02	Lubię bezpośredni styl zarządzania.	
VO_ICC07_LichKing_Male_Human_Lose_01	Przebrzyd, ta twoja talia to niezłe ohydztwo. Nie doceniłem cię.	
VO_ICC07_LichKing_Male_Human_Win_02	Przebrzyd, to było żenujące. Może talia łowcy cię przygarnie, bo w mojej cytadeli nie ma już dla ciebie miejsca.	
VO_ICC07_Putricide_Male_Undead_Aviana_01	Umiesz w naukę lepiej ode mnie!	
VO_ICC07_Putricide_Male_Undead_CloakedHuntress_01	Cóż, to nie było konieczne.	
VO_ICC07_Putricide_Male_Undead_Death_01	Mam złe wieści...	
VO_ICC07_Putricide_Male_Undead_EaglehornBow_01	Też bym chciał taki.	
VO_ICC07_Putricide_Male_Undead_EaterOfSecrets_01	O, nie! Moje sekrety! Dzieło mojego życia!	
VO_ICC07_Putricide_Male_Undead_EmoteResponse_01	To nie było miłe.	
VO_ICC07_Putricide_Male_Undead_EquipWeapon_01	Ojejku.	
VO_ICC07_Putricide_Male_Undead_EquipWeapon_02	Nawet nie wiedziałem, że mam coś takiego.	
VO_ICC07_Putricide_Male_Undead_EquipWeapon_03	Aha, to się nada.	
VO_ICC07_Putricide_Male_Undead_EquipWeapon_04	A to skąd się wzięło?	
VO_ICC07_Putricide_Male_Undead_EquipWeapon_05	Taka niebezpieczna. Taka cudowna!	
VO_ICC07_Putricide_Male_Undead_EtherealArcanist_01	Eteryczni są podejrzani. Nie widać, jakie robią miny!	
VO_ICC07_Putricide_Male_Undead_FestergutDeath_01	Och, Ropniaku. To ciebie zawsze lubiłem najbardziej... No i Zgnilca.	
VO_ICC07_Putricide_Male_Undead_Intro_02	Mam wspaniałe wieści! Naprawiłem rury z trującym szlamem! O, witaj.	
VO_ICC07_Putricide_Male_Undead_LichKing_01	Ojej. Ciebie się tu nie spodziewałem, panie.	
VO_ICC07_Putricide_Male_Undead_MysteriousChallenger_01	Nikt nie jest bardziej tajemniczy ode mnie!	
VO_ICC07_Putricide_Male_Undead_Ooze_01	Szlag, szlam!	
VO_ICC07_Putricide_Male_Undead_PhaseTransition_01	Macki! Jejku, zupełnie jakby żyły własnym życiem, nieprawdaż?	
VO_ICC07_Putricide_Male_Undead_PhaseTransition_03	Hmmm, fascynujące.	
VO_ICC07_Putricide_Male_Undead_Putricide_02	Hę? To ten koleś co to wygląda jak ja?	
VO_ICC07_Putricide_Male_Undead_Putricide_03	Dobrze cię widzieć, Przebrzydzie!	
VO_ICC07_Putricide_Male_Undead_Putricide_04	A ciebie nie, ty mackowata podróbo.	
VO_ICC07_Putricide_Male_Undead_Rotface_01	Zgniłku! Jak mogłeś?!	
VO_ICC07_Putricide_Male_Undead_RotfaceDeath_01	Tylko nie Zgniłek! Krzywdę ci zrobił, czy jak?!	
VO_ICC07_Putricide_Male_Undead_Scientist_01	Podkradasz mój personel?	
VO_ICC07_Putricide_Male_Undead_Slime_01	Przynoszę dobre wieści! Szlam znów płynie przez rury!	
VO_ICC07_Putricide_Male_Undead_TentaclesForArms_01	Stylowa broń, nie powiem.	
VO_ICC07_Putricide_Male_Undead_TransformDK_01	Co za zmiana! Jak w pandareńskiej kreskówce!	
VO_ICC07_Rotface_Male_Abomination_Rotface_02	Zgnilec ma POCZEBY.	
VO_ICC08_Anduin_Male_Human_Muted_02	Mmmhh!	
VO_ICC08_Anduin_Male_Human_Muted_03	Mmmhh.	
VO_ICC08_Anduin_Male_Human_Muted_06	Mmmmhhhhhh…!!	
VO_ICC08_Anduin_Male_Human_Muted_07	Mmmmhhhhhh!	
VO_ICC08_Anduin_Male_Human_Muted_11	Mmmhh?	
VO_ICC08_Anduin_Male_Human_Muted_13	Mmmhh…	
VO_ICC08_Anduin_Male_Human_WinA_01	Zawsze musi być...	
VO_ICC08_Anduin_Male_Human_WinB_01	Król Lisz!	
VO_ICC08_Garrosh_Male_Orc_WinA_01	Zawsze musi być...	
VO_ICC08_Garrosh_Male_Orc_WinB_01	Król Lisz!	
VO_ICC08_Guldan_Male_Orc_WinA_01	Zawsze musi być...	
VO_ICC08_Guldan_Male_Orc_WinB_01	Król Lisz!	
VO_ICC08_Jaina_Female_Human_WinA_01	Zawsze musi być...	
VO_ICC08_Jaina_Female_Human_WinB_01	Król Lisz!	
VO_ICC08_LichKing_Male_Human_Archmage Antonidas_01	Już raz cię zabiłem, starcze. Zrobię to znów.	
VO_ICC08_LichKing_Male_Human_Arfas_01	Zły pies!	
VO_ICC08_LichKing_Male_Human_Bolvar_01	O, tego ciężko było złamać.	
VO_ICC08_LichKing_Male_Human_Death_01	Widzę... tylko ciemność...	
VO_ICC08_LichKing_Male_Human_DeathPunisher_01	To było słabe. Naprawdę słabe.	
VO_ICC08_LichKing_Male_Human_EmoteResponse_01	Nikt nie będzie mi rozkazywał!	
VO_ICC08_LichKing_Male_Human_EndOfTurn4_01	Mój triumf jest nieunikniony, żadna karta go nie opóźni.	
VO_ICC08_LichKing_Male_Human_Frostmourne_01	Ostrze Mrozu jest głodne...	
VO_ICC08_LichKing_Male_Human_Frostmourne_02	Ostrze Mrozu jest głodne… A ty masz na coś ochotę?	
VO_ICC08_LichKing_Male_Human_Frostmourne_07	Ukażę ci moc Ostrza Mrozu.	
VO_ICC08_LichKing_Male_Human_GenericStart_03	Zniszczę twoją talię, a potem... TWOJĄ DUSZĘ!	
VO_ICC08_LichKing_Male_Human_Horsemen_01	Jak zdobędę wszystkich czterech, będzie ci niesamowicie głupio.	
VO_ICC08_LichKing_Male_Human_Hunter_01	Samotny łowca. Wystarczy zabrać twoich pupili i nie ma już kto ze mną walczyć, hm?	
VO_ICC08_LichKing_Male_Human_Illidan_01	Mroźny Tron należy do mnie, demonie. Zejdź mi z drogi.	
VO_ICC08_LichKing_Male_Human_IndestructableWeapon_01	Daremny wysiłek.	
VO_ICC08_LichKing_Male_Human_Intro_01	Twoje cierpienie stanie się legendarne. Ale ranga nie.	
VO_ICC08_LichKing_Male_Human_Intro_02	W końcu i tak wszyscy będą mi służyć.	
VO_ICC08_LichKing_Male_Human_Intro_03	Nazywasz talią ten żałosny stos kart?	
VO_ICC08_LichKing_Male_Human_Intro_04	Jestem początkiem i końcem. META-GRA TO JA!	
VO_ICC08_LichKing_Male_Human_Intro_06	Ktoś taki jak ty miałby zasłużyć na moją litość?	
VO_ICC08_LichKing_Male_Human_Intro_07	To ma być twoja talia? Wygląda jak wołanie o pomoc.	
VO_ICC08_LichKing_Male_Human_Intro_08	Twoje zbolałe okrzyki będą najlepszą recenzją moich legendarnych zagrań.	
VO_ICC08_LichKing_Male_Human_Intro_09	Czy to naprawdę poczucie sprawiedliwości tobą kieruje? Zastanawiające...	
VO_ICC08_LichKing_Male_Human_Kelthuzad_01	Kel’Thuzad! Zabłąkałeś się do niewłaściwej przygody.	
VO_ICC08_LichKing_Male_Human_Lanathel_01	Twoja zdrada wcale mnie nie dziwi, Lana’thel.	
VO_ICC08_LichKing_Male_Human_LichKing_01	No witaj, przystojniaku.	
VO_ICC08_LichKing_Male_Human_LichKing_02	Dobrze wyglądam.	
VO_ICC08_LichKing_Male_Human_LichKingMuted_01	Ale chwila, nie możesz...	
VO_ICC08_LichKing_Male_Human_LichKingMutedResponse_01	Mmmph.	
VO_ICC08_LichKing_Male_Human_LichKingMutedResponse_02	Mppmph Mmmphm!	
VO_ICC08_LichKing_Male_Human_LichKingMutedResponse_03	MphMPH!	
VO_ICC08_LichKing_Male_Human_LichKingMutedResponse_04	Mpphmmm…	
VO_ICC08_LichKing_Male_Human_LilLich_01	Jest... przeuroczy.	
VO_ICC08_LichKing_Male_Human_Lose_03	Dołącz do mnie w ciemności...	
VO_ICC08_LichKing_Male_Human_Mage_01	Nie wiesz, magu, że tylko ja dzierżę władzę nad ponurym chłodem śmierci?	
VO_ICC08_LichKing_Male_Human_MageSpellReflect_01	Jakim cudem to przeszło przez fazę testów?	
VO_ICC08_LichKing_Male_Human_MageSpellReflect_02	Serio? Kto testuje te przygody?	
VO_ICC08_LichKing_Male_Human_Mograine_01	Mograine! Tak często zmieniasz strony, że sam się już gubię.	
VO_ICC08_LichKing_Male_Human_MutedResponse_01	Cisza!	
VO_ICC08_LichKing_Male_Human_MutedResponse_02	Ciii!	
VO_ICC08_LichKing_Male_Human_MutedResponse_03	Ciiiiiiiii!	
VO_ICC08_LichKing_Male_Human_MutedResponse_04	Cicho tam.	
VO_ICC08_LichKing_Male_Human_MutedResponse_05	Cicho bądź.	
VO_ICC08_LichKing_Male_Human_MutedResponse_06	Ciiicho.	
VO_ICC08_LichKing_Male_Human_Paladin_01	Światłość cię tu nie ochroni, paladynie. Nic cię nie ochroni.	
VO_ICC08_LichKing_Male_Human_Phase03_01	Oto twój marny koniec.	
VO_ICC08_LichKing_Male_Human_PhaseTransition_02	Co jest z tą bronią? Znerfili ją?	
VO_ICC08_LichKing_Male_Human_PowerReplace_01	Moją moc nie tak łatwo okiełznać.	
VO_ICC08_LichKing_Male_Human_Priest_01	Milcz, kapłanie! Światłość i tak pozostanie głucha na twoje błagania o litość.	
VO_ICC08_LichKing_Male_Human_Putricide_01	Zawsze się tobą brzydziłem.	
VO_ICC08_LichKing_Male_Human_Rogue_01	Wyjdź z cienia, łotrze. Czy dasz sobie radę bez tych twoich sztuczek?	
VO_ICC08_LichKing_Male_Human_Shaman_01	Szamanie! Twoi stronnicy kulą się ze strachu widząc moją moc!	
VO_ICC08_LichKing_Male_Human_Sindragosa_01	To MOJA karta kończąca. Weź oddaj, no weź!	
VO_ICC08_LichKing_Male_Human_Sylvanas_01	Po tym wszystkim, co przez ciebie przeszedłem, nawet nie myśl, że znajdziesz ukojenie w śmierci.	
VO_ICC08_LichKing_Male_Human_Tirion_01	Fordring! Zachowam cię przy życiu, żebyś zobaczył, jak to się skończy.	
VO_ICC08_LichKing_Male_Human_TransformDK_01	Tak... Przyjmij swoją nową moc... Już zwyciężyłem...	
VO_ICC08_LichKing_Male_Human_Turn6_01	Ja na razie to twoja najbardziej żenująca tura. A pozostałe też nie powalają.	
VO_ICC08_LichKing_Male_Human_Turn6_03	Zagrywasz karty tak jak mój ojciec rządził królestwem. Marnie.	
VO_ICC08_LichKing_Male_Human_Turn6_04	Jak możesz żyć ze sobą w zgodzie grając takimi kartami?	
VO_ICC08_LichKing_Male_Human_Turn6_05	Każda zagrana karta przybliża cię do upadku.	
VO_ICC08_LichKing_Male_Human_Turn6_06	Szykuj się na swój koniec. Żadna emotka nie odda twojej hańby.	
VO_ICC08_LichKing_Male_Human_Turn6_07	Skąd masz taką beznadziejną talię?	
VO_ICC08_LichKing_Male_Human_Turn6_08	Na kogo była szykowana? Na Wyżera?	
VO_ICC08_LichKing_Male_Human_Warlock_01	Czarnoksiężniku, nie wykładaj nawet kart. Potworności, które ci służą, wkrótce zyskają nowego pana.	
VO_ICC08_LichKing_Male_Human_Warrior_01	Wojowniku, gdy już cię pokonam, będzie z ciebie doskonały rycerz śmierci.	
VO_ICC08_LichKing_Male_Human_Wounded_01	Nadzieja gaśnie...	
VO_ICC08_LichKing_Male_Human_Wounded_02	Niemożliwe... NIEMOŻLIWE!	
VO_ICC08_LichKing_Male_Human_YoungArthas_01	Co to ma być? Co to za chuchro?	
VO_ICC08_Malfurion_Male_NightElf_WinA_01	Zawsze musi być...	
VO_ICC08_Malfurion_Male_NightElf_WinB_01	Król Lisz!	
VO_ICC08_Rexxar_Male_Orc_WinA_01	Zawsze musi być...	
VO_ICC08_Rexxar_Male_Orc_WinB_01	Król Lisz!	
VO_ICC08_Thrall_Male_Orc_WinA_01	Zawsze musi być...	
VO_ICC08_Thrall_Male_Orc_WinB_01	Król Lisz!	
VO_ICC08_Tirion_Male_Human_Win_01	Udało ci się!	
VO_ICC08_Tirion_Male_Human_Win_02	Lecz wyzwolona spod władzy swego pana, niespokojna Plaga stanie się jeszcze większym zagrożeniem dla tego świata.	
VO_ICC08_Uther_Male_Human_WinA_01	Zawsze musi być...	
VO_ICC08_Uther_Male_Human_WinB_01	Król Lisz!	
VO_ICC08_Valeera_Female_Human_WinA_01	Zawsze musi być...	
VO_ICC08_Valeera_Female_Human_WinB_01	Król Lisz!	
VO_ICC09_LichKing_Male_Human_LichKing_02	Bez obaw, nie zaatakuję cię.	
VO_ICC09_LichKing_Male_Human_Lose_01	Ktoś tutaj był chyba mocno nieprzygotowany do zajęć.	
VO_ICC09_LichKing_Male_Human_Win_01	To była moja ulubiona legenda! Teraz muszę ją przerobić na coś lepszego.	
VO_ICC09_Saurfang_Male_Orc_AttackedByPlayer_01	No pokaż, co potrafisz!	
VO_ICC09_Saurfang_Male_Orc_AttacksPlayer_01	Zmierz się z potęgą Plagi!	
VO_ICC09_Saurfang_Male_Orc_AttacksPlayer_02	I stałem się śmiercią!	
VO_ICC09_Saurfang_Male_Orc_AttacksPlayer_03	Król Lisz zgarnie wszystko.	
VO_ICC09_Saurfang_Male_Orc_AttacksPlayer_04	Walcz i umieraj! Twój los został przypieczętowany.	
VO_ICC09_Saurfang_Male_Orc_BloodBeast_01	Pożywcie się, moi stronnicy!	
VO_ICC09_Saurfang_Male_Orc_BloodBeast_02	Pożreć ich...	
VO_ICC09_Saurfang_Male_Orc_BloodBeast_03	Moja siła rośnie.	
VO_ICC09_Saurfang_Male_Orc_BloodBeast_04	Oto moja wściekłość!	
VO_ICC09_Saurfang_Male_Orc_BloodBeastStolen_01	Zatrzymaj ją sobie. Już się nie pozbędziesz smrodu z ubrania.	
VO_ICC09_Saurfang_Male_Orc_CursedBlade_01	Kto wpadł na ten… „wspaniały” pomysł?	
VO_ICC09_Saurfang_Male_Orc_Death_01	Jestem... wolny...	
VO_ICC09_Saurfang_Male_Orc_DKTransform_01	Nareszcie! Godny przeciwnik!	
VO_ICC09_Saurfang_Male_Orc_Doomerang_01	Hmm... Muszę sobie taki sprawić...	
VO_ICC09_Saurfang_Male_Orc_EmoteResponse_01	Żałosny tchórz.	
VO_ICC09_Saurfang_Male_Orc_EquipWeapon_01	Na potęgę Króla Lisza!	
VO_ICC09_Saurfang_Male_Orc_EquipWeapon_02	Imponujące.	
VO_ICC09_Saurfang_Male_Orc_Intro_01	Chodź i zmierz się z potęgą Plagi!	
VO_ICC09_Saurfang_Male_Orc_LichKing_01	A TY co tu robisz?	
VO_ICC09_Saurfang_Male_Orc_WeaponDestroyed_01	Raaaar!	
VO_ICC10_Deathwhisper_Female_Lich_DamageByValithria_01	Agrrr...	
VO_ICC10_Deathwhisper_Female_Lich_Death_01	Niemożliwe...!	
VO_ICC10_Deathwhisper_Female_Lich_DKTransform_01	Aaa! Ciebie również przyciągnęła potęga pana...	
VO_ICC10_Deathwhisper_Female_Lich_EmoteResponse_01	Ooo, czy to była groźba?	
VO_ICC10_Deathwhisper_Female_Lich_Equality_01	Tylko ci się wydaje, że to dobry pomysł.	
VO_ICC10_Deathwhisper_Female_Lich_HeroPower_01	Śmiertelnicy są tacy słabi...	
VO_ICC10_Deathwhisper_Female_Lich_HeroPower_02	Twoje śmiertelne ciało to przekleństwo...	
VO_ICC10_Deathwhisper_Female_Lich_HeroPower_03	Czy pojmujesz próżność swych czynów?	
VO_ICC10_Deathwhisper_Female_Lich_HeroPower_04	Mrok cię pochłonie…	
VO_ICC10_Deathwhisper_Female_Lich_HeroPowerInitial_01	Usłysz wezwanie śmierci...	
VO_ICC10_Deathwhisper_Female_Lich_Intro_01	Kto zakłóca mój spokój? Jeszcze tu nie skończyłam.	
VO_ICC10_Deathwhisper_Female_Lich_LichKing_01	Panie, błagam... Zabijam ich najszybciej, jak mogę!	
VO_ICC10_Deathwhisper_Female_Lich_PlayerPlaysEnrage_01	Twoi stronnicy proszą się o karę!	
VO_ICC10_Deathwhisper_Female_Lich_StoneskinGargoyle_01	Co? Nie wiedziałam, że gramy tu kartami z Dziczy!	
VO_ICC10_Deathwhisper_Female_Lich_ValithriaBlessedChampion_01	Znajdź sobie inne zajęcie, paladynie!	
VO_ICC10_Deathwhisper_Female_Lich_ValithriaDivineShield_01	Daj już spokój tej smoczycy!	
VO_ICC10_Deathwhisper_Female_Lich_ValithriaResurrect_01	Ta gra już mnie nie bawi.	
VO_ICC10_Deathwhisper_Female_Lich_ValithriaTaunt_01	I bez tego miałam dość tej smoczycy.	
VO_ICC10_Deathwhisper_Female_Lich_ValithriaWindfury_01	Umph… Litości…	
VO_ICC10_LichKing_Male_Human_DamageByValithria_02	Ta smoczyca zniweczy wszystkie nasze wysiłki! Zniszcz ją, Morowa Pani!	
VO_ICC10_LichKing_Male_Human_Lose_01	Następnym razem zainwestuj w_leczenie.	
VO_ICC10_LichKing_Male_Human_Turn2_01	Morowa Pani! Kazałem ci wykończyć tę smoczycę.	
VO_ICC10_LichKing_Male_Human_Turn2_02	Jak na przywódczynię kultu śmierci, nie śpieszysz się zbytnio.	
VO_ICC10_LichKing_Male_Human_Win_01	Twoja talia mnie zawiodła, Morowa Pani. Ciesz się, że twoja porażka była szybka.	
VO_ICC10_LichKing_Male_Human_Wounded_01	Przestań się bawić i skończ to wreszcie, Morowa Pani.	
VO_ICC10_LichKing_Male_Human_Wounded_02	Jak można nie mieć w talii Tajemnej eksplozji?!	
VO_ICCA08_033_Male_HumanGhost_Flavor_01	Pomóż nam...	
VO_ICCA08_033_Male_HumanGhost_Flavor_02	Uratuj nas...	
VO_ICCA08_033_Male_HumanGhost_Flavor_03	Nie ma ucieczki...	
VO_ICCA08_033_Male_HumanGhost_Flavor_04	No, może jednak jest...	
VO_ICCA08_033_Male_HumanGhost_Flavor_05	Ciii!	
VO_ICCA10_001_Female_GreenDragon_Healed_01	Wróciły mi siły!	
VO_ICCA10_001_Female_GreenDragon_Start_01	Czempionie, pomóż mi... Nie mogę... się poddać.	
VO_Illhoof_Male_Demon_IlhoofKilrek_01	Chodź, musimy dokończyć przywoływanie!	
VO_Illhoof_Male_Demon_IllhoofDeath_02	Nie! Tak blisko! Sarger...	
VO_Illhoof_Male_Demon_IllhoofEmoteResponse_01	Esencja twojej siły życiowej zasili rytuał!	
VO_Illhoof_Male_Demon_IllhoofOpen_01	Ach, w samą porę!	
VO_Illhoof_Male_Demon_IllhoofSummonImps_01	Chodźcie, mieszkańcy mroku, przybądźcie na moje wezwanie!	
VO_Illhoof_Male_Demon_IllhoofSummoningPortal_01	Portal bez obrzędu? Jakie to proste...	
VO_Illhoof_Male_Demon_IllhoofTurn1_01	Zaczynamy rytuał!	
VO_Illhoof_Male_Demon_IllhoofWounded_01	Chodźcie, zwierzaczki. Trzeba dokończyć rytuał!	
VO_INNKEEPER_Male_Dwarf_HSNewYearBrawl_02	Rok Kruka jest ociupinkę straszniejszy od całej reszty.	
VO_INNKEEPER_Male_Dwarf_HSNewYearBrawl_03	O kruca bomba! Wygląda na to, że przybył herold Roku Kruka!	
VO_INNKEEPER_Male_Dwarf_HSNewYearBrawl_05	W Roku Kruka dojdzie do pewnych mrocznych przemian.	
VO_INNKEEPER_Male_Dwarf_HSNewYearBrawl_08	Bestie czyhające w cieniu nabierają śmiałości...	
VO_INNKEEPER_Male_Dwarf_HSNewYearBrawl_09	Nocne stworzenia szykują się do harców...	
VO_INNKEEPER_Male_Dwarf_HSNewYearBrawl_10	Bagienne potwory podpełzają coraz bliżej...	
VO_Jaraxxus_Male_Demon_FinalMalchezaarJaraxxus_01	Niemądry księciunio. Lepiej poćwicz karaoke, jak Jaraxxus!	
VO_Jaraxxus_Male_Demon_FinalMalchezaarJaraxxus_02	Trzeba nam...\nodkrywców bo...\nmy ligą odkrywców się zwiemy....	
VO_Julianne_Female_Human_JulianneDeath_01	Do ciebie, mój luby, spełniam ten toast...	
VO_Julianne_Female_Human_JulianneEmoteResponse_01	Skrzywiłeś się na nas, mości panie?	
VO_Julianne_Female_Human_JulianneFeignDeath_03	Ockniesz się, jak ze snu błogiego...	
VO_Julianne_Female_Human_JulianneHeroPower_01	Przyjdź, ciemna nocy! A z tobą Romulo, mój luby!	
VO_Julianne_Female_Human_JulianneOpen_01	Cóżeś za bies?	
VO_KAR03_MOROES_MALE_HUMAN_CHESS_TURN_1	Patrz, na końcu twojej tury figury automatycznie zaatakują.	
VO_KAR03_MOROES_MALE_HUMAN_CHESS_TURN_3	Jeżeli figura stoi pomiędzy dwoma przeciwnikami, uderzy obu!	
VO_KAR03_MOROES_MALE_HUMAN_CHESS_TURN_5	Kluczem do zwycięstwa jest odpowiednie ustawienie. Zadbaj o podwójne ataki!	
VO_KARA_04_01_Female_Human_CroneHuffer_01	Prychaczu, to chyba już nie jest Zachodni Brzeg...	
VO_KARA_04_01_Female_Human_CroneLionTigerBear_02	Och! Lwy, smoki i niedźwiedzie! O rety!	
VO_KARA_04_01_Female_Human_CroneTurn1_01	Och nie, nie pozwól, żeby mnie skrzywdziła.	
VO_KARA_04_01_Female_Human_CroneTurn3_01	Chwyćmy się za ręce! Razem będziemy silniejsi!	
VO_KARA_06_01_Male_Human_JulianneDeadlyPoison_02	O, trucizna zgubna!	
VO_KARA_06_01_Male_Human_JulianneTurn1_01	Wyzywasz moją wściekłość? Broń się zatem!	
VO_KT_ANTI_CHEESE1_65	To heroiczny Naxxramas! Nie pozwolę tutaj na takie cieniackie zagrywki!	
VO_KT_ANTI_CHEESE2_66	Prorok zagłady, mówisz? Myślisz, że to takie sprytne zagranie?	
VO_KT_ANTI_CHEESE3_67	Równość?! A może jeszcze Wolność i Braterstwo?!	
VO_KT_ANUB2_43	NIEEEE!!! To znaczy... nieważne. I tak nie pokonasz... Wielkiej Wdowy!	
VO_KT_BARON2_64	Rewir Zbrojnych się nie popisał. Ciężko dziś o solidnych fachowców.	
VO_KT_FAERLINA2_45	Strata Ferliny nic dla mnie nie znaczy. Pajęcza Królowa załatwi cię z łatwością!	
VO_KT_GLUTH2_73	Zapytałem zombiaki, czy chcą zjeść twój mózg, ale powiedziały „Nie jemy śmieciowego żarcia”. Hahaha!	
VO_KT_GLUTH2_ALT_74	Za przegranie z Glutem jest osiągnięcie. To prawda.	
VO_KT_GLUTH3_75	HAHAHA NIE MA ŻADNEGO OSIĄGNIĘCIA ZA PRZEGRANĄ Z GLUTEM!	
VO_KT_GLUTH4_76	Nie! Kto teraz zeżre te wszystkie nadliczbowe zombie?	
VO_KT_GLUTH5_77	W zawodzie bossa najbardziej cenię sobie dziesiątkowanie. Albo nie - mrożenie krwi w żyłach.	
VO_KT_GLUTH6_78	Dobry piesek! Bardzo dobry!	
VO_KT_GOTHIK2_62	Chwila! Dlaczego Gotyk nie powrócił jako Widmowy Gotyk? Granda!	
VO_KT_GROBBULUS2_71	No i cały misterny plan…	
VO_KT_HEIGAN2_55	Aż wrę z gniewu. WRĘ MÓWIĘ!	
VO_KT_LOATHEB2_57	Wciąż ZABIJASZ MOICH STRONNIKÓW. Przestań! Przestań ale już!	
VO_KT_MAEXXNA2_47	Jej trucizna zapewni ci *w miarę* bezbolesną śmierć.	
VO_KT_MAEXXNA3_48	Morski olbrzym?! Maexxno, ale jego nie ma na liście dopuszczonych przeze mnie kart!	
VO_KT_MAEXXNA4_49	Niemożliwe! To jeszcze nie koniec, ŻAŁOSNA ISTOTO!	
VO_KT_MAEXXNA6_51	Maexxna zapewni ci stały dostęp do sieci.	
VO_KT_NOTH2_53	Biedny Nicz. Chyba zapalę mu znicz.	
VO_KT_PATCHWERK2_69	Mój awatar wojny! Trzeba go było zszyć z lepszych graczy...	
VO_KT_RAZUVIOUS2_59	Kto będzie teraz szkolił moich rycerzy śmierci? Sam tego nie zrobię. Ja czasu nie mam.	
VO_KT_SAPPHIRON2_84	Popatrz na tego gnoma. Też kiedyś był intruzem. Tak jak ty!	
VO_KT_SAPPHIRON3_85	Przestań się chować za tym blokiem lodu!	
VO_KT_SAPPHIRON4_ALT_87	Szafironie, wykonaj plan: „ZAMROŻENIE KRWI W ŻYŁACH”!	
VO_KT_SAPPHIRON5_88	MÓJ SMOK! Nie lubię cię.	
VO_KT_THADDIUS2_81	Intruzie! Ta zniewaga krwi wymaga!	
VO_LichKing_Male_Human_Brawl_01	Powyrzynam każdego bywalca tej karczmy...	
VO_LichKing_Male_Human_Brawl_03	Nieważne, ilu głupców ruszy do walki. I tak zwyciężę!	
VO_LichKing_Male_Human_Brawl_05	Patrzcie na mój ogromny zasób zdrowia… Patrzcie i rozpaczajcie...	
VO_LichKing_Male_Human_ExpansionIntro_02	Lodowa Korona! Przychodzisz, aby zmierzyć się ze straszliwą potęgą. Zostajesz, bo giniesz po drodze.	
VO_LichKing_Male_Human_FinaleFirstVictory_01	Niemożliwe... Niemożliwe… No to co… do pięciu zwycięstw?	
VO_LichKing_Male_Human_FinaleLock_01	NIGDY mnie nie pokonasz! A przynajmniej dopóki to skrzydło jest zablokowane! Hahaha!	
VO_LichKing_Male_Human_FinaleUnlock_03	Mam odłożyć Ostrze Mrozu i zdać się na waszą łaskę? UWAGA, SPOILER: nie zamierzam.	
VO_LichKing_Male_Human_LowerCitadelUnlock_01	Cytadela Lodowej Korony! Znajdziesz tu najplugawszych stronników, których stworzyłem nie z pyłu… lecz z NIENAWIŚCI!	
VO_LichKing_Male_Human_PrologueBossCoin_01	Czekam na ciebie! Zniszczę cię i przerobię na tajemny pył!	
VO_LichKing_Male_Human_PrologueBossCoin_02	Poskładałem tę kościaną paskudę ze szczątków duplikatów moich kart.	
VO_LichKing_Male_Human_PrologueBossCoin_03	Siewca Śmierci Zaurzykieł to mój pierwszy legendarny stronnik. Na nim oparłem całą tę przygodę.	
VO_LichKing_Male_Human_PrologueBossCoin_04	Oto Morowa Pani. Przed nerfem!	
VO_LichKing_Male_Human_PrologueBossCoin_05	Profesor Przebrzyd odpowiada za mój system dobierania kart. Ale zamiast dobierać, ciągle coś podbiera do swojego laboratorium. Nie przepadam za gościem.	
VO_LichKing_Male_Human_PrologueBossCoin_07	Szlag, Lana’thel! Na moich kartach są ŚLADY KŁÓW! Miałaś je powkładać do koszulek!	
VO_LichKing_Male_Human_PrologueBossCoin_08	Sindragosę zostawiam zawsze na koniec! Łapy przy sobie! Nie dam ci jej!	
VO_LichKing_Male_Human_PrologueBossCoin_09	Będziesz błagać o litość. Klikniesz „Poddaj się”, a ja odmówię.	
VO_LichKing_Male_Human_PrologueBossCoin_11	Spójrz, co masz w ręce. Zobacz, czym się stajesz. Czy naprawdę tak bardzo się różnimy?	
VO_LichKing_Male_Human_PrologueBossCoin_12	Staję tu jak lew przed owcami… a one nie okazują lęku.	
VO_LichKing_Male_Human_ResponseAnubaArak_01	Bądź moim sługą, Anub'araku!	
VO_LichKing_Male_Human_ResponseMalganis_01	Ile razy muszę cię pokonać, Mal'Ganisie?	
VO_LichKing_Male_Human_UpperReachesLock_01	Chcesz obrócić moją moc przeciwko mnie? No to do dzieła, a ja tymczasem poszukam w sieci jakiejś talii, od której ten świat spowije wieczna ciemność.	
VO_LichKing_Male_Human_UpperReachesUnlock_01	Chcesz obrócić moją moc przeciwko mnie? Masz pojęcie, ile razy osiągnąłem rangę legendy?	
VO_LOE_01_DEATH_2	Oryzysie! Pomścij mnie!	
VO_LOE_01_RESPONSE	Drżyj przed gniewem słońca!	
VO_LOE_01_STAFF	Ha ha! Jest moja!	
VO_LOE_01_STAFF_2	Spłoniesz!	
VO_LOE_01_STAFF_2_RENO	Lepiej pilnuj tej różdżki. Jest cenna.	
VO_LOE_01_START	Jestem NIEZWYCIĘŻONY!	
VO_LOE_01_WIN	Ha ha! Mam różdżkę! Gdyby tylko Harrison mnie teraz widział!	
VO_LOE_01_WIN_2	Bierz różdżkę!	
VO_LOE_01_WIN_2_ALT_2	Eee… Czy to normalne, że ziemia tak drży?	
VO_LOE_01_WOUNDED	Już prawie po nim! Wykończ go!	
VO_LOE_02_DEATH	Znowu do lampy?! Nieee!	
VO_LOE_02_INTRO	Różdżka Słońca jest MOJA!	
VO_LOE_02_MORE_WISHES	A niech mnie. Nie wierzę, że to zadziałało.	
VO_LOE_02_PHAERIX_STAFF_RECOVER	Nigdy nie pojmiesz potęgi różdżki!	
VO_LOE_02_RESPONSE	Niezwykła moc kosmiczna!	
VO_LOE_02_START	Wreszcie wolny! W nagrodę dam ci szybką śmierć!	
VO_LOE_02_START2	Awanturniku! Jestem Reno Jackson, światowej sławy archeolog, odkrywca i łowca skarbów.	
VO_LOE_02_START3	Chytry jak lis. Pazerny jak sroka.	
VO_LOE_02_TURN_10	Tylko pomyśl, odkrywco – Kostur Stworzenia! Ha! Jest wart tysiące!	
VO_LOE_02_TURN_6	Czy opowiadałem ci, jak kiedyś w przebraniu wmieszałem się w grupę ogrów w pewnych ruinach w Feralas?	
VO_LOE_02_TURN_6_2	A o tym, jak przekradałem się przez Lykeion Czarnej Góry, żeby zdobyć...	
VO_LOE_02_WIN	Naprzód! Różdżka znajduje się na końcu tego korytarza!	
VO_LOE_02_WISH	To miło z jego strony, że jest skłonny spełniać nasze życzenia jednocześnie PRÓBUJĄC NAS ZABIĆ.	
VO_LOE_03_RESPONSE	Szybciej!	
VO_LOE_03_TURN_1	Sufit się wali, a wszędzie są potwory! Szybciej!	
VO_LOE_03_TURN_10	Już niedaleko! Widzę słońce!	
VO_LOE_03_TURN_2	Spójrz na to! Świecąca sadzawka. Chcesz ją zbadać?	
VO_LOE_03_TURN_2_2	Nie ma na to czasu!	
VO_LOE_03_TURN_3	Hmm... W prawo czy w lewo?	
VO_LOE_03_TURN_3_BOULDER	Ten głaz jest ogromny! Z drogi!	
VO_LOE_03_TURN_3_WARNING	To dudnienie jest coraz głośniejsze. Założę się, że w następnej turze zawali się sufit!	
VO_LOE_03_TURN_4	Hej, jama z kolcami!	
VO_LOE_03_TURN_4_BAD	Ojojoj! Miło to nie wygląda!	
VO_LOE_03_TURN_4_GOOD	Nieźle! PRAWIE tak dobrze jak ja.	
VO_LOE_03_TURN_4_NEITHER	Czołgasz się pomiędzy tymi kolcami, czy jak? Żwawiej, żwawiej!	
VO_LOE_03_TURN_5	Jaki ładny posąg. I jaki lśniący rubin...	
VO_LOE_03_TURN_5_4	Oj, nie jest zadowolony. Chyba chce odzyskać swój klejnot.	
VO_LOE_03_TURN_6	Uwaga! Sufit się wali!	
VO_LOE_03_TURN_6_2	Uff! Mało brakowało! Uratowałem cię w ostatniej chwili! Drobiazg.	
VO_LOE_03_TURN_7	Hm… Niech to, ciemno że oko wykol, ale to najszybsza droga do wyjścia. Ruszajmy!	
VO_LOE_03_TURN_7_2	Na mojej mapie jest tylko jedna wskazówka: „Nie idź tam!”.	
VO_LOE_03_TURN_8	Uff! Robi się gorąco. Musimy się pospieszyć!	
VO_LOE_03_TURN_9	Uch. Dlaczego to zawsze muszą być robale?	
VO_LOE_03_WIN	Udało się! Nie sądziłem, że kiedykolwiek ucieszy mnie widok tej pustyni! A teraz… Wody!	
VO_LOE_04_RESPONSE	Trogg rozwalać gupki!	
VO_LOE_04_SCARVASH_TURN_2	Trogg nie gupi. Trogg sprawia ty gupi.	
VO_LOE_04_START	Uldaman TYLKO dla troggi!	
VO_LOE_04_WIN	Jest ich jeszcze więcej! Tędy, wskakuj do wagonika!	
VO_LOE_07_RESPONSE	Naprawdę masz na to czas?	
VO_LOE_07_START	Uwaga, gonią nas!	
VO_LOE_07_WIN	Ha ha! Ucieczka wagonikami i rzucanie bomb! Ale jazda!	
VO_LOE_08_ANIMATE_STONE	Ziemio i kamieniu, przebudźcie się!	
VO_LOE_08_LANDSLIDE	Zniszczę was!	
VO_LOE_08_RESPONSE	Jesteście niczym pył.	
VO_LOE_08_START	Kto naraża się na gniew stwórców?	
VO_LOE_08_WIN	Górna część jest nasza! Brakuje już tylko jednej!	
VO_LOE_092_Attack_02	Patrzcie!	
VO_LOE_10_NYAH	Mrrrglmrrrgl Nyah!	
VO_LOE_10_RESPONSE	Mrglmrrglrmrrgl.	
VO_LOE_10_RESPONSE_ALT_read	(Średniopłetwie, co ty tutaj robisz!?)	
VO_LOE_10_START	Mrglmrglmrgl.	
VO_LOE_10_START_2	Naprawdę? To było wyjątkowo niegrzeczne.	
VO_LOE_10_TURN_2_GIANTFIN	MRRRGL! MRRRGLMRGL!	
VO_LOE_10_TURN1	Mrrrgl! Mrrglrrglmrgl.	
VO_LOE_10_WIN	A to szkoda. Gdyby tylko lepiej go wychowano, mógłby wyrosnąć na porządnego płetwonoga.	
VO_LOE_12_NAZJAR_PEARL	Coś niesamowitego! Perła Pływów jest piękniejsza niż się spodziewałem.	
VO_LOE_12_NAZJAR_TURN_1	Jestem ostrzem Aszary. Kto śmie stawać przeciwko mnie?	
VO_LOE_12_NAZJAR_TURN_1_FINLEY	Jestem sir Płetwin Mrrgglton. Bardzo mi miło.	
VO_LOE_12_NAZJAR_TURN_3_FINLEY	Elizo, jak radzi sobie reszta?	
VO_LOE_12_NAZJAR_TURN_5	Armie głębin, zalejcie naszych wrogów niczym fala śmierci!	
VO_LOE_12_NAZJAR_TURN_5_FINLEY	To zabrzmiało dość radykalnie.	
VO_LOE_12_NAZJAR_TURN_7_FINLEY	Mrgggl! MRRGLMRRGL!	
VO_LOE_12_NAZJAR_TURN_7_FINLEY_2	Wybacz, odkrywco. Czasem trochę się zapominam.	
VO_LOE_12_RESPONSE	Władam mocą perły!	
VO_LOE_12_START	Pochłonie was potęga fal!	
VO_LOE_12_WIN	Brawo! Perła jest nasza! Zechciej udać się ze mną do Sali Odkrywców, gdzie wspólnie złożymy artefakt!	
VO_LOE_13_RESPONSE	RAAAAA!	
VO_LOE_13_START_2	Raaaa!	
VO_LOE_13_TURN_1	Kostur był przeklęty! Przywołał Eterycznego pomimo znaków ochronnych. A on wszystko stąd kradnie!	
VO_LOE_13_TURN_1_2	Nie wszystko. Tylko co lepsze rzeczy.	
VO_LOE_13_TURN_5	Ooo, czy to naprawdę sygnet Arthasa? I to w idealnym stanie.	
VO_LOE_13_TURN_5_2	Reno, Brann, ukryjcie artefakty!	
VO_LOE_13_TURN_9	Ożywia całą armię! Elizo, powstrzymaj go!	
VO_LOE_13_TURN_9_2	Tel'zaxus Nalore! Kostur jest zbyt potężny, ale mogę go spowolnić!	
VO_LOE_13_WIN	Zajmiemy się eksponatami. Odkrywco, dotrzyj do Rafaama!	
VO_LOE_14_RESPONSE	*BRZDĘK*	
VO_LOE_14_START	No, to zbroja Lothara! Miesiącami grzebałem w smoczym łajnie na Czarnej Górze żeby ją znaleźć.	
VO_LOE_14_TURN_13	Brann, on ożywia książki z biblioteki! Ja zajmę się latającymi młotkami z wystawy poświęconej Lordaeronowi.	
VO_LOE_14_TURN_5	Poradziłem sobie z ożywionymi mieczami we wschodnim korytarzu. Elizo, komu powinienem pomóc?	
VO_LOE_14_TURN_5_2	Pomóż Renowi w głównym magazynie! Otoczyły go Hukoboty!	
VO_LOE_14_TURN_9	Jesteście chyba dość zajęci. Pozwólcie, że zaopiekuję się tą śliczną broszą.	
VO_LOE_14_WIN	Muzeum zabezpieczone. Odkrywco, daj Rafaamowi zakosztować walki!	
VO_LOE_15_RESPONSE	Cóż za wspaniałe karty!	
VO_LOE_15_SPARE	Odkrywco! Mamy dodatkową talię, zrób z niej użytek!	
VO_LOE_16_BOOM_BOT	O tak… Tego akurat mamy w nadmiarze. Wykończ go!	
VO_LOE_16_CROWN	Manifestacja mocy magicznych maniakalnego maga.	
VO_LOE_16_EYE	Ha, ciekawe. Cały czas miałem to w kieszeni – chyba możesz pożyczyć.	
VO_LOE_16_FIRST_ITEM	Poszukamy w muzeum przydatnych rzeczy. Daj znać, jeśli będzie ci czegoś trzeba!	
VO_LOE_16_GOBLET	Nienawidzę węży.	
VO_LOE_16_GREAVE	Część zbroi Lothara pozostała nienaruszona po zezłomowaniu.	
VO_LOE_16_LOCKET	Ten medalion nawiedzają duchy Karazhanu.	
VO_LOE_16_PIPE	Trzymaj! Tylko nie mów Brannowi – uwielbia tę fajkę!	
VO_LOE_16_RAFAAM_DEATH2	NIE! Nie można mnie pokonać!	
VO_LOE_16_SHARD	Znalazłem to w pudełku z napisem „NIE OTWIERAĆ”. No cóż... Powodzenia!	
VO_LOE_16_SPLINTER	Znalazłem to w Ognistej Czeluści. Majordomus używał tego do dłubania w zębach.	
VO_LOE_16_START_2	Kostur się ładuje. Uwaga!	
VO_LOE_16_TEAR	To święty artefakt mojego ludu. Pij szybko!	
VO_LOE_16_TURN_2	Kostur jest już niemal naładowany. Przygotuj się!	
VO_LOE_16_TURN_2_2	HA HA HA! WSZECHOGARNIAJĄCA MOC!	
VO_LOE_16_TURN_2_3	Kostur jest naładowany! To nasza szansa!	
VO_LOE_16_TURN_3	Jestem niezwyciężony! Nigdy mnie nie pokonacie!	
VO_LOE_16_TURN_3_2	Kostur znów się ładuje. Za chwilę nadarzy się kolejna okazja.	
VO_LOE_16_TURN_4	Kostur jest prawie gotowy. Skup się!	
VO_LOE_16_TURN_5	HA HA HA! WSZECHOGARNIAJĄCA MOC!	
VO_LOE_16_TURN_5_2	Padły mu osłony! Do dzieła!	
VO_LOE_16_TURN_6	Osłona znów aktywna. Ostrożnie!	
VO_LOE_16_VIAL	Na etykietce jest napis „WYPIJ MNIE”. Znaleźliśmy to w Naxxramas, więc nikt nie ważył się spróbować.	
VO_LOE_ARCHAEDAS_TURN_1_CARTOGRAPHER	Gdyby tylko nie był tak zajęty wdeptywaniem cię w ziemię.	
VO_LOE_GIANTFIN_TIDEHUNTER_2	Nie, Płetwinie. Już wtedy byłeś inny.	
VO_LOE_NAZJAR_TURN_3_CARTOGRAPHER	Reno wrócił z Różdżką Słońca, a Brann jest w drodze.	
VO_LOE_SCARVASH_TURN_6_CARTOGRAPHER	Skup się, Brann!	
VO_LOE_ZINAAR_TURN_10_CARTOGRAPHER_2	Nie będziemy go sprzedawać.	
VO_LOE_ZINAAR_TURN_6_CARTOGRAPHER_2	Tak.	
VO_LOE_ZINAAR_TURN_6_CARTOGRAPHER_2_ALT	Tak.	
VO_LOE10_DEAD_MURLOCS	Tyle ofiar. Jaka szkoda.	
VO_LOE10_NYAH_FINLEY	Przestań się mazać, murloki nie płaczą.	
VO_LOE10_TIDEHUNTER	Dorastałem jako brzegowiec, zanim odnalazła mnie Eliza. Czy podzieliłbym ten los?	
VO_LOE10_TURN_2_FINLEY	Moi bracia, współpracujcie z nami. Nie musimy walczyć!	
VO_LOE10_TURN_2_FINLEY_2	Chyba należało się tego spodziewać.	
VO_LOEA04_BRANN_TURN_1	Kiedy zawitałem tu ostatnim razem, Skarwosz był jeszcze małym troggiem. Teraz jest większy, głupszy i brzydszy.	
VO_LOEA04_BRANN_TURN_6	Fascynujące. W tych mithrilowych runach zawarty jest kod strażników. Muszą pochodzić z czasów Tytanów!	
VO_LOEA07_MINE_ALMOST_DONE	Robię, co mogę! Ciekawe do czego służy ten guzik...	
VO_LOEA07_MINE_ARCHAEDAS	NA BRODĘ MAGNIEGO! CZY TO SAM ARCHAEDAS?!	
VO_LOEA07_MINE_BARREL_FORWARD	Cała naprzód!	
VO_LOEA07_MINE_BOOM	Skaczące bomby! To będzie dla nich nauczką!	
VO_LOEA07_MINE_BOOMZOOKA	Bum!!! Lepiej naładuję, żeby oddać kolejny strzał!	
VO_LOEA07_MINE_DETONATE	Chcesz wysadzić szyb? PORĄBAŁO CIĘ?!	
VO_LOEA07_MINE_DYNAMITE	Ostrożnie z tym! Rozwaliło część torów!	
VO_LOEA07_MINE_HUNKER_DOWN	Kryć się!	
VO_LOEA07_MINE_PARROT	Leć, Dżino!	
VO_LOEA07_MINE_RAMMING	Ha ha! Z drogi śledzie!	
VO_LOEA07_MINE_REPAIRS	Trochę kleju żołądkowego i będzie jak nowe!	
VO_LOEA07_MINE_SPIKED_DECOY	Hej, głupie troggi! Spróbujcie mnie dorwać!	
VO_LOEA08_TURN_1_BRANN	Sługa przedwiecznych Tytanów... Ależ historie mógłby nam opowiedzieć!	
VO_LOEA09_1_RESPONSE	Więcej na obiad!	
VO_LOEA09_1_TURN1	Ośmielacie się wkraczać do Zrujnowanego Miasta?	
VO_LOEA09_FINLEY_DEATH	Zaraz się pozbieram. Odkrywco, załatw tę śliską nagę!	
VO_LOEA09_HERO_POWER	Pora obiadowa! Dziś jemy zupę z murloka!	
VO_LOEA09_HERO_POWER1	Witaj, odkrywco. Chyba mam mały problem. Zechcesz pomóc koledze?	
VO_LOEA09_HERO_POWER2	Nie powiem, strasznie tu ciemno.	
VO_LOEA09_HERO_POWER3	Ojej. Czyżby robiło się cieplej?	
VO_LOEA09_HERO_POWER4	To dość nieprzyjemne, muszę przyznać.	
VO_LOEA09_HERO_POWER5	Zdecydowanie jest tu gorąco.	
VO_LOEA09_HERO_POWER6	Mała pomoc byłaby mile widziana.	
VO_LOEA09_QUOTE1	Dziękuję, stary druhu! Niewiele brakowało!	
VO_LOEA09_UNSTABLE	Wracaj do kotła!	
VO_LOEA09_WIN	Masz moją wdzięczność, odkrywco. Pozwolisz, że wskażę ci drogę do ostatniej części?	
VO_LOEA10_1_MIDDLEFIN	(Średniopłetwie, co ty tutaj robisz!?)	
VO_LOEA15_1_LOSS_11	Twoja talia jest beznadziejna. Pora sięgnąć po własną.	
VO_LOEA15_1_LOW_HEALTH_10	Chyba popełniłem błąd, biorąc twoją talię.	
VO_LOEA15_1_MAGMA_RAGER_09	Wulkaniczny furiat?! Po co zagrywać tę kartę?!	
VO_LOEA15_1_START_07	Podoba mi się twoja talia. Chyba ci ją ZABIORĘ.	
VO_LOEA15_1_TURN1_08	O tak. To talia jest NIESAMOWITA.	
VO_LOEA15_1_WIN_12	Twoja talia jest ŚWIETNA. Ha ha ha!	
VO_LOEA15_GOLDEN	Czy w tej talii są same ZŁOTE KARTY? Twoja kolekcja dorównuje mojej!	
VO_LOEA16_1_CARD_04	Mam artefakty z SETEK różnych światów!	
VO_LOEA16_1_RESPONSE_03	Tak! TAK!	
VO_LOEA16_1_START_01	Poznajcie PEŁNIĘ MOCY kostura!	
VO_LOEA16_1_TURN1_02	Jestem niezwyciężony! Mam moc Tytanów!	
VO_LOOT_329_Male_Elemental_Attack_01	Skiśnij.	
VO_LOOT_329_Male_Elemental_Death_01	<Death>	
VO_LOOT_329_Male_Elemental_Play_01	Kto żyje, ten zgnije.	
VO_LOOT_541_Male_Kobold_BOSS_AFKay_01	Dorwij ją! Zanim się skuma, że ma się z tobą bić!	
VO_LOOT_541_Male_Kobold_BOSS_Blackseed_01	Czarnosiej zapuszcza się głęboko w tunele i wraca z takimi... bleeeee... paskudnymi mackami.	
VO_LOOT_541_Male_Kobold_BOSS_Brimstone_01	Ciiiiiiiii! Te posągi mają oczy, więc stała czujność. I nie mrugaj!	
VO_LOOT_541_Male_Kobold_BOSS_Candlebeard_01	Woskobrody myśli, że zakopywanie skarbów zrobi z kobolda pirata.	
VO_LOOT_541_Male_Kobold_BOSS_Chronomancer_01	Czasowiedźma! Znowu się spotykamy pierwszy raz!	
VO_LOOT_541_Male_Kobold_BOSS_Everrot_01	Łapy z dala od zarodników! Wyślij stronnika, żeby pacnął.	
VO_LOOT_541_Male_Kobold_BOSS_Flurgl_01	Kobold murloka nie skuma – gada taki jak niegadacz.	
VO_LOOT_541_Male_Kobold_BOSS_GeorgeKarl_01	Te dwa wesołki któregoś dnia po prostu wzięły się znikąd.	
VO_LOOT_541_Male_Kobold_BOSS_Gnosh_01	Ten tunel to wcale nie żaden tunel! Ogromniasta paszcza! Ostre zębiska!	
VO_LOOT_541_Male_Kobold_BOSS_Graves_01	Ten uzdrowiciel, co to się zgubił, to by chciał wszystkich uzdrawiać i nauczać. Weź go załatw!	
VO_LOOT_541_Male_Kobold_BOSS_Gutmook_01	Troggi, blech. Czymaj gębę na kłódkę i niech stronnicy się męczą.	
VO_LOOT_541_Male_Kobold_BOSS_Hamm_01	Homm kopie tunele jak mało kto! Tylko z tym kopaniem to taka mientka fora jest.	
VO_LOOT_541_Male_Kobold_BOSS_Jeeru_01	O nie, nie, nie, nie, nie! Nie trzyj lampy! Paskudna pułapka!	
VO_LOOT_541_Male_Kobold_BOSS_Lyris_01	Stuknięte elfie wiedźmisko! Uważaj na te jej sprytne żarzyludki!	
VO_LOOT_541_Male_Kobold_BOSS_MagmaRager_01	Koboldy zabijają deskami ujście lawy, ale jakoś nigdy nie załatwia to sprawy.	
VO_LOOT_541_Male_Kobold_BOSS_Mothergloop_01	Uważaj na Szlamamę, mamę całego szlamu!	
VO_LOOT_541_Male_Kobold_BOSS_Mushhuckster_01	Brejarza Maksa przywiało z okropecznie szemranego tunelu. Nie łaź tam.	
VO_LOOT_541_Male_Kobold_BOSS_Russell_01	Koboldy nie są za bardzo muzyczne, ale ten bard to już przegina pałę goryczy.	
VO_LOOT_541_Male_Kobold_BOSS_Seriona_01	Wstrętne smoczydło. Od zmierzchu do_świtania daje nam, koboldom, w_kość.	
VO_LOOT_541_Male_Kobold_BOSS_Sturmi_01	Szturmia lepi takich fajowych woskowych koleżków! Robi furorę na koboldzich imprezach.	
VO_LOOT_541_Male_Kobold_BOSS_TrappedRoom_01	Ciiiii... Nie macaj tu... NICZEGO...	
VO_LOOT_541_Male_Kobold_BOSS_TreasureVault_01	Tyle tu skarbów, cała góra. A ty będziesz panoszyć się i kraść!	
VO_LOOT_541_Male_Kobold_BOSS_Troll_01	Tak wiem, zawsze musi być troll jako boss. Ja nie wiem skąd się biorom, ja tu tylko króluję!	
VO_LOOT_541_Male_Kobold_BOSS_Whopwhisker_01	Nikt nie łazi taki rozeźlony jak stary poczciwy Wyrwiwąs, he he.	
VO_LOOT_541_Male_Kobold_DefeatPlayer_01	Tyyyyyle skarbów! He he… Moje, moje, moje, moje.	
VO_LOOT_541_Male_Kobold_EmoteResponse_01	A tam, cicho być!	
VO_LOOT_541_Male_Kobold_LOOT_Backpacks_01	Jeszcze więcej miejsca na epickie łupy, taki to pożyje!	
VO_LOOT_541_Male_Kobold_LOOT_Boombox_01	Huczna skrzynia! Najhuczniejsza ze wszystkich!	
VO_LOOT_541_Male_Kobold_LOOT_Candle1_01	Moja świecunia, moja!	
VO_LOOT_541_Male_Kobold_LOOT_Candle2_01	Czy ty mnie w ogóle słuchasz? Mówię, że moja, a ty i tak bierzesz!	
VO_LOOT_541_Male_Kobold_LOOT_CapturedFlag_01	I w Hordzie, i w Przymierzu wszyscy mają kręćka na punkcie tych flag.	
VO_LOOT_541_Male_Kobold_LOOT_Cube_01	Ooo, wariacki sześcian! Przydaje się, jak już nie ma szans na wygraną!	
VO_LOOT_541_Male_Kobold_LOOT_Invisibility_01	Peleryna niewidka! Ciągle ją gubię, bo ona taka niewidzialna.	
VO_LOOT_541_Male_Kobold_LOOT_QuelDelar_01	Quel'delar! Legendarny miecz pęknięty na pół. Nie moja wina.	
VO_LOOT_541_Male_Kobold_LOOT_QuelDelarForged_01	Taki ładniutki! Taki lśniący! Taki... mieczowaty!	
VO_LOOT_541_Male_Kobold_LOOT_Wand_01	Koboldy wielbią Kijek pożogi, bo tak oddziela się koboldy od koboldziątek, he he.	
VO_LOOT_541_Male_Kobold_LOOT_WaxRager_01	Woskowy furiat to krzepki koleżka. Nie pytaj, skąd ten wosk. No dobra, z uszów!	
VO_LOOT_541_Male_Kobold_TUT_AdventureSelect_01	A co to za zapaszek? Hmm... Skóra? Stal? Pochodnie... No nie! To AWANTURNICY!	
VO_LOOT_541_Male_Kobold_TUT_BossHeroPower_01	Każdy potwór umie co innego. Ale zawsze niemiłego. Kliknij i zobacz!	
VO_LOOT_541_Male_Kobold_TUT_BountyBoard_01	Stój! Idź skąd cię przywiało! Te stosy łupów są MOJE, a nie TWOJE.	
VO_LOOT_541_Male_Kobold_TUT_CharacterSelect_01	Kto wyciąga łapska po koboldzie skarby, hę? Rębajło? Czarownica?	
VO_LOOT_541_Male_Kobold_TUT_Final_Boss_Azari_01	Wypuścili Pożeracza! W nogi!	
VO_LOOT_541_Male_Kobold_TUT_Final_Boss_Darkness_01	Ciemności czeba się bać! Dlatemu koboldy mają świecunie.	
VO_LOOT_541_Male_Kobold_TUT_Final_Boss_KoboldKing_01	Moja kolej, hie hie! Oj dam ci łupnia, i złupię te wszystkie twoje łupy.	
VO_LOOT_541_Male_Kobold_TUT_Final_Boss_Vustrasz_01	Masz chrapkę na smocze skarby? Ojojoj, smoczydło nie będzie najzadowoleńsze…	
VO_LOOT_541_Male_Kobold_TUT_Final_Boss_Xol_01	Tylko nie pacz Xol w oczy! A oczysk ma od groma na tej swojej twarzuni.	
VO_LOOT_541_Male_Kobold_TUT_Game1Begin1_01	Pierwsze potwory to krzepy nie mają. Ale ty też nie!	
VO_LOOT_541_Male_Kobold_TUT_Game1Begin2_01	Bedziesz je pacać i brać ich rzeczy, co by mieć więcej krzepy!	
VO_LOOT_541_Male_Kobold_TUT_Game1Defeat_01	Nie ma co się mazać. Lepiej wyciągnąć nogi za młodziaka niż wogle!	
VO_LOOT_541_Male_Kobold_TUT_Game1Victory_01	No i wygrywasz! Łup jest twój. Hie hie. Awanturnik co się zowie!	
VO_LOOT_541_Male_Kobold_TUT_Game2Begin1_01	Jak ty bedziesz nabierać krzepy, to potwory też.	
VO_LOOT_541_Male_Kobold_TUT_Game2Begin2_01	No bo wiesz… Gospodarka koboldziego imperium opiera się na doktrynie elastyczności finansowej.	
VO_LOOT_541_Male_Kobold_TUT_GeneralDefeat1_01	Co za pech. Twój pech. Jak awanturnik kipnie, to król koboldów zgarnia wszystkie łupy, he he.	
VO_LOOT_541_Male_Kobold_TUT_GeneralDefeat2_01	Awanturnicy mile widziani! He he! Więcej trupów, więcej łupów, he he – dla mnie, dla mnie!	
VO_LOOT_541_Male_Kobold_TUT_MainBoss1_01	Różniaste potwory się kręcą po koboldzim imperium. Każda walka cię wzmocni! ...Chyba że ukatrupi.	
VO_LOOT_541_Male_Kobold_TUT_MainBoss3_01	Jedna wyprawa w podziemie, to osiem bossów do pacnięcia. Czyli tyle co paluchów u rąk!	
VO_LOOT_541_Male_Kobold_TUT_TreasureSelect1_01	Oooo, skarb jak się patrzy! Wybierz se, ale tylko jeden. Z głową wybierz.	
VO_LOOT_541_Male_Kobold_TUT_TreasureSelect2_01	Teraz wybierasz se karty, co to pójdą do twojej Talii podziemi.	
VO_LOOT_541_Male_Kobold_TUT_TreasureSelect3_01	Zrób se talię do pacania potworów. To bedzie twoja talia, aż kopniesz w kalendarz!	
VO_LOOT_541_Male_Kobold_TUT_TreasureSelect4_01	Im więcej wygrasz walk, tem więcej zgarniasz łupów. Tak to się robi po koboldziemu!	
VO_LOOT_541_Male_Kobold_TUT_Victory1_01	Coooo? Nikt nie wyłazi na powierzchnię z worem koboldzich skarbów!	
VO_LOOT_541_Male_Kobold_TUT_Victory2_01	A już na pewno nie dziewięć razy!	
VO_LOOT_541_Male_Kobold_TUT_VictoryComplete_01	Udało ci się! Taki z ciebie miszcz podziemi, że nie ma to tamto!	
VO_LOOT_541_Male_Kobold_TUT_VictoryComplete_02	Udało ci się! Jesteś miszcz podziemi pełną gębą!	
VO_LOOTA_829_Male_Human_Event_01	Za tę zdradę pochłoną mnie podziemia!	
VO_LOOTA_BOSS_04h_Female_Kobold_Death_01	<Death>	
VO_LOOTA_BOSS_04h_Female_Kobold_DefeatPlayer_01	Nie ruszaj się! Niech wosk ostygnie... Taka ładna buźka, ładniuteńka...	
VO_LOOTA_BOSS_04h_Female_Kobold_EmoteResponse_01	Jestem woskomantka, a nie żadna woskowa wiedźma.	
VO_LOOTA_BOSS_04h_Female_Kobold_EventWaxOff_01	I zdejmujemy wosk.	
VO_LOOTA_BOSS_04h_Female_Kobold_EventWaxOn_01	No to woskujemy!	
VO_LOOTA_BOSS_04h_Female_Kobold_EventWaxRagerPlay_01	Ooo... Przystojniaczek!	
VO_LOOTA_BOSS_04h_Female_Kobold_EventWaxRagerRespawn_01	Wraca i wraca, co nie?	
VO_LOOTA_BOSS_04h_Female_Kobold_Intro1_01	O tak, hmm, wosk ma oczy...	
VO_LOOTA_BOSS_04h_Female_Kobold_Intro2_01	Lepię z wosku takie śliczne woskusie.	
VO_LOOTA_BOSS_05h_Male_Kobold_Death_01	<Zgon>	
VO_LOOTA_BOSS_05h_Male_Kobold_DefeatPlayer_01	Moje bum robi szum!	
VO_LOOTA_BOSS_05h_Male_Kobold_EmoteResponse_01	Moje bum bum, moje!	
VO_LOOTA_BOSS_05h_Male_Kobold_EventBoomBots_01	Super. SUPER! Super super super!	
VO_LOOTA_BOSS_05h_Male_Kobold_EventMadBomberDeath_01	AAAAAAA! No ale nie taaak!	
VO_LOOTA_BOSS_05h_Male_Kobold_HeroPower1_01	Bum jak się patrzy. Ha ha! BUM!	
VO_LOOTA_BOSS_05h_Male_Kobold_HeroPower2_01	Hahaha!	
VO_LOOTA_BOSS_05h_Male_Kobold_HeroPower3_01	Hahahaha!	
VO_LOOTA_BOSS_05h_Male_Kobold_Intro_01	Hehehe! Czas na rozwałkę!	
VO_LOOTA_BOSS_06h_Male_Furbolg_Death_01	Jest jeszcze jeden, tam, na dole...	
VO_LOOTA_BOSS_06h_Male_Furbolg_DefeatPlayer_01	Czy… czy zabiłem tę istotę? Cóż uczyniłem…	
VO_LOOTA_BOSS_06h_Male_Furbolg_EmoteResponse_01	Jesteś tylko kolejnym... głosem...	
VO_LOOTA_BOSS_06h_Male_Furbolg_EventPlayerEvolves_01	Dotknęła cię ciemność.	
VO_LOOTA_BOSS_06h_Male_Furbolg_HeroPower1_01	Słyszę, jak nawołuje...	
VO_LOOTA_BOSS_06h_Male_Furbolg_HeroPower2_01	Te jaskinie sięgają głęboko.	
VO_LOOTA_BOSS_06h_Male_Furbolg_HeroPower3_01	Wszystko jest inne, niż się wydaje...	
VO_LOOTA_BOSS_06h_Male_Furbolg_HeroPower4_01	Kto tu jest potworem?	
VO_LOOTA_BOSS_06h_Male_Furbolg_HeroPower5_01	Ty nie widzisz cieni... Ale one widzą ciebie.	
VO_LOOTA_BOSS_06h_Male_Furbolg_Intro_01	Coś nikczemnego w tych tunelach kopie...	
VO_LOOTA_BOSS_09h_Female_Furbolg_Death_01	<Death>	
VO_LOOTA_BOSS_09h_Female_Furbolg_DefeatPlayer_01	Tak załatwiamy sprawy w Zimozdroju.	
VO_LOOTA_BOSS_09h_Female_Furbolg_EmoteResponse_01	Powiało chłodem.	
VO_LOOTA_BOSS_09h_Female_Furbolg_EventFrostMagic1_01	Ty również znasz potęgę chłodu.	
VO_LOOTA_BOSS_09h_Female_Furbolg_EventFrostMagic2_01	Brrrrrr!	
VO_LOOTA_BOSS_09h_Female_Furbolg_EventFrostMagic3_01	Jaki mróz!	
VO_LOOTA_BOSS_09h_Female_Furbolg_HeroPower1_01	Posiedź tu chwilę.	
VO_LOOTA_BOSS_09h_Female_Furbolg_HeroPower2_01	Tylko bez takich.	
VO_LOOTA_BOSS_09h_Female_Furbolg_HeroPower3_01	Nie ruszaj się.	
VO_LOOTA_BOSS_09h_Female_Furbolg_Intro_01	Mówiłam wam, koboldy, żebyście... o,_kogo tu przyniosło?	
VO_LOOTA_BOSS_10h_Male_Human_Death_01	Pewnie tak musiało być...	
VO_LOOTA_BOSS_10h_Male_Human_DefeatPlayer_02	Rekwiruję te skarby. W imieniu Światłości! I dla siebie.	
VO_LOOTA_BOSS_10h_Male_Human_EmoteResponse_01	Błaganie o łaskę na nic ci się nie zda.	
VO_LOOTA_BOSS_10h_Male_Human_EventOverdraw_01	Uch… Kapłanka jest nieco zbyt gorliwa!	
VO_LOOTA_BOSS_10h_Male_Human_HeroPower1_01	Uwierz!	
VO_LOOTA_BOSS_10h_Male_Human_HeroPower2_01	Uzdrawiam was!	
VO_LOOTA_BOSS_10h_Male_Human_HeroPower3_01	Odrzuć ciemność!	
VO_LOOTA_BOSS_10h_Male_Human_HeroPower4_01	Światłość jest litościwa.	
VO_LOOTA_BOSS_10h_Male_Human_HeroPower5_01	Cudownie!	
VO_LOOTA_BOSS_10h_Male_Human_Intro_01	Stój! Rekwiruję te skarby w imieniu Światłości!	
VO_LOOTA_BOSS_11h_Male_Trogg_Death_01	<Death>	
VO_LOOTA_BOSS_11h_Male_Trogg_DefeatPlayer_01	Dobry przywódca wie, że najlepiej motywuje trzask bicza.	
VO_LOOTA_BOSS_11h_Male_Trogg_EmoteResponse_01	Gadanie nie wygrywa. Bicz wygrywa!	
VO_LOOTA_BOSS_11h_Male_Trogg_EventEquality_01	Baaaaah, i jak tu trzaskać takie chuchra?	
VO_LOOTA_BOSS_11h_Male_Trogg_HeroPower1_01	No ruchy, ruchy!	
VO_LOOTA_BOSS_11h_Male_Trogg_HeroPower2_01	Do roboty!	
VO_LOOTA_BOSS_11h_Male_Trogg_HeroPower3_01	Szybciej!	
VO_LOOTA_BOSS_11h_Male_Trogg_HeroPower4_01	Nie ociągać się!	
VO_LOOTA_BOSS_11h_Male_Trogg_HeroPower5_01	Bicz trzaska aż miło!	
VO_LOOTA_BOSS_11h_Male_Trogg_Intro_01	Czas na ból!	
VO_LOOTA_BOSS_12h_Male_Kobold_CandleAttack1_01	Chcesz rozeźlić świecunię?!	
VO_LOOTA_BOSS_12h_Male_Kobold_CandleAttack2_01	Nie prowokuj świecuni!	
VO_LOOTA_BOSS_12h_Male_Kobold_CandleAttack3_01	Rakaniszu!	
VO_LOOTA_BOSS_12h_Male_Kobold_CandleAttack4_01	Świecunia do boju!	
VO_LOOTA_BOSS_12h_Male_Kobold_CandleAttack5_01	Świecunia nie dla słabych!	
VO_LOOTA_BOSS_12h_Male_Kobold_Death_01	Moja... świecunia...	
VO_LOOTA_BOSS_12h_Male_Kobold_Death1_01	Idę na dno!	
VO_LOOTA_BOSS_12h_Male_Kobold_Death2_01	Jo ho... O.	
VO_LOOTA_BOSS_12h_Male_Kobold_Death3_01	Ech, na umrzyka skrzyni!	
VO_LOOTA_BOSS_12h_Male_Kobold_DefeatPlayer_01	Harr harr! Nie wykiwasz morskiego kobolda!	
VO_LOOTA_BOSS_12h_Male_Kobold_DefeatPlayer_02	Tyyyyyle skarbów! Ha ha… Rafaam kopyrtnie z zazdrości…	
VO_LOOTA_BOSS_12h_Male_Kobold_EmoteResponse_01	Arrr! Spływaj stąd, szczurze tunelowy!	
VO_LOOTA_BOSS_12h_Male_Kobold_EventCandleStolen_01	Co?! Kradziejstwo świecuni to poważne wykroczenie!	
VO_LOOTA_BOSS_12h_Male_Kobold_EventChargeBigMinion_01	O ho ho!	
VO_LOOTA_BOSS_12h_Male_Kobold_EventFindCandle_01	Ooo, kochana świecunia! Już dobrze. Moja, tylko moja...	
VO_LOOTA_BOSS_12h_Male_Kobold_EventPlayCandle_01	A MÓWIŁEM, ŻE MOJA ŚWIECUNIA, TAK?!	
VO_LOOTA_BOSS_12h_Male_Kobold_EventPlayerPlaysCrab_01	Zabierz to stąd! Ale już!	
VO_LOOTA_BOSS_12h_Male_Kobold_EventPlayerPlaysPatches_01	Nie! Ja tu dowodzę! Ja!	
VO_LOOTA_BOSS_12h_Male_Kobold_EventPlayKoboldKing_01	Ooo! Uzurpator.	
VO_LOOTA_BOSS_12h_Male_Kobold_GetTreasure1_01	Mnie też się trafił skarb. Hie, hie.	
VO_LOOTA_BOSS_12h_Male_Kobold_GetTreasure2_01	Skarbów wór dostaje król!	
VO_LOOTA_BOSS_12h_Male_Kobold_GetTreasure3_01	Co my tu mamy? O, to fajne.	
VO_LOOTA_BOSS_12h_Male_Kobold_GetTreasure4_01	Ach... Skarby!	
VO_LOOTA_BOSS_12h_Male_Kobold_GetTreasure5_01	Moje podziemia, moje skarby!	
VO_LOOTA_BOSS_12h_Male_Kobold_Intro_01	Puszczaj te błyskotki! Ja zbieram! Moje!	
VO_LOOTA_BOSS_12h_Male_Kobold_Intro1_01	A niech mi zgaśnie świeczka!	
VO_LOOTA_BOSS_12h_Male_Kobold_Intro2_01	A niech mnie wosk zaleje!	
VO_LOOTA_BOSS_12h_Male_Kobold_Intro3_01	Sięgniesz po łup, zostanie twój trup!	
VO_LOOTA_BOSS_13h_Female_Undead_Death_01	<Death>	
VO_LOOTA_BOSS_13h_Female_Undead_DefeatPlayer_01	Zobaczmy, co tam masz... Hmmm? Serio? Strasznie biedne masz te karty.	
VO_LOOTA_BOSS_13h_Female_Undead_EmoteResponse_01	Pierwszy raz w podziemiach? Raczej nie lubimy tutaj gadać.	
VO_LOOTA_BOSS_13h_Female_Undead_EventBagOfCoins_01	No, no. Nazbierało się tych skarbów.	
VO_LOOTA_BOSS_13h_Female_Undead_EventStealQuest_01	Łapać złodzieja!	
VO_LOOTA_BOSS_13h_Female_Undead_HeroPower_01	Znienacka!	
VO_LOOTA_BOSS_13h_Female_Undead_HeroPower1_01	Krok w tył.	
VO_LOOTA_BOSS_13h_Female_Undead_HeroPower2_01	Kocia gracja.	
VO_LOOTA_BOSS_13h_Female_Undead_HeroPower3_01	Za zasłoną cieni.	
VO_LOOTA_BOSS_13h_Female_Undead_HeroPower4_01	Pojawiam się i znikam.	
VO_LOOTA_BOSS_13h_Female_Undead_Intro_01	Oddaj grzecznie skarb, to dam ci w zamian szybką śmierć.	
VO_LOOTA_BOSS_15h_Male_Human_Death_01	<Death>	
VO_LOOTA_BOSS_15h_Male_Human_DefeatPlayer_01	Jeśli pójdziemy TĘDY, to może trafimy z powrotem do Un'goro.	
VO_LOOTA_BOSS_15h_Male_Human_EmoteResponse_01	Chyba kojarzę cię z Un'goro?	
VO_LOOTA_BOSS_15h_Male_Human_Intro_01	A niech to Światłość, Rychu! Patrz, gdzie nas zaniosło!	
VO_LOOTA_BOSS_15h_Male_Human_PartnerDeath_01	Na Światłość! Zabili Rycha!	
VO_LOOTA_BOSS_15h_Male_Human_TaggedIn1_01	Przesuń się, przejmuję dowodzenie.	
VO_LOOTA_BOSS_15h_Male_Human_TaggedIn2_01	To jakaś żenada. Oddaj mi karty.	
VO_LOOTA_BOSS_15h_Male_Human_TaggedIn3_01	Odsuń się, to MOJA kolej!	
VO_LOOTA_BOSS_16h_Male_Troll_Death_01	Uaaa... Teraz ja se pogadam ze sobą…	
VO_LOOTA_BOSS_16h_Male_Troll_DefeatPlayer_01	Ej, nie smuć się, truposzku. Tera Azun będzie z tobo… Hahaha.	
VO_LOOTA_BOSS_16h_Male_Troll_EmoteResponse_01	Ja nawijam do truposzków. Ty nawijaj do pacyna.	
VO_LOOTA_BOSS_16h_Male_Troll_EventPlayerDeathrattle1_01	Ha ha, to było dobre.	
VO_LOOTA_BOSS_16h_Male_Troll_EventPlayerDeathrattle2_01	Nikt tu nie spoczywa w pokoju, muahaha!	
VO_LOOTA_BOSS_16h_Male_Troll_EventPlayerDeathrattle3_01	Mogę pomóc truposzkowi.	
VO_LOOTA_BOSS_16h_Male_Troll_EventPlayerDeathrattle4_01	Taki mulo, a takie czory.	
VO_LOOTA_BOSS_16h_Male_Troll_EventPlayerDeathrattle5_01	Umiera się tylko dwa razy.	
VO_LOOTA_BOSS_16h_Male_Troll_Intro_01	Gadam se z trupami. Wporzo? Wporzo!	
VO_LOOTA_BOSS_17h_Male_Troll_Death_01	<Death>	
VO_LOOTA_BOSS_17h_Male_Troll_DefeatPlayer_01	Przynosisz drakę do Jin'zo? No to masz drakę!	
VO_LOOTA_BOSS_17h_Male_Troll_EmoteResponse_01	Nie czas na gadanie. Czas na płacz!	
VO_LOOTA_BOSS_17h_Male_Troll_EventPlayerBattlecry1_01	Oooo... To mi się podoba.	
VO_LOOTA_BOSS_17h_Male_Troll_EventPlayerBattlecry2_01	Jin'zo to pochwala.	
VO_LOOTA_BOSS_17h_Male_Troll_EventPlayerBattlecry3_01	Tak, Jin'zo rozumie taki język!	
VO_LOOTA_BOSS_17h_Male_Troll_EventPlayerBrann_01	Hohoho! Krasnoludzki pokurcz myśli, że jest głośniejszy od Jin'zo? NIE JEST!	
VO_LOOTA_BOSS_17h_Male_Troll_Intro_01	Jin'zo wie, co z tobą zrobi!	
VO_LOOTA_BOSS_19h_Male_Trogg_Death_01	Ueeghhh…	
VO_LOOTA_BOSS_19h_Male_Trogg_DefeatPlayer_01	Zabawiasz się sztuczkami, obrywasz po łbie.	
VO_LOOTA_BOSS_19h_Male_Trogg_EmoteResponse_01	Lubisz troggi? Mam troggi.	
VO_LOOTA_BOSS_19h_Male_Trogg_EventHandFull_01	Cicho już. Ech, za dużo tego!	
VO_LOOTA_BOSS_19h_Male_Trogg_HeroPower1_01	Chodź no, troggu!	
VO_LOOTA_BOSS_19h_Male_Trogg_HeroPower2_01	Kłap dalej. Mam ich więcej.	
VO_LOOTA_BOSS_19h_Male_Trogg_HeroPower3_01	One wyczuwają magię!	
VO_LOOTA_BOSS_19h_Male_Trogg_HeroPowerHard1_01	Co za moc.	
VO_LOOTA_BOSS_19h_Male_Trogg_HeroPowerHard2_01	Mehehe, gadaj dalej!	
VO_LOOTA_BOSS_19h_Male_Trogg_HeroPowerHard3_01	Aaaaa... magia...	
VO_LOOTA_BOSS_19h_Male_Trogg_Intro_01	Na kolana przed troggiem!	
VO_LOOTA_BOSS_20h_Male_Earthen_Death_01	Spaaaaaaać...	
VO_LOOTA_BOSS_20h_Male_Earthen_DefeatPlayer_01	Sanktuarium jest bezpieczne.	
VO_LOOTA_BOSS_20h_Male_Earthen_EmoteResponse_01	Tylko na tyle cię stać?	
VO_LOOTA_BOSS_20h_Male_Earthen_EventPlayerSilence_01	O proszę. Dziękuję ci.	
VO_LOOTA_BOSS_20h_Male_Earthen_EventStatueDestroyed1_01	Tylko odwlekasz to, co nieuniknione.	
VO_LOOTA_BOSS_20h_Male_Earthen_EventStatueDestroyed2_01	Muszę tylko przeczekać.	
VO_LOOTA_BOSS_20h_Male_Earthen_EventStatueDestroyed3_01	Bezcześcisz to miejsce.	
VO_LOOTA_BOSS_20h_Male_Earthen_EventStatueDestroyed4_01	Muszę... ochronić... sanktuarium...	
VO_LOOTA_BOSS_20h_Male_Earthen_EventStatueDestroyed5_01	Moja wola jest twarda niczym głaz...	
VO_LOOTA_BOSS_20h_Male_Earthen_HeroPower_01	POWSTAŃCIE!	
VO_LOOTA_BOSS_20h_Male_Earthen_HeroPowerNoStatues_01	POWSTAŃCIE! ...O.	
VO_LOOTA_BOSS_20h_Male_Earthen_Intro_01	Odejdź precz. Nic tu po tobie.	
VO_LOOTA_BOSS_22h_Male_Murloc_Death_01	<Death>	
VO_LOOTA_BOSS_22h_Male_Murloc_DeathSpecial_01	...!!	
VO_LOOTA_BOSS_22h_Male_Murloc_DefeatPlayer_01	...! ...?	
VO_LOOTA_BOSS_22h_Male_Murloc_EmoteResponse_01	...?!	
VO_LOOTA_BOSS_22h_Male_Murloc_EventFishUpChest_01	...	
VO_LOOTA_BOSS_22h_Male_Murloc_EventSummonCrab_01	...!!	
VO_LOOTA_BOSS_22h_Male_Murloc_FishLarge_02	...!	
VO_LOOTA_BOSS_22h_Male_Murloc_FishMedium_01	...?	
VO_LOOTA_BOSS_22h_Male_Murloc_FishSmall_01	...	
VO_LOOTA_BOSS_22h_Male_Murloc_Intro_01	...!	
VO_LOOTA_BOSS_23h_Male_Furbolg_Death_01	<Death>	
VO_LOOTA_BOSS_23h_Male_Furbolg_DefeatPlayer_01	Twoje kości będą przestrogą dla innych.	
VO_LOOTA_BOSS_23h_Male_Furbolg_EmoteResponse_01	Mów dalej, to znajdą cię moje bestie...	
VO_LOOTA_BOSS_23h_Male_Furbolg_EventPlayBigMinion1_01	Niech skończą się łowy.	
VO_LOOTA_BOSS_23h_Male_Furbolg_EventPlayBigMinion2_01	Nie ma ucieczki.	
VO_LOOTA_BOSS_23h_Male_Furbolg_EventPlayBigMinion3_01	Czują twój strach!	
VO_LOOTA_BOSS_23h_Male_Furbolg_HeroPower1_01	Twój czas się skończy...	
VO_LOOTA_BOSS_23h_Male_Furbolg_HeroPower2_01	Moja siła rośnie.	
VO_LOOTA_BOSS_23h_Male_Furbolg_HeroPower3_01	Moje bestie cię znajdą.	
VO_LOOTA_BOSS_23h_Male_Furbolg_HeroPower4_01	To moje jaskinie, ja tu rządzę. A ciebie... urządzę!	
VO_LOOTA_BOSS_23h_Male_Furbolg_HeroPower5_01	To MÓJ teren łowiecki.	
VO_LOOTA_BOSS_23h_Male_Furbolg_Intro_01	Tutaj... to TY jesteś zwierzyną!	
VO_LOOTA_BOSS_25h_Male_Dragon_Death_01	<Death>	
VO_LOOTA_BOSS_25h_Male_Dragon_DefeatPlayer_01	To pradawne, uświęcone skarby. Pozostaną na swoim miejscu.	
VO_LOOTA_BOSS_25h_Male_Dragon_EmoteResponse_01	Wezmę to pod uwagę.	
VO_LOOTA_BOSS_25h_Male_Dragon_EventMarinTheFox_01	O, Marin Szczwany Lis! Ośmielasz się tu wracać?	
VO_LOOTA_BOSS_25h_Male_Dragon_HeroPower1_01	Płoń, intruzie.	
VO_LOOTA_BOSS_25h_Male_Dragon_HeroPower2_01	Nędzny rabusiu!	
VO_LOOTA_BOSS_25h_Male_Dragon_HeroPower3_01	Będziesz cierpieć!	
VO_LOOTA_BOSS_25h_Male_Dragon_HeroPower4_01	Przepadnij!	
VO_LOOTA_BOSS_25h_Male_Dragon_HeroPower5_01	Już się nie schowasz.	
VO_LOOTA_BOSS_25h_Male_Dragon_Intro_01	Wyjdź z ukrycia, nędzny złodziejaszku.	
VO_LOOTA_BOSS_25h_Male_Dragon_TreasureDestroy1_01	To nie należy do ciebie.	
VO_LOOTA_BOSS_25h_Male_Dragon_TreasureDestroy2_01	Złodziej!	
VO_LOOTA_BOSS_25h_Male_Dragon_TreasureDestroy3_01	Oddawaj!	
VO_LOOTA_BOSS_25h_Male_Dragon_TreasureDestroy4_02	Jak rozkapryszone dziecko!	
VO_LOOTA_BOSS_25h_Male_Dragon_TreasureDestroy5_01	Zapłacisz za tę chciwość.	
VO_LOOTA_BOSS_26h_Female_Demon_Death_01	<Death>	
VO_LOOTA_BOSS_26h_Female_Demon_DefeatPlayer_01	Głupiutki intruzie. Widzę wszystko.	
VO_LOOTA_BOSS_26h_Female_Demon_EmoteResponse_01	Widzę tylko... ciebie...	
VO_LOOTA_BOSS_26h_Female_Demon_EyeStalkConfuse_01	Skołowanie.	
VO_LOOTA_BOSS_26h_Female_Demon_EyeStalkDeath_01	Śmierć.	
VO_LOOTA_BOSS_26h_Female_Demon_EyeStalkDevitalize_01	Senność.	
VO_LOOTA_BOSS_26h_Female_Demon_EyeStalkFear_01	Strach.	
VO_LOOTA_BOSS_26h_Female_Demon_EyeStalkFire_01	Spalenizna.	
VO_LOOTA_BOSS_26h_Female_Demon_EyeStalkFrost_01	Szron.	
VO_LOOTA_BOSS_26h_Female_Demon_Intro_01	Udało ci się zajść ssstrasznie daleko... Niech no na ciebie sssspojrzę...	
VO_LOOTA_BOSS_32h_Male_Human_Death_01	<Death>	
VO_LOOTA_BOSS_32h_Male_Human_EmoteResponse_01	Nie rozmawiam z nieznajomymi.	
VO_LOOTA_BOSS_32h_Male_Human_PartnerDeath_01	O nie, tylko nie Zbychu!	
VO_LOOTA_BOSS_32h_Male_Human_TaggedIn1_01	Daj mi spróbować!	
VO_LOOTA_BOSS_32h_Male_Human_TaggedIn2_01	Też chcę pomóc, Zbychu!	
VO_LOOTA_BOSS_32h_Male_Human_TaggedIn3_01	Mogę ja, Zbychu? No weź.	
VO_LOOTA_BOSS_34h_Male_Demon_Death_01	<Death>	
VO_LOOTA_BOSS_34h_Male_Demon_DefeatPlayer_01	Trzeba mi... WIĘCEJ!	
VO_LOOTA_BOSS_34h_Male_Demon_EmoteResponse_01	Upajam się twoim strachem i karmię nieczystym sumieniem.	
VO_LOOTA_BOSS_34h_Male_Demon_HeroPower1_01	Pożeram.	
VO_LOOTA_BOSS_34h_Male_Demon_HeroPower2_01	Więcej...	
VO_LOOTA_BOSS_34h_Male_Demon_HeroPower3_01	Chcę więcej...	
VO_LOOTA_BOSS_34h_Male_Demon_HeroPower4_01	Pochłonę ten świat!	
VO_LOOTA_BOSS_34h_Male_Demon_HeroPower5_01	Nadszedł twój kres.	
VO_LOOTA_BOSS_34h_Male_Demon_Intro_01	CZUJĘ GŁÓD.	
VO_LOOTA_BOSS_35h_Male_Furbolg_Death_01	Zawróć... Jeśli zejdziesz głębiej, czeka cię zagłada.	
VO_LOOTA_BOSS_35h_Male_Furbolg_DefeatPlayer_01	Ciało umiera, lecz twoja dusza jest nareszcie wolna.	
VO_LOOTA_BOSS_35h_Male_Furbolg_EmoteResponse_01	Jeśli pragniesz spokoju duszy, zostaw skarby i odejdź.	
VO_LOOTA_BOSS_35h_Male_Furbolg_Intro_01	Przepadnij! Twoja magia na nic się tu zda.	
VO_LOOTA_BOSS_35h_Male_Furbolg_SpellCountered1_01	Twoja magia tylko karmi ten labirynt.	
VO_LOOTA_BOSS_35h_Male_Furbolg_SpellCountered2_01	Cisza!	
VO_LOOTA_BOSS_35h_Male_Furbolg_SpellCountered3_01	Twoja siła słabnie.	
VO_LOOTA_BOSS_35h_Male_Furbolg_SpellCountered4_01	Moja magia jest silniejsza od twojej...	
VO_LOOTA_BOSS_35h_Male_Furbolg_SpellCountered5_01	Pradawnej mocy tak łatwo nie pokonasz.	
VO_LOOTA_BOSS_37h_Female_BloodElf_Death_01	Ja płonę! Oouuu!	
VO_LOOTA_BOSS_37h_Female_BloodElf_DefeatPlayer_01	Kto się tu zapuszcza, ten się sparzy...	
VO_LOOTA_BOSS_37h_Female_BloodElf_EmoteResponse_01	Jak cię pokonam, spalisz się ze wstydu! Haha, rozumiesz?	
VO_LOOTA_BOSS_37h_Female_BloodElf_EventFireball_01	Tyle ognia... Niech płonie!	
VO_LOOTA_BOSS_37h_Female_BloodElf_EventPyroblast_01	Ufff, jak gorąco!	
VO_LOOTA_BOSS_37h_Female_BloodElf_EventRagnaros_01	No i to się nazywa walka!	
VO_LOOTA_BOSS_37h_Female_BloodElf_EventTheCandle_01	A więc... świecunia jest teraz twoja?	
VO_LOOTA_BOSS_37h_Female_BloodElf_Flamewakers_01	Wszyscy gotowi na fajerwerki?	
VO_LOOTA_BOSS_37h_Female_BloodElf_HeroPower1_01	Potrzebuję więcej mocy...	
VO_LOOTA_BOSS_37h_Female_BloodElf_HeroPower2_01	Więcej... więcej!	
VO_LOOTA_BOSS_37h_Female_BloodElf_HeroPower3_01	Zaklęcia są zabawne! Bardzo zabawne!	
VO_LOOTA_BOSS_37h_Female_BloodElf_Intro_01	Zatańczysz w płomieniach!	
VO_LOOTA_BOSS_38h_Male_Kobold_Death_01	Przeklinam cię! Aaa!	
VO_LOOTA_BOSS_38h_Male_Kobold_DefeatPlayer_01	Ahahaha! Czynię czary jak boss!	
VO_LOOTA_BOSS_38h_Male_Kobold_EmoteResponse_01	Sybydybydyta! A masz z uroka!	
VO_LOOTA_BOSS_38h_Male_Kobold_EventBrann_01	Ble! Ale okropeczna krasnalska magia!	
VO_LOOTA_BOSS_38h_Male_Kobold_EventPlayerBattlecries1_01	Ale dużo wrzeszczy.	
VO_LOOTA_BOSS_38h_Male_Kobold_EventPlayerBattlecries2_01	Dość, dość tych okrzyków!	
VO_LOOTA_BOSS_38h_Male_Kobold_EventPlayerBattlecries3_01	No i po co tyle krzyku.	
VO_LOOTA_BOSS_38h_Male_Kobold_EventPlayerDeathrattles1_01	Odchodzi z przytupem!	
VO_LOOTA_BOSS_38h_Male_Kobold_EventPlayerDeathrattles3_01	Trup, a robi wudu! Huehue!	
VO_LOOTA_BOSS_38h_Male_Kobold_EventRivendare_01	Aaaaa! Trupie czary są najgorsze.	
VO_LOOTA_BOSS_38h_Male_Kobold_Intro_01	Ahaha! Wudu robię bez trudu!	
VO_LOOTA_BOSS_39h_Male_Golem_Death_01	Ciało… rozbite…	
VO_LOOTA_BOSS_39h_Male_Golem_DefeatPlayer_01	Skarb… bezpieczny…	
VO_LOOTA_BOSS_39h_Male_Golem_EmoteResponse_01	Ty… nie… twórca…	
VO_LOOTA_BOSS_39h_Male_Golem_HeroPower1_01	Miażdżyć.	
VO_LOOTA_BOSS_39h_Male_Golem_HeroPower2_01	Zgniatać.	
VO_LOOTA_BOSS_39h_Male_Golem_HeroPower3_01	Przejścia… nie ma…	
VO_LOOTA_BOSS_39h_Male_Golem_HeroPower4_01	Ty… maleństwo…	
VO_LOOTA_BOSS_39h_Male_Golem_HeroPower5_01	Przepadnij!	
VO_LOOTA_BOSS_39h_Male_Golem_Intro_01	Bronić… skarb…	
VO_LOOTA_BOSS_40h_Female_Dragon_Death_01	<Death>	
VO_LOOTA_BOSS_40h_Female_Dragon_DefeatPlayer_01	Smoki zmierzchu znów zatriumfują!	
VO_LOOTA_BOSS_40h_Female_Dragon_EmoteResponse_01	Mmmmm... Pozwolę sobie pozostać przy własnej opinii.	
VO_LOOTA_BOSS_40h_Female_Dragon_EventPlayTwilightDrake_01	Mały braciszku, nie zdradzaj nas.	
VO_LOOTA_BOSS_40h_Female_Dragon_EventPlayTwilightWhelp_01	Wróć na łono rodziny, maleństwo!	
VO_LOOTA_BOSS_40h_Female_Dragon_HeroPower1_01	Łaknę pokarmu...!	
VO_LOOTA_BOSS_40h_Female_Dragon_HeroPower2_01	Karmię się twoją siłą.	
VO_LOOTA_BOSS_40h_Female_Dragon_HeroPower3_01	Moi pobratymcy przetrwają.	
VO_LOOTA_BOSS_40h_Female_Dragon_HeroPower4_01	Powitaj uścisk zmierzchu.	
VO_LOOTA_BOSS_40h_Female_Dragon_Intro_01	Wyczuwam ogromną moc. Zbliż się...	
VO_LOOTA_BOSS_41h_Male_Kobold_Death_01	<Death>	
VO_LOOTA_BOSS_41h_Male_Kobold_DefeatPlayer_01	MOJA świecunia. Twoje wielkie NIC!	
VO_LOOTA_BOSS_41h_Male_Kobold_EmoteResponse_01	Zamknij gadaczkę i walcz!	
VO_LOOTA_BOSS_41h_Male_Kobold_EventHornOfCenarius_01	Co? COOOO? Oszukujesz!	
VO_LOOTA_BOSS_41h_Male_Kobold_HeroPower1_01	Wszyscy do boju!	
VO_LOOTA_BOSS_41h_Male_Kobold_HeroPower2_01	Bójka!	
VO_LOOTA_BOSS_41h_Male_Kobold_HeroPower3_01	Napierać!	
VO_LOOTA_BOSS_41h_Male_Kobold_Intro_01	Moja świecunia, oddawaj!	
VO_LOOTA_BOSS_42h_Female_Furbolg_Armor10_01	Oddaję cześć moim przodkom!	
VO_LOOTA_BOSS_42h_Female_Furbolg_Armor15_01	Zaprawdę starożytni są potężni!	
VO_LOOTA_BOSS_42h_Female_Furbolg_Armor20_01	Oddaj mi swoje skarby, nie ma już dla ciebie nadziei!	
VO_LOOTA_BOSS_42h_Female_Furbolg_Armor5_01	Ruszam do walki bez strachu.	
VO_LOOTA_BOSS_42h_Female_Furbolg_Death_01	Dołączam... do mych przodków...	
VO_LOOTA_BOSS_42h_Female_Furbolg_DefeatPlayer_01	Chwała prastarym duchom! Albowiem one są mą tarczą!	
VO_LOOTA_BOSS_42h_Female_Furbolg_EmoteResponse_01	Prastare duchy... nie przepadają za tobą.	
VO_LOOTA_BOSS_42h_Female_Furbolg_Intro_01	Prastare duchy! Wzywam was!	
VO_LOOTA_BOSS_43h_Female_Djinn_Death_01	<Death>	
VO_LOOTA_BOSS_43h_Female_Djinn_DefeatPlayer_01	Czyż nie spełniłam wszystkich twoich życzeń...?	
VO_LOOTA_BOSS_43h_Female_Djinn_EmoteResponse_01	Kiepskie to twoje życzenie.	
VO_LOOTA_BOSS_43h_Female_Djinn_HeroAbility1_01	Czego pragniesz?	
VO_LOOTA_BOSS_43h_Female_Djinn_HeroAbility2_01	Raz... Dwa... Trzy...	
VO_LOOTA_BOSS_43h_Female_Djinn_HeroAbility3_01	Życzenie spełnione!	
VO_LOOTA_BOSS_43h_Female_Djinn_HeroAbilityHandFull1_01	Hehehehe!	
VO_LOOTA_BOSS_43h_Female_Djinn_HeroAbilityHandFull2_01	Za dużo dobrego?	
VO_LOOTA_BOSS_43h_Female_Djinn_HeroAbilityHandFull3_01	Z życzeniami trzeba ostrożnie.	
VO_LOOTA_BOSS_43h_Female_Djinn_Intro_01	Twoje życzenie jest dla mnie rozkazem... Za odpowiednią cenę... Hahaha!	
VO_LOOTA_BOSS_44h_Female_Dragon_Death_01	<Death>	
VO_LOOTA_BOSS_44h_Female_Dragon_DefeatPlayer_01	Wszyscy poszli. Pa, pa!	
VO_LOOTA_BOSS_44h_Female_Dragon_EmoteResponse_01	Chcę do mamy!	
VO_LOOTA_BOSS_44h_Female_Dragon_Intro_01	Oooo! Czas na papu?	
VO_LOOTA_BOSS_45h_Male_Gnome_Death_01	<Death>	
VO_LOOTA_BOSS_45h_Male_Gnome_DefeatPlayer_01	Znalezione nie kradzione. No chyba że przeze mnie.	
VO_LOOTA_BOSS_45h_Male_Gnome_EmoteResponse_01	Co za miejsce! Plątanina wąziutkich korytarzyków. I_wszystkie takie same!	
VO_LOOTA_BOSS_45h_Male_Gnome_HeroPower1_01	Aaa, świecidełka.	
VO_LOOTA_BOSS_45h_Male_Gnome_HeroPower2_01	Hehehe!	
VO_LOOTA_BOSS_45h_Male_Gnome_HeroPower3_01	Orzeł! Wygrywam.	
VO_LOOTA_BOSS_45h_Male_Gnome_HeroPower4_01	Reszka! Przegrywasz.	
VO_LOOTA_BOSS_45h_Male_Gnome_Intro_01	Nie za bardzo masz wypchane te kieszenie?	
VO_LOOTA_BOSS_46h_Male_Murloc_Death_01	<Death>	
VO_LOOTA_BOSS_46h_Male_Murloc_DefeatPlayer_01	... ...? ...!	
VO_LOOTA_BOSS_46h_Male_Murloc_EmoteResponse_01	…! …! …! Blrghrgrhg!	
VO_LOOTA_BOSS_46h_Male_Murloc_HeroPower1_01	...	
VO_LOOTA_BOSS_46h_Male_Murloc_HeroPower2_01	...?	
VO_LOOTA_BOSS_46h_Male_Murloc_HeroPower3_01	...	
VO_LOOTA_BOSS_46h_Male_Murloc_Intro_01	...!!	
VO_LOOTA_BOSS_49h_Male_Elemental_Death_01	<Death>	
VO_LOOTA_BOSS_49h_Male_Elemental_DefeatPlayer_01	Muahahaha...	
VO_LOOTA_BOSS_49h_Male_Elemental_EmoteResponse_01	Zabieram świeczki. Tak już mam. To właśnie robię.	
VO_LOOTA_BOSS_49h_Male_Elemental_HeroPower1_01	Ciemność...	
VO_LOOTA_BOSS_49h_Male_Elemental_HeroPower2_01	Uciekaj...	
VO_LOOTA_BOSS_49h_Male_Elemental_HeroPower3_01	Muahahaha!	
VO_LOOTA_BOSS_49h_Male_Elemental_Intro_01	Twój płomień słabnie, awanturniku...	
VO_LOOTA_BOSS_50h_Male_Kobold_Death_01	<Death>	
VO_LOOTA_BOSS_50h_Male_Kobold_DefeatPlayer_01	Ooo, tak! Ma kopa to coś.	
VO_LOOTA_BOSS_50h_Male_Kobold_EmoteResponse_01	NIE. Zwrotów nie uznaję.	
VO_LOOTA_BOSS_50h_Male_Kobold_EventKazakus_01	Kozakus! Przyszłeś po nową dostawę?	
VO_LOOTA_BOSS_50h_Male_Kobold_EventMakePotion1_01	A to... Pfe! Obrzydlistwo.	
VO_LOOTA_BOSS_50h_Male_Kobold_EventMakePotion2_01	Sroga breja, będzie w sam raz! Hahaha!	
VO_LOOTA_BOSS_50h_Male_Kobold_EventMakePotion3_01	Chcesz trochę, co? Hehe, nie dostaniesz.	
VO_LOOTA_BOSS_50h_Male_Kobold_EventUsePotion1_01	Ooo, ale śmierdzi. Powąchaj!	
VO_LOOTA_BOSS_50h_Male_Kobold_EventUsePotion2_01	Hahahaha, o taaak! Tak, tak!	
VO_LOOTA_BOSS_50h_Male_Kobold_EventUsePotion3_01	Och... Wykrzywia mordę, ale w sumie to smakuje.	
VO_LOOTA_BOSS_50h_Male_Kobold_Intro_01	Mam najlepsiejsze grzyby, świecunie sobie podrzynam!	
VO_LOOTA_BOSS_51h_Male_Dwarf_Death_01	Dobranoc, Azeroth!	
VO_LOOTA_BOSS_51h_Male_Dwarf_DefeatPlayer_02	Dzięki za twoich stronników!	
VO_LOOTA_BOSS_51h_Male_Dwarf_EmoteResponse_01	Oho! Widzę, że nie tylko ja tutaj mam cięty język.	
VO_LOOTA_BOSS_51h_Male_Dwarf_EventBoombox_01	Hej! Ale fajerwerki dopiero po występie!	
VO_LOOTA_BOSS_51h_Male_Dwarf_Intro_01	Zostań na chwilę i posłuchaj.	
VO_LOOTA_BOSS_51h_Male_Dwarf_KillingBlowReady_01	Koboldy i katakumby!	
VO_LOOTA_BOSS_51h_Male_Dwarf_Song1A_01	Drużynę już masz, na wyprawę gnasz...	
VO_LOOTA_BOSS_51h_Male_Dwarf_Song1B_01	By łupów zdobyć pełen wór!	
VO_LOOTA_BOSS_51h_Male_Dwarf_Song1C_01	Nęci cię skarbów blask, lecz pułapek trzask...	
VO_LOOTA_BOSS_51h_Male_Dwarf_Song1D_01	Przypomina, że wiecznie brak ci tur!	
VO_LOOTA_BOSS_51h_Male_Dwarf_Song2A_01	Lecz jeśli tak cię nosi, by wosk im zakosić…	
VO_LOOTA_BOSS_51h_Male_Dwarf_Song2B_01	Zrób to! I bierz nogi za pas.	
VO_LOOTA_BOSS_51h_Male_Dwarf_Song2C_01	Pędź ile w piersi tchu, musisz zgubić ich ze stu...	
VO_LOOTA_BOSS_51h_Male_Dwarf_Song2D_01	Mówiąc sobie, że to już ostatni raz.	
VO_LOOTA_BOSS_51h_Male_Dwarf_Song3A_01	Doganiają cię, to skończy się źle...	
VO_LOOTA_BOSS_51h_Male_Dwarf_Song3B_01	I zamknie się wieko twojej trumny!	
VO_LOOTA_BOSS_51h_Male_Dwarf_Song3C_01	Gdy gubisz się w mroku, wszędzie są wokół…	
VO_LOOTA_BOSS_51h_Male_Dwarf_Song3D_01	Koboldy i katakumby!	
VO_LOOTA_BOSS_51h_Male_Dwarf_Steal_01	Chodź no tu!	
VO_LOOTA_BOSS_51h_Male_Dwarf_Steal_02	Cho no tu!	
VO_LOOTA_BOSS_51h_Male_Dwarf_Steal_03	Czas na zabawę!	
VO_LOOTA_BOSS_51h_Male_Dwarf_StealDoomsayer_01	Muszę zatrudnić innego dźwiękowca.	
VO_LOOTA_BOSS_51h_Male_Dwarf_StealMinstrel_01	A! Ha! Czas na duet!	
VO_LOOTA_BOSS_53h2_Female_Undead_Death_01	Paradoks czasowy!	
VO_LOOTA_BOSS_53h2_Female_Undead_DefeatPlayer_01	Wiedziałam, że wygram. W końcu widzę przyszłość.	
VO_LOOTA_BOSS_53h2_Female_Undead_EmoteResponse_01	Umiem przechytrzyć spiżowego smoka. Żadne z ciebie wyzwanie.	
VO_LOOTA_BOSS_53h2_Female_Undead_EventManaDestroyed_01	Tylko opóźniasz to, co nieuniknione.	
VO_LOOTA_BOSS_53h2_Female_Undead_EventPlayerTimeWalk_01	Widzę, że Wiekuista Wyspa jest ci znana.	
VO_LOOTA_BOSS_53h2_Female_Undead_Intro_01	Czas można cofnąć. A ciebie unicestwić.	
VO_LOOTA_BOSS_53h2_Female_Undead_RitualPrep1_01	Twój czas nadejdzie...	
VO_LOOTA_BOSS_53h2_Female_Undead_RitualPrep2_01	Moja siła rośnie.	
VO_LOOTA_BOSS_53h2_Female_Undead_RitualPrep3_01	Tik-tak...	
VO_LOOTA_BOSS_53h2_Female_Undead_TimeRewindPlayCard1_01	Za każdym razem jestem coraz lepsza.	
VO_LOOTA_BOSS_53h2_Female_Undead_TimeRewindPlayCard2_01	Już to przerabialiśmy.	
VO_LOOTA_BOSS_53h2_Female_Undead_TimeRewindPlayCard3_01	Czas mi sprzyja.	
VO_LOOTA_BOSS_53h2_Female_Undead_TimeRewindPlayCard4_01	Kto kontroluje czas, włada nieskończonością!	
VO_LOOTA_BOSS_53h2_Female_Undead_TimeRewindPlayCard5_01	Czas to skończyć!	
VO_LOOTA_BOSS_53h2_Female_Undead_TimeRewindStart1_01	Spójrz tylko, co potrafię!	
VO_LOOTA_BOSS_53h2_Female_Undead_TimeRewindStart2_01	Czas działać!	
VO_LOOTA_BOSS_53h2_Female_Undead_TimeRewindStart3_01	Jeszcze raz! Powtórzmy to!	
VO_LOOTA_BOSS_53h2_Female_Undead_TimeRewindStart4_01	Oto moja chwila!	
VO_LOOTA_BOSS_54h_Female_Human_Death_01	Nie byłam gotowa!	
VO_LOOTA_BOSS_54h_Female_Human_DefeatPlayer_01	W porządku, już jestem gotowa.	
VO_LOOTA_BOSS_54h_Female_Human_EmoteResponse_01	Zaraz wracam. Daj znać, jak rozpocznie się walka.	
VO_LOOTA_BOSS_54h_Female_Human_Intro_01	<Podśpiewuje\nrozkojarzona>	
VO_LOOTA_BOSS_54h_Female_Human_Intro_02	<Podśpiewuje>	
VO_LOOTA_BOSS_54h_Female_Human_Intro_03	<Podśpiewuje>	
VO_LOOTA_BOSS_54h_Female_Human_Intro_04	<Pogwizduje>	
VO_LOOTA_BOSS_54h_Female_Human_Intro_07	<Podśpiewuje>	
VO_LOOTA_BOSS_54h_Female_Human_WakeUp_01	O, to my walczymy?	
VO_Maiden_Female_Titan_FinalMaidenEmoteResponse_01	Takie zachowanie nie będzie tolerowane.	
VO_Maiden_Female_Titan_FinalMaidenEyeForAnEye_01	Sprawiedliwości stało się zadość.	
VO_Maiden_Female_Titan_FinalMaidenHeroPower_01	Pozbądź się plugawych myśli.	
VO_Maiden_Female_Titan_FinalMaidenHumility_01	Tak! Na kolana, a może cię oszczędzę!	
VO_Maiden_Female_Titan_FinalMaidenOpen_01	Wzywasz przedstawicielkę tytanów?	
VO_Maiden_Female_Titan_FinalMaidenTurn5_01	My jesteśmy wieczni! Ty jesteś nikim!	
VO_Malchezaar_Male_Demon_Brawl_06	Prostaczkowie! Czas to ogień, który was strawi!	
VO_Malchezaar_Male_Demon_EmoteParty_01	Malkezar też lubi imprezować!	
VO_Malchezaar_Male_Demon_FinalAltOpening_01	Prostaczkowie!	
VO_Malchezaar_Male_Demon_FinalMalchezaarDeath_01	Nie! Nie! Tylko nie znowu!	
VO_Malchezaar_Male_Demon_FinalMalchezaarEmoteResponse_01	Będę przyczynkiem twojej zguby!	
VO_Malchezaar_Male_Demon_FinalMalchezaarHeroPower_01	Mierzycie się nie tylko z Malkezarem, ale także z legionami, którym przewodzę!	
VO_Malchezaar_Male_Demon_FinalMalchezaarJaraxxus_01	Hej ty! To moje zaproszenie!	
VO_Malchezaar_Male_Demon_FinalMalchezaarMedivhSkin_01	Jesteś w kostiumie? Hmm... Też chciałbym taki.	
VO_Malchezaar_Male_Demon_FinalMalchezaarSacrificialPact_03	Haha! Coś takiego nigdy nie zadziała na prawdziwego Władcę Eredarów!	
VO_Malchezaar_Male_Demon_FinalMalchezaarTurn1_01	Ten mag jest potężny, ale jak mogliście oczekiwać, że wytrzymacie przepływ tak potężnej mocy?	
VO_Malchezaar_Male_Demon_FinalMalchezaarTurn7_01	Słyszę muzykę! Me-divy! Karazhańska noc!	
VO_Malchezaar_Male_Demon_FinalThirdSequence_01	Przywołaliście mnie do Karazhanu? W samą porę na imprezę!	
VO_Malchezaar_Male_Demon_FinalThirdSequence_04	Z drogi, głupcze!	
VO_Malchezaar_Male_Demon_PrologueEmoteResponse_01	Prostak!	
VO_Malchezaar_Male_Demon_PrologueHeroPower_01	Wszystkie wymiary i przestrzenie stają przede mną otworem!	
VO_Malchezaar_Male_Demon_PrologueOpen_01	Gdzie jest moje zaproszenie?	
VO_Malchezaar_Male_Demon_PrologueTurn1_04	Nie zaprosiłeś mnie?! Przecież jestem księciem Eredarów!	
VO_Malchezaar_Male_Demon_PrologueTurn11_02	Zaprosiłeś Jaraxxusa? Tego słabeusza?	
VO_Malchezaar_Male_Demon_PrologueWin_01	Zabiorę cię ze sobą!	
VO_Mediva_01_Female_Blood Elf_AranSpell_04	Och, brrr.	
VO_Mediva_01_Female_Blood Elf_ChessEmoteOops_06	Ojej.	
VO_Mediva_01_Female_Blood Elf_PrologueTurn5_06	Medivy!	
VO_Mediva_02_Female_Draenei_JulianneDeadlyPoison_02	Jakie to tragiczne!	
VO_Mediva_02_Female_Draenei_PrologueTurn5_05	Tak?	
VO_Mediva_03_Male_Night Elf_AranHeroPower_01	Płońcie jak pochodnie!	
VO_Mediva_03_Male_Night Elf_CuratorBeasts_04	Apsik, skarbie!	
VO_Mediva_03_Male_Night Elf_PrologueTurn5_01	Waćpan wzywał?	
VO_Medivas_Multiple_Multiple_CroneLionTigerBear_01	O rety!	
VO_Medivas_Multiple_Multiple_IllhoofWounded_01	Oj! Jak się boję!	
VO_Medivas_Multiple_Multiple_NetherspiteTurn1_01	Promienie!	
VO_Medivh_Male_Human_EmoteGreetings_01	Co tu robisz?!	
VO_Medivh_Male_Human_EmoteOops_01	Taki był twój plan?	
VO_Medivh_Male_Human_EmoteSorry_01	Aj, nie udało się...	
VO_Medivh_Male_Human_EmoteThanks_01	Rozpieszczasz mnie.	
VO_Medivh_Male_Human_EmoteThreaten_01	Nie masz szans!	
VO_Medivh_Male_Human_EmoteWellPlayed_01	Dobre zagranie, demonie.	
VO_Medivh_Male_Human_EmoteWow_01	Haha! To było wspaniałe!	
VO_Medivh_Male_Human_FinalMalchezaarTurn5_01	Doskonała robota, Moriosie – przyjęcie nabiera rozpędu!	
VO_Medivh_Male_Human_FinalMalchezaarWin_01	Dobra robota! Dalej, czas na przyjęcie!	
VO_Medivh_Male_Human_FinalMedivhMedivhSkin_01	O, zaraz! Jesteś mną? Z przyszłości? Powiedz mi... jak się udało przyjęcie? Było cudowne?	
VO_Medivh_Male_Human_FinalThirdSequence_01	Ach, gość! Zajmij się proszę tym demonem. Ja muszę prowadzić przyjęcie!	
VO_Medivh_Male_Human_FinalThirdSequence_02	Zostawił cię bez kart? Wobec tego skorzystaj z portali.	
VO_Medivh_Male_Human_FinalThirdSequence_03	Proszę, możesz pożyczyć mój kostur. Za jego pomocą można kontrolować portale. Tylko go nie porysuj.	
VO_Medivh_Male_Human_PrologueDeath_02	Co? Niemożliwe!	
VO_Medivh_Male_Human_PrologueHeroPower_01	Nie licząc tego przyjęcia!	
VO_Medivh_Male_Human_PrologueOpen_01	Uch, to znowu ty?	
VO_Medivh_Male_Human_PrologueTurn1_02	Nie naprawiliśmy jeszcze dziury w dachu po ostatnim razie!	
VO_Medivh_Male_Human_PrologueTurn11_01	Słyszałeś jego karaoke? Gość jest niesamowity!	
VO_Medivh_Male_Human_PrologueTurn3_02	Moriosie, zajrzyj do szachów. Niebawem przybędą prawdziwi goście.	
VO_Medivh_Male_Human_PrologueTurn9_01	Balony! Moriosie, zapomnieliśmy o balonach!	
VO_Medivh_Male_Human_PrologueWin_01	Wracaj do siebie, demonie!	
VO_Medivh_Male_Human_Wing0Intro_01	Ożywiliśmy zastawę, odbyliśmy próby w operze, przygotowaliśmy menażerię. To będzie pamiętna noc.	
VO_Medivh_Male_Human_Wing4Win_01	Zapraszamy, wędrowcze! Baw się na przyjęciu!	
VO_Mirror_Male_Mirror_MirrorDeath_01	Hej! To było oszustwo! Domagam się rewanżu!	
VO_Mirror_Male_Mirror_MirrorEmoteResponse_01	Nie, ty!	
VO_Mirror_Male_Mirror_MirrorFirstCard_01	O nie, masz tę kartę w talii?	
VO_Mirror_Male_Mirror_MirrorMedivhSkin_01	Och, pan Medivh! Wygląda pan... Co? Hej! Zaraz, ty nie jesteś Medivhem!	
VO_Mirror_Male_Mirror_MirrorMirrorImage_01	Hej, to moja ulubiona karta! A jaka jest twoja? Wulkaniczny furiat?	
VO_Mirror_Male_Mirror_MirrorOpen_02	NO CO TAM?	
VO_Mirror_Male_Mirror_MirrorTurn1_01	Uuu! Kiepściutko wyglądacie!	
VO_Mirror_Male_Mirror_MirrorTurn3_01	Lustereczko, powiedz przecie, kto jest najpiękniejszy w świecie?	
VO_Mirror_Male_Mirror_MirrorTurn3_03	Nie ty, dziadku!	
VO_Mirror_Male_Mirror_MirrorTurn5_02	Nefarius? Bardziej Brzydarius, prawda? Hahaha!	
VO_Mirror_Male_Mirror_MirrorWellPlayedResponse_01	Szkoda, że nie mogę odpowiedzieć komplementem! Badum tss!	
VO_Moroes_Male_Human_AranTurn1_01	*wzdycha* Poznaj Arana, marudnego ducha.	
VO_Moroes_Male_Human_AranTurn9_04	Smoki wyżarły wszystko z bufetu i teraz ostrzą sobie zęby na murloki!	
VO_Moroes_Male_Human_AranWin_01	Portal jest pokój obok! Przybyliśmy w samą porę!	
VO_Moroes_Male_Human_ChessForfeit_02	Nie masz już figur. Ta parta jest przegrana.	
VO_Moroes_Male_Human_ChessTurn1_03	Patrz, na końcu twojej tury figury automatycznie zaatakują.	
VO_Moroes_Male_Human_ChessTurn3_01	Jeżeli figura stoi pomiędzy dwoma przeciwnikami, uderzy obu!	
VO_Moroes_Male_Human_ChessTurn5_01	Kluczem do zwycięstwa jest odpowiednie ustawienie. Zadbaj o podwójne ataki!	
VO_Moroes_Male_Human_ChessTurn7_01	Przed wejściem zbierają się inni goście! Dotarliśmy prawie do opery, ale musimy się pospieszyć!	
VO_Moroes_Male_Human_ChessTurn7_02	Nie zostało ci zbyt wiele figur... Gdy się skończą, partia będzie przegrana.	
VO_Moroes_Male_Human_ChessTurn7_03	Nie zostało ci zbyt wiele figur. Gdy się skończą przegrasz.	
VO_Moroes_Male_Human_ChessWin_01	Doskonale! Do opery!	
VO_Moroes_Male_Human_CroneTurn5_02	Na dole czeka Majordomus Egzekutus. Mam mu oznajmić, że przybył za wcześnie?	
VO_Moroes_Male_Human_CroneWin_01	W końcu! Ruszamy uwolnić czarodzieja!	
VO_Moroes_Male_Human_CuratorTurn3_01	Kustosz nie wie, co robi! Nie pozwól mu wypuścić okazów z menażerii!	
VO_Moroes_Male_Human_CuratorWin_01	Dobrze... Drobna korekta... i jest jak nowy!	
VO_Moroes_Male_Human_EndWing1_01	Doskonale! Tymi schodami dojdziemy do opery! Barnes na pewno szybko nas przepuści!	
VO_Moroes_Male_Human_FinalAltTurn5_01	Tyle portali... ciekawe co jest za tym...	
VO_Moroes_Male_Human_FinalMaidenTurn1_01	Przepraszam, zajmij się tym, a ja tymczasem rozgryzę sterowanie.	
VO_Moroes_Male_Human_FinalMaidenTurn7_03	Och, to świat macek. Tego zdecydowanie nie chcemy.	
VO_Moroes_Male_Human_FinalNazraTurn7_02	Zmuś ją do odwrotu, żebyśmy mogli otworzyć kolejny portal.	
VO_Moroes_Male_Human_FinalSecondSequence_01	Znakomicie! Przekonajmy się czy ten jest właściwy...	
VO_Moroes_Male_Human_FInalStartSequence_01	Hmm. Spróbujmy. Może ten?	
VO_Moroes_Male_Human_FinalThirdSequence_01	No, nareszcie!	
VO_Moroes_Male_Human_FinalTurn1_02	Oj! Nie ten portal. Pokonaj ją, żebym mógł spróbować ponownie.	
VO_Moroes_Male_Human_IllhoofKilrekResponse_01	Co oni chcą przywołać?	
VO_Moroes_Male_Human_JulianneTurn5_01	Barnes, przepuść nas! Musimy dotrzeć do Medivha, zanim z tego przyjęcia zrobi się tragedia!	
VO_Moroes_Male_Human_JulianneTurn9_02	Przybył Illidan! Nie jesteśmy gotowi!	
VO_Moroes_Male_Human_MedivhSkinResponse_01	Kostium Medivha? Zaprawdę, podobieństwo jest uderzające!	
VO_Moroes_Male_Human_MirrorTurn3_01	Hmmmm…	
VO_Moroes_Male_Human_MirrorTurn5_01	Niebawem przybędzie Lord Nefarius. Aż się boję myśleć, co zrobi.	
VO_Moroes_Male_Human_MirrorWin_02	Znakomicie! Schody do opery są zaraz przed nami!	
VO_Moroes_Male_Human_NetherspiteTurn1_01	Te promienie wzmacniają smoka! Zablokuj je stronnikami!	
VO_Moroes_Male_Human_NetherspiteTurn5_01	Powiedz nam, za którym jest Medivh!	
VO_Moroes_Male_Human_NetherspiteTurn7_01	Potrzebujemy tych portali! Goście zaczynają wrzucać księgi do puli many!	
VO_Moroes_Male_Human_NetherspiteWin_01	Dobra nasza! Niech no tylko sobie przypomnę jak to działa...	
VO_Moroes_Male_Human_NightbaneTurn3_01	Kustoszu, musimy uratować Medivha!	
VO_Moroes_Male_Human_NightbaneTurn7_01	Przybyła Liga Odkrywców. RENO, NATYCHMIAST ODŁÓŻ TE SREBRA!	
VO_Moroes_Male_Human_PrologueTurn11_01	Ekhm... No i nie spalił biblioteki....	
VO_Moroes_Male_Human_PrologueTurn5_03	Medivy są gotowe. Barnes prowadzi z_nimi próbę.	
VO_Moroes_Male_Human_PrologueTurn7_01	Proszę spojrzeć przez okno. Bossowie z rajdów czekają na zaproszenie.	
VO_Moroes_Male_Human_PrologueTurn9_02	Murloki panicznie boją się balonów. Przypominam co zaszło w zeszłym tygodniu.	
VO_Moroes_Male_Human_PrologueWin_02	Niedobrze. Bardzo niedobrze.	
VO_Moroes_Male_Human_SilverwareResponse_01	Och... To był antyk.	
VO_Moroes_Male_Human_SilverwareTurn3_02	Sztućce i zastawa są w zmowie! Jesteśmy otoczeni!	
VO_Moroes_Male_Human_SilverwareWin_01	Ale bałagan.	
VO_Moroes_Male_Human_Wing1Intro_02	Jestem Morios, zarządca Karazhanu. Potrzebuję twojej pomocy. Medivh zniknął! Musimy skorzystać z portali na szczycie wieży, żeby uratować jego i przyjęcie!	
VO_Moroes_Male_Human_Wing1Win_01	Dobra robota! W tym tempie dotrzemy na szczyt wieży w samą porę, aby uratować przyjęcie!	
VO_Moroes_Male_Human_Wing2Win_01	Naprzód! Za tymi schodami kustosz pilnuje menażerii. Mam nadzieję, że działa poprawnie.	
VO_Moroes_Male_Human_Wing3Open_02	Kustosz pilnuje menażerii, w której zebrano najbardziej egzotyczne stworzenia z całego Azeroth. Dalej znajdują się prywatne komnaty i portal, który pozwoli nam ocalić Medivha!	
VO_Moroes_Male_Human_Wing3Win_02	Jesteśmy prawie na samej górze! Musimy ocalić Medivha, zanim przyjęcie zmieni się w rozróbę!	
VO_Moroes_Male_Human_Wing4Intro_01	W końcu dotarliśmy na szczyt wieży! Odszukaj właściwy portal i sprowadź z powrotem Medivha!	
VO_Moroes_Male_Human_Wing4Win_01	Udało ci się. Nie mogę uwierzyć, że przyjęcie rozpoczęło się o czasie. Możesz przyjechać za tydzień? Medivh ma urodziny... przydałaby się pomoc.	
VO_Moroes_Male_Human_WolfClaws_03	To raczej nie jest prawda.	
VO_NAX1_01_CARD_02	Skosztuj tego!	
VO_NAX1_01_DEATH_05	Ależ za co?	
VO_NAX1_01_EMOTE_04	To mówi!	
VO_NAX1_01_HP_03	Niech cię skosztuję!	
VO_NAX1_01_START_01	O! Witaj w moim przybytku.	
VO_NAX10_01_DEATH_LINE_03	Co się stało... Łaciorowi... aaaar....	
VO_NAX10_01_EMOTE1_04	Zabawa?	
VO_NAX10_01_EMOTE2_05	Tak! Zabawa! Zabawa!	
VO_NAX10_01_HP_02	Nie ma zabawy?	
VO_NAX10_01_START_01	Łacior chce siem bawić!	
VO_NAX11_01_CARD_03	Szlam.	
VO_NAX11_01_DEATH_05	*ugh uh ahoh gowr grrrlrrlrrlaaahhh*	
VO_NAX11_01_EMOTE_04	Cicho tam!	
VO_NAX11_01_HP_02	Śmierdzi.	
VO_NAX11_01_START_01	Mięso!	
VO_NAX12_01_CARD_01	*Ryk*	
VO_NAX12_01_DEATH_01	*Skomle*	
VO_NAX12_01_EMOTE_01	*Mamrotanie*	
VO_NAX12_01_EMOTE_02	*Grrr*	
VO_NAX12_01_EMOTE_03	*Grrroooooo*	
VO_NAX12_01_HP_01	*Ryczy*	
VO_NAX12_01_START_01	*Warczy*	
VO_NAX13_01_DEATH_LINE_03	Dziękuję...	
VO_NAX13_01_EMOTE_04	Zabić!	
VO_NAX13_01_HP_02	Teraz giń!	
VO_NAX13_01_START_01	Muszę... być... posłuszny!	
VO_NAX14_01_CARD_01	*rrrrrAAAHH*	
VO_NAX14_01_DEATH_01	*roooarrr...*	
VO_NAX14_01_EMOTE_01	*rrrr Rrahhh!*	
VO_NAX14_01_EMOTE_02	*grraaaaah*	
VO_NAX14_01_EMOTE_03	*rooooaaar*	
VO_NAX14_01_HP_01	*roooarrr*	
VO_NAX14_01_START_01	*ROOOARRR*	
VO_NAX15_01_BIGGLES_32	Nie! Przeklinam cię, intruzie!	
VO_NAX15_01_DEATH_LINE_08	To nie koniec!!! ... ... ... Jest jeszcze tryb heroiczny...	
VO_NAX15_01_DEATH_LINE2_09	Nieeeee!!!	
VO_NAX15_01_EMOTE_HELLO_26	Często pozdrawiasz ludzi, którzy chcą cię zabić?	
VO_NAX15_01_EMOTE_OOPS_29	W rzeczy samej.	
VO_NAX15_01_EMOTE_SORRY_28	No cóż, intruzie. Wszyscy popełniamy błędy.	
VO_NAX15_01_EMOTE_THANKS_27	Nie ma za co.	
VO_NAX15_01_EMOTE_THREATEN_30	Oj! Jak się boję!	
VO_NAX15_01_EMOTE_WP_25	Phi. Oczywiście, że to było niezłe zagranie. Jestem Kel'thuzad, do diaska!	
VO_NAX15_01_HP_07	Zamrożę ci krew w żyłach!	
VO_NAX15_01_HP2_05	Spętam twoją nędzną duszę.	
VO_NAX15_01_HP3_06	Nie uciekniesz mi!	
VO_NAX15_01_HURRY_31	Moja cierpliwość ma swoje granice.	
VO_NAX15_01_PHASE2_10	Sądzisz, że sobie dobrze radzisz? Poczekaj tylko!	
VO_NAX15_01_PHASE2_ALT_11	O nie! Twoja tura kończy się teraz! MOJA kolej!	
VO_NAX15_01_RESPOND_ANDUIN_24	Tylko pamiętaj, że światłość należy oszczędzać!	
VO_NAX15_01_RESPOND_GARROSH_15	Naprawdę? W takim razie niech będzie śmierć.	
VO_NAX15_01_RESPOND_GARROSH_ALT_16	To jakaś zagadka? Dla ciebie chyba zostaje śmierć!	
VO_NAX15_01_RESPOND_GULDAN_22	No cóż, czyjaś dusza na pewno będzie czyjaś.	
VO_NAX15_01_RESPOND_JAINA_23	O nic się nie proszę! To ty się wprosiłaś do mojej latającej nekropolii!	
VO_NAX15_01_RESPOND_MALFURION_ALT_21	Dzikie ostępy? Więc co robisz w Naxxramas?	
VO_NAX15_01_RESPOND_REXXAR_19	Odważne słowa jak na zwierzynę.	
VO_NAX15_01_RESPOND_THRALL_17	Zgładziciela? Kto wymyśla takie imiona?	
VO_NAX15_01_RESPOND_UTHER_14	...a ja będę walczyć z pomocą wielkich stronników i niszczących zaklęć. Powodzenia!	
VO_NAX15_01_RESPOND_VALEERA_18	Dobrze. Zachowam.	
VO_NAX15_01_START_13	W końcu się spotykamy.	
VO_NAX15_01_SUMMON_ADDS_12	Moi stronnicy, przyzywam was!	
VO_NAX2_01_CARD_02	Zabij w imię Mistrza!	
VO_NAX2_01_CUSTOM_03	Ty nędzniku!	
VO_NAX2_01_DEATH_LINE_05	Mistrz mnie pomści!	
VO_NAX2_01_EMOTE_06	Hahahaha!	
VO_NAX2_01_HP_04	Na kolana, robaku!	
VO_NAX2_01_START_01	Moi akolici służą mi bez wahania!	
VO_NAX3_01_CARD_01	*grghhghgh*	
VO_NAX3_01_DEATH_01	*syczenie*	
VO_NAX3_01_EMOTE_01	*syczenie*	
VO_NAX3_01_EMOTE_02	*syczenie*	
VO_NAX3_01_EMOTE_03	*syczenie*	
VO_NAX3_01_EMOTE_04	*syczenie*	
VO_NAX3_01_EMOTE_05	*syczenie*	
VO_NAX3_01_HP_01	*syczenie*	
VO_NAX3_01_START_01	*pierzchanie*	
VO_NAX4_01_CARD_03	To twe ostatnie tchnienie.	
VO_NAX4_01_DEATH_LINE_04	Będę służyć Mistrzowi... nawet po śmierci.	
VO_NAX4_01_EMOTE_06	Giń, intruzie!	
VO_NAX4_01_HP_02	Powstańcie, moi żołnierze! Powstańcie i walczcie raz jeszcze!	
VO_NAX4_01_START_01	Kolejna dusza do mojej... kolekcji.	
VO_NAX5_01_CARD_03	Przetrzepię ci MÓZG!	
VO_NAX5_01_DEATH_LINE_04	A mogłem w końcu się umyć.	
VO_NAX5_01_EMOTE_05	Nie mam czasu na te bzdury.	
VO_NAX5_01_HP_02	Tańcz dla mnie!	
VO_NAX5_01_START_01	Myślisz, że zdołasz tu przeżyć?	
VO_NAX6_01_CARD_03	Koniec jest bliski.	
VO_NAX6_01_DEATH_LINE_04	Wszystkich czeka śmierć.	
VO_NAX6_01_EMOTE_05	Marnujesz oddech.	
VO_NAX6_01_HP_02	Pochłonę cię!	
VO_NAX6_01_START_01	Widzę cię!	
VO_NAX7_01_CARD_03	Trzeba było zostać w domu!	
VO_NAX7_01_DEATH_LINE_04	Honorowa śmierć.	
VO_NAX7_01_EMOTE_05	Ha! Dopiero się rozgrzewam!	
VO_NAX7_01_HP_02	Hajda!	
VO_NAX7_01_START_01	Nie... nie! Natychmiast oddaj mi moich uczniów!	
VO_NAX8_01_CARD_02	Zabijaj moich stronników do woli... Ich dusze złożą ci wizytę.	
VO_NAX8_01_CUSTOM_03	Hahaha! Nie pojmujesz? Jestem Żniwiarzem Dusz!	
VO_NAX8_01_CUSTOM2_04	Martwi powracają!	
VO_NAX8_01_DEATH_LINE_05	Nadszedł mój koniec!	
VO_NAX8_01_EMOTE1_06	Bezmyślnie kroczysz w kierunku zagłady.	
VO_NAX8_01_EMOTE2_07	Bezczelnie ignorujesz moce, których nie jesteś w stanie zrozumieć.	
VO_NAX8_01_EMOTE3_08	Zawzięcie próbujesz dostać się do domeny Żniwiarza.	
VO_NAX8_01_EMOTE4_09	Zostało ci już tylko jedno wyjście...	
VO_NAX8_01_EMOTE5_10	...wejdź do menu opcji i naciśnij PODDAJ SIĘ.	
VO_NAX8_01_START_01	Moi stronnicy nigdy naprawdę nie giną.	
VO_NAX9_01_CUSTOM_02	Koniec gadaniny! Niech przyjdą!	
VO_NAX9_01_DEATH_LINE_03	Nie! Potrzebuję więcej czasu.	
VO_NAX9_01_EMOTE_04	Śmierci szukasz?!	
VO_NAX9_01_START_01	Zmielimy twoje kości na proch!	
VO_NAX9_02_CUSTOM_01	Intruzie! Zawróć, póki jeszcze możesz!	
VO_NAX9_03_CUSTOM_01	Przestań, Zelogu. Zabawimy się.	
VO_NAX9_04_CUSTOM_01	Dawej pokurczu, pokoż na co cię stać!	
VO_Nazra_Female_Orc_FinalNazraChogall_02	Klan Młota Zmierzchu? Tutaj?	
VO_Nazra_Female_Orc_FinalNazraDeath_01	Za Hordę!	
VO_Nazra_Female_Orc_FinalNazraEmoteResponse_01	Nazra cię zmiażdży!	
VO_Nazra_Female_Orc_FinalNazraGrom_01	Grommasz?! Kopę lat!	
VO_Nazra_Female_Orc_FinalNazraHeroPower_01	Nazra będzie władać tym nędznym światem!	
VO_Nazra_Female_Orc_FinalStartSequence_01	Na kolana przed Hordą!	
VO_NEFARIAN_ATRAMEDES_DEATH_76	Biedny ślepy smok... Martwy… Był bezbronny jak mały kotek. Jak ci nie wstyd!	
VO_NEFARIAN_BARON_GEDDON_DEAD_40	Jesteśmy już blisko. Coraz bliżej!	
VO_NEFARIAN_CHROMAGGUS_DEAD_63	Tak naprawdę Chromagus był najsłabszym z moich stronników. Nadal rozpiera cię duma?	
VO_NEFARIAN_CHROMAGGUS1_59	Stworzyłem go z dwiema głowami, bo co dwie szczęki to nie jedna!	
VO_NEFARIAN_CHROMAGGUS2_60	Nadałem mu moce wszystkich smoczych szczepów! To stworzenie doskonałe!	
VO_NEFARIAN_CHROMAGGUS3_61	Świetnie! Grzeczny Chromagus!	
VO_NEFARIAN_CHROMAGGUS4_62	A cóż to? Rękę ci zablokowało? Hehehe! Dobry piesek.	
VO_NEFARIAN_COREN_DEAD_28	Ponury Opoj. Przedziwne.	
VO_NEFARIAN_DRAKKISATH_DEAD_50	Zaczynasz mnie irytować.	
VO_NEFARIAN_DRAKKISATH_RESPOND_48	Tak, Drakkisacie. Awanturniku, NADAL JESTEŚ PO NIEWŁAŚCIWEJ STRONIE GÓRY!	
VO_NEFARIAN_DRAKKISATH1_49	Słuchaj, idź zagrać w trybie rankingowym. Ta przygoda jest nie dla ciebie.	
VO_NEFARIAN_GARR_DEAD1_38	Zabierz ze sobą kawałek Garra i puść nim kaczkę na jeziorze lawy Ragnarosa. Na pewno się ucieszy.	
VO_NEFARIAN_GARR2_35	Lepiej uważaj na te kamienne stwory.	
VO_NEFARIAN_GARR3_36	Tylko mi tu nie wybuchnij. Musisz jeszcze poradzić sobie z Władcą Żywiołu.	
VO_NEFARIAN_GARR4_37	Wiesz co…? Lubię patrzeć na twoje wysiłki.	
VO_NEFARIAN_GRIMSTONE_DEAD1_30	Oby tak dalej, a wkrótce Ragnaros zostanie wypędzony z tej góry!	
VO_NEFARIAN_HEROIC_BLOCK_77	Nie w trybie heroicznym.	
VO_NEFARIAN_MALORIAK_DEATH_PT1_72	Winszuję! Cóż za imponujące osiągnięcie!	
VO_NEFARIAN_MALORIAK_DEATH_PT2_73	Chyba muszę ukuć dla ciebie nowy tytuł z okazji tego wiekopomnego zwycięstwa.	
VO_NEFARIAN_MALORIAK_DEATH_PT3_74	„Pogromca ćwierć-inteligentnych, pół-kompetentnych i całkiem bezużytecznych stronników”. Pasuje jak ulał!	
VO_NEFARIAN_MALORIAK_TURN2_71	Maloriaku, postaraj się nie przegrać z tym śmiertelnikiem.	
VO_NEFARIAN_NEF_MISSION_66	O, nie! Nie ma takiego oszukiwania!	
VO_NEFARIAN_NEF2_65	Nie! NIEEE! Zniszczę cię!	
VO_NEFARIAN_OMNOTRON_DEAD_69	Naprawa tego złomu kosztowałaby mnie majątek. Dzięki tobie zaoszczędziłem mnóstwo złota!	
VO_NEFARIAN_OMOKK_DEAD_46	Nic z tego nie rozumiem.	
VO_NEFARIAN_OMOKK1_44	Co tu jeszcze robisz? Ragnaros nie żyje. Czemu nie świętujesz w gronie przyjaciół?	
VO_NEFARIAN_OMOKK2_45	Nie rozumiem. Nie ma tu więcej Ragnarosów. Twoja misja dobiegła końca. Wracaj do domu.	
VO_NEFARIAN_RAZORGORE_DEAD_55	Te jaja były przeznaczone do wyjątkowego eksperymentu!	
VO_NEFARIAN_REND_DEAD_53	Dobra, śmiertelniku. Udało ci się zadrzeć ze smokiem, którego nie powinno się drażnić.	
VO_NEFARIAN_REND1_52	Nawet ten ork wie, że popełniasz błąd.	
VO_NEFARIAN_THAURISSAN_DEAD_32	Trzeba było zabić tego drugiego krasnoluda! Żaden z nich nie może przeżyć!	
VO_NEFARIAN_THAURISSAN_DEAD2_33	Udało ci się zabić oba krasnoludy? Jestem pod wrażeniem!	
VO_NEFARIAN_VAEL_DEAD_57	Ha! Z twoich rąk zginęło niewinne stworzenie! Smutno ci teraz?	
VO_Netherspite_Male_Dragon_NetherspiteAngryChicken_01	To znowu ty! Dlaczego zawsze siedzisz w moich portalach?!	
VO_Netherspite_Male_Dragon_NetherspiteDeath_01	Moje dzieła...	
VO_Netherspite_Male_Dragon_NetherspiteEmoteResponse_01	Rzucasz wyzwanie smokowi w jego pracowni?	
VO_Netherspite_Male_Dragon_NetherspiteEmpowerment_01	Tyle światów! Tyle wiedzy do zdobycia!	
VO_Netherspite_Male_Dragon_NetherspiteOpen_01	Kto zakłóca moje badania?	
VO_Netherspite_Male_Dragon_NetherspiteShadowBreath_01	Odejdź!	
VO_Netherspite_Male_Dragon_NetherspiteTurn12_01	Hmm... Jeżeli o czwartej z czerwonego portalu wyjdzie 12 murloków, a C’Thun przybędzie o piątej... Hmm... Muszę się zastanowić...	
VO_Netherspite_Male_Dragon_NetherspiteTurn3_02	Moje eksperymenty! Nie dotykać!	
VO_Netherspite_Male_Dragon_NetherspiteTurn5_01	Przestań majstrować przy portalach! Modulacje przepływu są idealnie zestrojone!	
VO_Netherspite_Male_Dragon_NetherspiteTurn7_01	Idź lepiej bawić się na przyjęciu i zostaw moje portale w spokoju!	
VO_Netherspite_Male_Dragon_NetherspiteUnstablePortal_01	Interesujące. Bazowe zaburzenia.	
VO_Netherspite_Male_Dragon_NetherspiteUnstablePortal_02	Interesujące... Bazowe zaburzenia...	
VO_Nightbane_Roar	*RYK*	
VO_PrinceKeleseth_Male_Vampire_ResponseLanaThel_01	Moja królowo!	
VO_PrinceTaldaram_Male_Vampire_ResponseLanaThel_01	Moja królowo... Łaknę krwi.	
VO_PrinceValanar_Male_Vampire_ResponseLanaThel_01	Królowa Lana’thel!	
VO_RAGNAROS_GRIMSTONE_DEAD2_66	TO JA CIEBIE WYGONIĘ, ŁUSKOWATY PISKLAKU!	
VO_RAGNAROS_NEF1_71	BOHATERZE, CHYBA POTRZEBUJESZ POMOCY.	
VO_RAGNAROS_NEF3_72	NIE UNIKNIESZ MOJEJ ZEMSTY! OCZYŚCI CIĘ OGIEŃ!	
VO_RAGNAROS_NEF4_73	MOI STRONNICY CIĘ UNICESTWIĄ, CZARNOSKRZYDŁY!	
VO_RAGNAROS_NEF5_74	ZAMIEŃCIE TEGO NADĘTEGO SMOKA W GARŚĆ POPIOŁU!	
VO_RAGNAROS_NEF6_75	NIESPODZIANKA Z KRAINY OGNIA!	
VO_RAGNAROS_NEF7_76	NIE ZDOŁASZ ZDUSIĆ PŁOMIENI WŁADCY OGNIA!	
VO_RAGNAROS_NEF8_77	JESZCZE SIĘ ZEMSZCZĘ, SMOKU!	
VO_Rakanishu_Male_Elemental_CastSpell1_01	Ode mnie... PRECZ!	
VO_Rakanishu_Male_Elemental_CastSpell2_01	Ogień cię oczyści!	
VO_Rakanishu_Male_Elemental_CastSpell3_01	Giń, awanturniku!	
VO_Rakanishu_Male_Elemental_CastSpell4_01	Za Rafaama!	
VO_Rakanishu_Male_Elemental_CastSpell5_01	Wszystko spłonie!	
VO_Rakanishu_Male_Elemental_EventRagnaros_02	Mój bohater!	
VO_Rakanishu_Male_Elemental_Intro_01	Zniszczyć! Zabrać skarb!	
VO_SilverwareGolem_Male_SilverwareGolem_SilverwareDeath_02	Bo zupa była za słooona...	
VO_SilverwareGolem_Male_SilverwareGolem_SilverwareEmoteResponse_01	Nadszedł czas polerowania!	
VO_SilverwareGolem_Male_SilverwareGolem_SilverwareForkedLightning_01	Lubisz widelce? Mam widelce!	
VO_SilverwareGolem_Male_SilverwareGolem_SilverwareHeroPower_01	Przygotujcie stoły! Przygotujcie parkiet!	
VO_SilverwareGolem_Male_SilverwareGolem_SilverwareKnifeJuggler_01	Och, rzut nożem!	
VO_SilverwareGolem_Male_SilverwareGolem_SilverwareOpen_01	Taniec to świetna zabawa!	
VO_SilverwareGolem_Male_SilverwareGolem_SilverwarePlateTossing_01	Talerz dla ciebie, i dla ciebie, i dla ciebie też!	
VO_TB_MEDIVA1_001	Płońcie!	
VO_TB_MEDIVA1_002	Uważaj!	
VO_TB_MEDIVA1_003	Oh, Tito!	
VO_TB_MEDIVA1_004	Na zdrowie.	
VO_TB_MEDIVA1_005	Bestyjko!	
VO_TB_MEDIVA1_006	Sierściuchy.	
VO_TB_MEDIVA1_007	Nie! Tylko nie trucizna.	
VO_TB_MEDIVA1_008	Błyskają!	
VO_TB_MEDIVA1_009	Ktoś mnie wzywał?	
VO_TB_MEDIVA2_001	Gorąco!	
VO_TB_MEDIVA2_002	Straszna!	
VO_TB_MEDIVA2_003	Ooch, zimno.	
VO_TB_MEDIVA2_004	Och nie! Pułapka!	
VO_TB_MEDIVA2_005	Och nie, nie mogę na to patrzeć!	
VO_TB_MEDIVA2_006	Milusia.	
VO_TB_MEDIVA2_007	Uwielbiam chochliki.	
VO_TB_MEDIVA2_008	Błyskają!	
VO_TB_MEDIVA2_009	Apsik. Ech!	
VO_TB_MEDIVA2_010	Wezwano mnie?	
VO_TB_MEDIVA3_001	Gorąco!	
VO_TB_MEDIVA3_002	Zimno, zimnica!	
VO_TB_MEDIVA3_003	Straszna ciemność!	
VO_TB_MEDIVA3_004	To pułapka!	
VO_TB_MEDIVA3_005	Ależ bestie!	
VO_TB_MEDIVA3_006	Rogacz ma kolegów!	
VO_TB_MEDIVA3_007	Och nie, niedobrze.	
VO_TB_MEDIVA3_008	To dopiero trucizna!	
VO_TB_MEDIVA3_009	A teraz, czas na Medivy!	
VO_TB_MEDIVA3_010	Taaak!	
VO_Terenas_Male_Human_ICCDruidVictory_01	Niegdyś arcydruid opiekował się dzikimi kniejami Azeroth. Teraz Malfurion, Zaraza Wcielona, stoi na straży naturalnej równowagi, roztaczając pieczę nad ogrodem śmierci.	
VO_Terenas_Male_Human_ICCHunterVictory_01	Rexxar uwolnił dusze uwięzione niegdyś przez Króla Lisza. Wyciągnął z kołczanu czarną strzałę. – Chodź, Misza – powiedział. – Zaczęły się łowy...	
VO_Terenas_Male_Human_ICCMageVictory_01	Świeżo ukoronowana Pani Mrozu powiodła wzrokiem po swoim królestwie. Szeregi nieumarłych wzmocniły potęgę Jainy. Nawet nie zauważyła, gdy krew w jej żyłach krew zamieniła się w lód.	
VO_Terenas_Male_Human_ICCPaladinVictory_01	Niegdyś szlachetny paladyn wkroczył na nową ścieżką przeznaczenia. Ci, którzy wiedli poczciwe życie, nie mieli czego się obawiać. Ale niegodziwców po śmierci czekał jego sąd...	
VO_Terenas_Male_Human_ICCPriestVictory_01	Ciało młodego księcia przeistoczyło się w cień. – Teraz widzę wszystko – rzekł, a w jego oczach zabłysł błękitny płomień. – Byłem taki naiwny.	
VO_Terenas_Male_Human_ICCRogueVictory_01	Valeera, Ostrze Pustki zniknęła w ciemnościach. Cienie, którymi włada widzą wszystko a przed jej lodowym ostrzem nie ma ucieczki.	
VO_Terenas_Male_Human_ICCShamanVictory_01	Czaszkę szamana wypełniła kakofonia głosów umarłych. Prorok Śmierci zamknął oczy i wyrzekł tylko jedno słowo: „Spać...”.	
VO_Terenas_Male_Human_ICCWarlockVictory_01	Gul’dan zasiadł wreszcie na Mroźnym Tronie. Mroczny Portal po raz kolejny się otworzył, a niezliczone światy zadrżały z przerażenia.	
VO_Terenas_Male_Human_ICCWarriorVictory_01	Niegdysiejszy wódz Hordy wziął na siebie brzemię straszliwej mocy. Zamarznięte ofiary jego armii powstaną z martwych. Będą mu służyć, aż uczyni sobie poddanym cały świat.	
VO_TIRION_INTRO_03	Który z naszych dzielnych rycerzy zdobędzie dziś tytuł Mistrza?	
VO_WhiteKing_Male_ChessPiece_ChessDeath_01	Szach i mat.	
VO_WhiteKing_Male_ChessPiece_ChessEmoteGreetings_01	Zagramy partyjkę?	
VO_WhiteKing_Male_ChessPiece_ChessEmoteOops_01	Och, głupi ruch!	
VO_WhiteKing_Male_ChessPiece_ChessEmoteSorry_01	Niefortunne zagranie.	
VO_WhiteKing_Male_ChessPiece_ChessEmoteThanks_01	To bardzo uprzejme.	
VO_WhiteKing_Male_ChessPiece_ChessEmoteThinking_01	Hmm, wieża na A3...	
VO_WhiteKing_Male_ChessPiece_ChessEmoteThinking_02	Skoczek na F6...	
VO_WhiteKing_Male_ChessPiece_ChessEmoteThinking_03	Królowa na E5... Nie, nie, nie, nie...	
VO_WhiteKing_Male_ChessPiece_ChessEmoteThreaten_01	Widzę mata w czterech posunięciach.	
VO_WhiteKing_Male_ChessPiece_ChessEmoteWellPlayed_01	Szach-mat.	
VO_WhiteKing_Male_ChessPiece_ChessEmoteWow_01	Ach, znakomicie!	
VO_WhiteKing_Male_ChessPiece_ChessOpen_02	En garde!	
VOX_Nightbane_Start_01	Wrrr!	
