TAG	TEXT	COMMENT
ChromaggusBoss_Death_1	¡Roaaaaarr!	
ChromaggusBoss_EmoteResponse_1	*Gruñido*	
ChromaggusBoss_Start_1	¡Grrr!	
GiantRat_LOOTA_BOSS_18h_DefeatPlayer	<Chirrido>	
GiantRat_LOOTA_BOSS_18h_EmoteResponse	<Chirrido>	
GILA_BOSS_65h_Gobbles_DefeatPlayer	¡Reeeaaaooo!	
GILA_BOSS_65h_Gobbles_EmoteResponse	¡Bahauaoour!	
GILA_BOSS_65h_Gobbles_Intro	¡Uuaauuoooo!	
LOE_07_MINE_CART_EMOTES	CLANK	
LOOTA_BOSS_21h_GnoshTheGreatWorm_EmoteResponse	<Rugido>	
LOOTA_BOSS_47h_Lava_FilledRoom_Emote	<Ira>	
LOOTA_BOSS_52h_TreasureVault_Emote	<Clin-clin>	
OnyxiaBoss_Death_1	¡Roaaaaarr!	
OnyxiaBoss_EmoteResponse_1	*Gruñido*	
OnyxiaBoss_Start_1	¡Grrr!	
POPUP_FROST_BRAWL	¡Fatiga! Quien tenga más salud al final del próximo turno ganará la partida.	
POPUP_FROST_BRAWL_ARMOR	¡En esta pelea no vale esconderse detrás de la armadura!	
TheMothergloop_LOOTA_BOSS_24h_EmoteResponse	<Eructo>	
TrappedRoom_LOOTA_BOSS_48h_EmoteResponse	<Ruido mecánico>	
VO_Ahune_Male_Elemental_Brawl_01	¡SÍ! ¡APLASTEMOS A RAGNAROS!	
VO_Ahune_Male_Elemental_Brawl_02	¿QUIÉN TIENE EL PODER AHORA, EH, FOGOSILLO?	
VO_Ahune_Male_Elemental_Brawl_03	¡LA VENGANZA SE SIRVE FRÍA!	
VO_Ahune_Male_Elemental_Brawl_04	¿QUIÉN TIENE MÁS PROBABILIDADES DE MORIR A MANOS DE AVENTUREROS AHORA?	
VO_Ahune_Male_Elemental_Brawl_05	¿QUIÉN ES EL INSECTO AHORA?	
VO_Ahune_Male_Elemental_Brawl_07	¡LA PIEDRA DE HIELO SE HA FUNDIDO!	
VO_Ahune_Male_Elemental_Brawl_08	¿QUIÉN DESTRUIRÁ MÁS BUFONES?	
VO_Ahune_Male_Elemental_Brawl_11	¡UNA PUNTUACIÓN EXCELENTE!	
VO_Ahune_Male_Elemental_Brawl_15	¡HAY QUE DESTRUIR A RAGNAROS CON MÁS MALA UVA!	
VO_Ahune_Male_Elemental_Brawl_16	¡SE VE QUE ODIAS MUCHO A RAGNAROS!	
VO_Aran_Male_Shade_AranCrackle_01	Hum... En mis tiempos, Chisporroteo infligía 6 de daño.	
VO_Aran_Male_Shade_AranDeath_02	Otra vez no...	
VO_Aran_Male_Shade_AranEmoteResponse_01	¡Fuera, fuera!	
VO_Aran_Male_Shade_AranHeroPower_01	¡Arded, gamberros!	
VO_Aran_Male_Shade_AranMedivhSkin_01	¿Medivh? No, no... No importunaba a los invitados...	
VO_Aran_Male_Shade_AranOpen_01	Te voy a enseñar algo de respeto.	
VO_Aran_Male_Shade_AranSpell_03	¡A la fría oscuridad con vosotros!	
VO_Aran_Male_Shade_AranSpell_04	El amo es muy poderoso... ¡Pero yo tengo mis propios poderes!	
VO_Aran_Male_Shade_AranTrons_02	¡NO! ¡NO! ¡No lo soporto! ¡No puedo con sus "hola hola"!	
VO_Aran_Male_Shade_AranTurn1_01	¡No quiero música en mi torre!	
VO_Aran_Male_Shade_AranTurn5_01	¡No soy un simple juglar! ¡Soy Nielas Aran!	
VO_Barnes_Male_Human_FinalNazraTurn5_02	¡Socorro! ¡No nos quedan plátanos! ¡Mukkla está destrozando la despensa!	
VO_Barnes_Male_Human_JulianneTurn5_01	¿Qué es una fiesta sin una función? ¿Y una función sin público?	
VO_Barnes_Male_Human_JulianneWin_01	¡Fin del primer acto! ¡Quedan dos!	
VO_Barnes_Male_Human_Wing2Intro_02	¡Has llegado al teatro! Soy Barnes, el director de escena. Los portales para salvar a Medivh están en el piso de arriba, ¡pero antes debes ver la función!	
VO_Barnes_Male_Human_WolfBigMinion_01	Abuelita, ¡qué esbirros tan grandes tienes!	
VO_Barnes_Male_Human_WolfClaws_01	¡Calma! ¡Esas enormes garras son de atrezo!	
VO_Barnes_Male_Human_WolfTurn5_01	Me encanta que participe el público. ¡Huye, huésped! ¡Corre!	
VO_Barnes_Male_Human_WolfTurn9_01	Ja, ja, ¡qué gran espectáculo! ¡Mejor que el ogro que perseguimos el otro día!	
VO_Barnes_Male_Human_WolfWin_01	¡Ajá! ¡El gran final se acerca!	
VO_BigBadWolf_Male_Worgen_WolfBigMinion_01	¡Son para aplastarte mejor!	
VO_BigBadWolf_Male_Worgen_WolfDeath_01	¿Me han cazado? No...	
VO_BigBadWolf_Male_Worgen_WolfDireWolfAlpha_01	<Gruñido.>	
VO_BigBadWolf_Male_Worgen_WolfDireWolfAlpha_02	*Gemido*	
VO_BigBadWolf_Male_Worgen_WolfEmoteResponse_01	Mmmm... Qué delicia.	
VO_BigBadWolf_Male_Worgen_WolfOpen_01	¡Huye, criaturita! ¡Corre!	
VO_BigBadWolf_Male_Worgen_WolfScarletCrusader_01	Oh, Caperucita Roja, ¿adónde vas?	
VO_BigBadWolf_Male_Worgen_WolfTurn1_01	Mira a tus esbirros. ¿Has visto cómo tiemblan al verme?	
VO_BlackKing_Male_ChessPiece_ChessEmoteGreetings_01	Siempre.	
VO_BlackKing_Male_ChessPiece_ChessEmoteOops_01	¿O una trampa?	
VO_BlackKing_Male_ChessPiece_ChessEmoteSorry_01	Un sacrificio necesario.	
VO_BlackKing_Male_ChessPiece_ChessEmoteThanks	Un placer.	
VO_BlackKing_Male_ChessPiece_ChessEmoteThanks_01	Un placer.	
VO_BlackKing_Male_ChessPiece_ChessEmoteThreaten_01	Pues yo lo veo en tres.	
VO_BlackKing_Male_ChessPiece_ChessEmoteWellPlayed_01	Todavía no.	
VO_BlackKing_Male_ChessPiece_ChessEmoteWow_01	Naturalmente.	
VO_BlackKing_Male_ChessPiece_ChessOpen_01	¡Nadie pasará!	
VO_BOSS_AYA_Female_Pandaren_BC_0_Jade_Golem_02	¿Más gólems? ¡TOMA YA!	
VO_BOSS_AYA_Female_Pandaren_BC_0_Jade_Golem_03	¡Ji, ji, ji, ji, ji, ji! ¡TOMA EJÉRCITO!	
VO_BOSS_AYA_Female_Pandaren_BC_0_Jade_Golem_04	¡Otro! ¡OTROOO!	
VO_BOSS_AYA_Female_Pandaren_BC_2_1st_Turn_Start_01	Seh, claro… ¡Gadgetzan es solo mío!	
VO_BOSS_AYA_Female_Pandaren_BC_2_2nd_Turn_Start_01	Gadgetzan pertenece al Loto de Jade… ¡y el Loto de Jade me pertenece a mí!	
VO_BOSS_AYA_Female_Pandaren_BC_2_Arms_Dealing1_01	Más armas. Qué originalidad.	
VO_BOSS_AYA_Female_Pandaren_BC_2_Fill1_01	Ooooh, esto te va a encantar…	
VO_BOSS_AYA_Female_Pandaren_BC_2_Fill2_01	Nah, ¡me gusta este sitio! ¡Me quedaré!	
VO_BOSS_AYA_Female_Pandaren_BC_2_Goons_Win_01	¡No, no, no, no, no, no! ¡ESTO SÍ QUE NO!	
VO_BOSS_AYA_Female_Pandaren_BC_2_Goons_Winning_02	¡¿Por qué no te CALLAS?!	
VO_BOSS_AYA_Female_Pandaren_BC_2_Jade_Win_01	¡El Loto de Jade vuelve a ganar! ¡Soy lo más!	
VO_BOSS_AYA_Female_Pandaren_BC_2_Lotus_Winning_01	¡Ji, ji, ji! ¡Sigue jugando, sigue!	
VO_BOSS_AYA_Female_Pandaren_BC_3_1st_Turn_Start_01	¡Gadgetzan MOLA MOGOLLÓN! ¡Lo quiero para mí!	
VO_BOSS_AYA_Female_Pandaren_BC_3_1st_Turn_Start_02	Ji, ji, ji… Será un placer…	
VO_BOSS_AYA_Female_Pandaren_BC_3_2nd_Turn_Start_01	Los del Kabal sois unos mueeeermos de cuidado…	
VO_BOSS_AYA_Female_Pandaren_BC_3_Fill1_01	Qué buen día hace, ¿eh, Kazakito?	
VO_BOSS_AYA_Female_Pandaren_BC_3_Fill2_01	Uh, Kazakito, relájate. Intenta divertirte un poco.	
VO_BOSS_AYA_Female_Pandaren_BC_3_Jade_Golem3_01	¡Ji, ji, ji, ji!	
VO_BOSS_AYA_Female_Pandaren_BC_3_Kabal_Winning_01	Sí, cansada de tus mamarrachadas.	
VO_BOSS_AYA_Female_Pandaren_BC_3_Kabal_Wins_01	¡NO ME LO CREO! ¡NO, NO, NO, NO Y NO!	
VO_BOSS_AYA_Female_Pandaren_BC_3_Lotus_Winning_01	Ohhh, ¿qué te pasa, Kazakito? ¡Menuda paliza te están dando!	
VO_BOSS_AYA_Female_Pandaren_BC_3_Lotus_Wins_01	Me lo he pasado bien. ¡Gracias por jugar, Kazakito!	
VO_BOSS_AYA_Female_Pandaren_BC_3_Potion1_02	Bla, bla, bla, pociones, bla, bla, bla. ¡Ven aquí y LUCHA, cobarde!	
VO_BOSS_AYA_Female_Pandaren_BC_3_Potion3_01	¡Puaj! ¡Pero qué asco!	
VO_BOSS_AYA_Female_Pandaren_Concede_01	Bah, aguafiestas…	
VO_BOSS_AYA_Female_Pandaren_Greetings_01	¡Holaaa!	
VO_BOSS_AYA_Female_Pandaren_Oops_01	¡Ups!	
VO_BOSS_AYA_Female_Pandaren_START_01	¡Prepara los gólems!	
VO_BOSS_AYA_Female_Pandaren_Thanks_02	¡Muchas gracias!	
VO_BOSS_AYA_Female_Pandaren_Threaten_02	Mmm… Ahora tendrás que morir.	
VO_BOSS_AYA_Female_Pandaren_Well_Played_01	¡No está nada mal!	
VO_BOSS_AYA_Female_Pandaren_Wow_02	¡Guaaa!	
VO_BOSS_CHO_Male_Ogre_BC_1_1st_Turn_Start_01	¡LOS MUGRES APLASTAR FLORES!	
VO_BOSS_CHO_Male_Ogre_BC_1_Fill2_01	¡ATACAR, MUCHACHOS!	
VO_BOSS_CHO_Male_Ogre_BC_2_Fill1_01	¡QUÉ OJOS DE LOCA!	
VO_BOSS_CHO_Male_Ogre_Concede_01	SÍ, DIGO, NO. CULPA TUYA.	
VO_BOSS_CHO_Male_Ogre_Oops_02	UY, ERROR.	
VO_BOSS_CHO_Male_Ogre_Thanks_01	GRACIAS.	
VO_BOSS_HAN_Male_Ogre_BC_0_Arms_Dealing_01	Algo se ha caído de un camión… Je, je, je…	
VO_BOSS_HAN_Male_Ogre_BC_0_Arms_Dealing_02	¡Mugres a mí!	
VO_BOSS_HAN_Male_Ogre_BC_0_Arms_Dealing_03	¡Armad a ese Mugre y sacadlo ahí fuera!	
VO_BOSS_HAN_Male_Ogre_BC_0_Arms_Dealing_04	¡Los Matones Mugrientos son familia!	
VO_BOSS_HAN_Male_Ogre_BC_1_1st_Turn_Start_01	Este barrio no es para flores delicadas, Kazakus.	
VO_BOSS_HAN_Male_Ogre_BC_1_2nd_Turn_Start_01	Gadgetzan es de los Mugres, ¿capito?	
VO_BOSS_HAN_Male_Ogre_BC_1_2nd_Turn_Start_02	Me parece muy bien, pero Gadgetzan pertenece a los Mugres.	
VO_BOSS_HAN_Male_Ogre_BC_1_Fill1_01	No quiero ver más pociones de esas.	
VO_BOSS_HAN_Male_Ogre_BC_1_Fill2_01	Cho, llama a los Mugres. Este trol necesita... persuasión.	test
VO_BOSS_HAN_Male_Ogre_BC_1_Goons_Win_01	Lo siento, Kazakus. Los negocios son los negocios.	
VO_BOSS_HAN_Male_Ogre_BC_1_Goons_Winning_01	Vaya, Kazakus, ni que hubieras sufrido un... accidente.	
VO_BOSS_HAN_Male_Ogre_BC_1_Kabal_Win_02	Esto... no ha... acabado... Kazakus...	
VO_BOSS_HAN_Male_Ogre_BC_1_Kabal_Winning_02	Je. Sigues en forma, abuelo.	
VO_BOSS_HAN_Male_Ogre_BC_1_Potion1_01	No me gustan las pociones ni con lasaña.	
VO_BOSS_HAN_Male_Ogre_BC_1_Potion2_01	¡Eh, vigila adónde tiras eso!	
VO_BOSS_HAN_Male_Ogre_BC_2_1st_Turn_Start_01	¡Gadgetzan es nuestro! ¡Lárgate, pintamonas!	
VO_BOSS_HAN_Male_Ogre_BC_2_1st_Turn_Start_04	Sí, bueno, los Matones Mugrientos queremos decir algo al respecto...	
VO_BOSS_HAN_Male_Ogre_BC_2_Fill1_01	No me gusta esa mirada, Aya.	
VO_BOSS_HAN_Male_Ogre_BC_2_Goons_Win_01	Tranquilízate, Aya. Je, je, te vendrá bien.	
VO_BOSS_HAN_Male_Ogre_BC_2_Goons_Winning_01	¿No quieres replantearte tu bando?	
VO_BOSS_HAN_Male_Ogre_BC_2_Jade_Golem2_01	Estos tipos de jade empiezan a cansarme.	
VO_BOSS_HAN_Male_Ogre_BC_2_Lotus_Win_01	Agh… Gadgetzan… será… nuestro…	
VO_BOSS_HAN_Male_Ogre_BC_2_Lotus_Winning_01	Argh… Llevaos de aquí a esta cría.	
VO_BOSS_HAN_Male_Ogre_Concede_01	¡Toda la culpa es tuya!	
VO_BOSS_HAN_Male_Ogre_Greetings_01	Gadgetzan te da la bienvenida.	
VO_BOSS_HAN_Male_Ogre_INTRO_PACK_OPEN_7	Un momento… ¿Quién es ese apuesto galán? Je, je, je.	
VO_BOSS_HAN_Male_Ogre_Oops_01	Mamma mia...	
VO_BOSS_HAN_Male_Ogre_START_01	Ahora estás en nuestro territorio.	
VO_BOSS_HAN_Male_Ogre_Thanks_01	Has cumplido un gran servicio.	test
VO_BOSS_HAN_Male_Ogre_Threaten_01	Mis ofertas no se rechazan…	
VO_BOSS_HAN_Male_Ogre_Well_Played_02	Tengo que admitir que me has impresionado.	
VO_BOSS_HAN_Male_Ogre_WOW_01	No está mal.	
VO_BOSS_KAZAKUS_Male_Troll_BC_0_Potion_01	Ah, qué refrehcante...	
VO_BOSS_KAZAKUS_Male_Troll_BC_0_Potion_02	¡Toma ehto!	
VO_BOSS_KAZAKUS_Male_Troll_BC_0_Potion_04	Acábatela toda...	
VO_BOSS_KAZAKUS_Male_Troll_BC_0_Potion_05	¡¿A qué sabe, eh?!	
VO_BOSS_KAZAKUS_Male_Troll_BC_1_1st_Turn_Start_01	¡Gadgetzan será mío, Han'Cho!	
VO_BOSS_KAZAKUS_Male_Troll_BC_1_2nd_Turn_Start_01	El Kabal ehtá en todah parteh. Gadgetzan ehtá a nuehtroh pieh.	
VO_BOSS_KAZAKUS_Male_Troll_BC_1_Arms_Dealing1_01	Mmm... La clásica cobardía de loh Mugreh. ¡SALID DE LA MANO!	
VO_BOSS_KAZAKUS_Male_Troll_BC_1_Fill1_01	El Kabal controla un poder infinito.	
VO_BOSS_KAZAKUS_Male_Troll_BC_1_Goons_Win_01	¡Volveré, y máh poderoso que nunca!	
VO_BOSS_KAZAKUS_Male_Troll_BC_1_Goons_Winning_01	¡Sufriráh eternamente, Han'Cho!	
VO_BOSS_KAZAKUS_Male_Troll_BC_1_Kabal_Win_01	Claro que sí.	
VO_BOSS_KAZAKUS_Male_Troll_BC_1_Kabal_Winning_01	¡El dehtino te aguarda, Han'Cho!	
VO_BOSS_KAZAKUS_Male_Troll_BC_3_1st_Turn_Start_01	¡Ja, ja, ja! Para eso tendráh que vencerme.	
VO_BOSS_KAZAKUS_Male_Troll_BC_3_Fill1_01	¡NO ME LLAMEH ASÍ, NIÑA INSOLENTE!	
VO_BOSS_KAZAKUS_Male_Troll_BC_3_Fill2_01	¡Ríndete ante el poder del Kabal!	
VO_BOSS_KAZAKUS_Male_Troll_BC_3_Jade_Golem2_01	¡Niña insolente! ¿Osah mofarte del líder máh poderoso de Gadgetzan?	
VO_BOSS_KAZAKUS_Male_Troll_BC_3_Jade_Golem3_01	¡Insolente! Ya bahta de ehta tontería de loh gólem.	
VO_BOSS_KAZAKUS_Male_Troll_BC_3_Kabal_Winning_01	¡Pareceh cansada, niñita!	
VO_BOSS_KAZAKUS_Male_Troll_BC_3_Kabal_Winning_02	¡¿Qué?! ¡Será posible! ¡YO seré TU FIN!	test
VO_BOSS_KAZAKUS_Male_Troll_BC_3_Kabal_Wins_01	¡Ja, ja! ¡Una víctima máh del poder del Kabal!	
VO_BOSS_KAZAKUS_Male_Troll_BC_3_Lotus_Winning_01	Será descarada...	
VO_BOSS_KAZAKUS_Male_Troll_BC_3_Lotus_Wins_01	¡Insensata! ¡Ehto no ha terminadooo...!	
VO_BOSS_KAZAKUS_Male_Troll_BC_3_Potion1_01	Siente la furia de lah pocioneh del Kabal.	
VO_BOSS_KAZAKUS_Male_Troll_Concede_01	Ehtah... calleh... me... pertenecen...	
VO_BOSS_KAZAKUS_Male_Troll_Greetings_02	¡Saludoh, ignoranteh!	test
VO_BOSS_KAZAKUS_Male_Troll_Mirror_Start_01	Ereh bahtante hábil.	
VO_BOSS_KAZAKUS_Male_Troll_Oops_01	Un error de cálculo.	
VO_BOSS_KAZAKUS_Male_Troll_START_01	El maná me llama...	
VO_BOSS_KAZAKUS_Male_Troll_Thanks_01	Te lo agradezco, peón.	
VO_BOSS_KAZAKUS_Male_Troll_Threaten_01	¡YO CONTROLO GADGETZAN!	
VO_BOSS_KAZAKUS_Male_Troll_Well_Played_02	Tu potencial ehtá por ehplotar...	
VO_BOSS_KAZAKUS_Male_Troll_Wow_01	¡El poder eh intenso en ti!	
VO_BRANN_MITHRIL_ALT_02	Fascinante. Estas runas de mitril contienen código de guardián. ¡Deben datar de la era de los titanes!	
VO_BRANN_WIN_07_ALT_07	¡Los hemos perdido! ¡La cabeza del bastón está en la siguiente sala!	
VO_BRM_027h_Death_63	¡No! ¡NO! ¡NOOOOOOOOOOOO!!!!	
VO_BRMA01_1_CARD_05	Venga, ¡démosles una cálida bienvenida!	
VO_BRMA01_1_DEATH_09	Jo, jo, jo. ¿Qué? Ah, no me gusta nada, pero va a ocurrir de todas formas.	
VO_BRMA01_1_ETC_06	¡Es la hora del espectáculo! ¡Un fuerte aplauso para Elite Tauren Chieftain!	
VO_BRMA01_1_HERO_POWER_04	¡Ja, ja, ja! ¡Más peña!	
VO_BRMA01_1_RESPONSE_03	Ja, ja, ja… ¡hip! ¡Uy, perdón!	
VO_BRMA01_1_START_01	¡Te doy la bienvenida al Tragapenas!	
VO_BRMA01_1_SUCCUBUS_08	¡Coima Nagmara! Creo que a mi "colega" le sentaría bien un "trago".	
VO_BRMA01_1_TURN1_02	¡Atención! Ja, ja. Mira por dónde… tenemos visita.	
VO_BRMA01_1_WARGOLEM_07	¡Jo, jo, jo! ¡Estás en apuros! ¡Falange! ¡Ataca!	
VO_BRMA02_1_ALAKIR_34	¡A este señor elemental le encanta aplastar insectos! ¡Al'Akir!	
VO_BRMA02_1_ALEXSTRAZA_32	Protectora, reina de los dragones, combatiente de la Arena Hierro Negro… ¡Alexstrasza!	
VO_BRMA02_1_BEAST_22	Le encanta comer gnomos, pero está dispuesta a hacer una excepción. ¡Es la Bestia!	
VO_BRMA02_1_BOOM_28	¡Espero que todos estéis a cubierto, porque nuestro siguiente contrincante es el Dr. Bum!	
VO_BRMA02_1_CAIRNE_20	Está educando a su hijo para que siga sus huellas. ¡Un aplauso para Cairne Pezuña de Sangre!	
VO_BRMA02_1_CHO_07	Es la hora del cuento con el pandaren más adorable: ¡el eremita Cho!	
VO_BRMA02_1_DEATH_38	¡Hjt! ¿Eh? ¡Aah! ¡Uf!	
VO_BRMA02_1_DEATHWING_35	¡Uuuuh! ¡Señoras y señores! El único, el inigualable… ¡ALAMUERTE!	
VO_BRMA02_1_ETC_18	Y ahora, el tauren, el mito, la leyenda… ¡Elite Tauren Chieftain!	
VO_BRMA02_1_FEUGEN_15	¡Un aplauso para Feugen!	
VO_BRMA02_1_FOEREAPER_29	Programada mecánicamente para la máxima destrucción, ¡es la Siegaenemigos 4000!	
VO_BRMA02_1_GEDDON_13	Uuh, ¡la Arena se está calentando! ¡Demos la bienvenida al barón Geddon!	
VO_BRMA02_1_GELBIN_21	Recién llegado de Nueva Ciudad Manitas, ¡saludad al jefe de los gnomos, Gelbin Mekkatorque!	
VO_BRMA02_1_GRUUL_31	¡Si lo llaman el Asesino de Dragones es por algo! ¡Un aplauso para Gruul!	
VO_BRMA02_1_HERO_POWER_05	¡El público se está impacientando! ¡Ja, ja, ja, ja!	
VO_BRMA02_1_HOGGER_27	Saludad al gnoll de nivel 11 que se convirtió en leyenda en sus ratos libres: ¡Hogger!	
VO_BRMA02_1_ILLIDAN_23	¿Quién necesita ojos teniendo gujas gemelas? ¡Illidan Tempestira no, desde luego!	
VO_BRMA02_1_LEVIATHAN_12	Recién restaurado y listo para destruir, ¡el Leviatán de llamas!	
VO_BRMA02_1_LOATHEB_16	Tapaos la nariz, cubríos la boca y animad a la podredumbre personificada: ¡Loatheb!	
VO_BRMA02_1_MAEXXNA_24	¡Aquí llega la araña gigante! ¿Y cuál es su nombre? ¡Maexxna!	
VO_BRMA02_1_MILLHOUSE_09	¿Quién ha dejado entrar a ese en la Arena?	
VO_BRMA02_1_MOGOR_25	Su vocabulario es limitado, pero su cólera no tiene fin. ¡Mogor el ogro!	
VO_BRMA02_1_MUKLA_10	Y ahora, el señor de los plátanos: ¡el rey Mukla!	
VO_BRMA02_1_NOZDORMU_36	Señoras y… ¡ups! Se acabó el tiempo.	
VO_BRMA02_1_ONYXIA_33	Recién llegada de Marjal Revolcafango y del castillo de Ventormenta, ¡Onyxia!	
VO_BRMA02_1_PAGLE_08	De vuelta de su viaje de pesca, ¡el maestro pescador Nat Pagle!	
VO_BRMA02_1_RESPONSE_04	¡Nadie puede sobrevivir a todas estas leyendas!	
VO_BRMA02_1_SNEED_30	¡El siguiente contrincante se esconde tras los controles de una vieja trituradora! ¿Quién será?	
VO_BRMA02_1_STALAGG_14	¿Logrará Stalagg sobrevivir en la Arena? ¡Veámoslo!	
VO_BRMA02_1_START_01	¡Un nuevo desafío!	
VO_BRMA02_1_SYLVANAS_19	Su odio eterno arde para vosotros. ¡Demos la bienvenida a Sylvanas Brisaveloz!	
VO_BRMA02_1_THALNOS_06	Un aplauso para el esqueleto con botas: ¡el mago sangriento Thalnos!	
VO_BRMA02_1_THAURISSAN_37	Recién llegado de una misión posterior a esta, ¡el emperador Thaurissan!	
VO_BRMA02_1_TINKMASTER_11	¡Un fuerte aplauso para el gran inventor, el maestro manitas Sobrechispa!	
VO_BRMA02_1_TOSHLEY_26	Este gnomo se encuentra lejos de su hogar. ¡Dad la bienvenida a Toshley!	
VO_BRMA02_1_TURN1_02	¡Enanas y enanos! ¡Menudo espectáculo tenemos preparado!	
VO_BRMA02_1_TURN1_PT2_03	¡Un solo individuo contra las mayores leyendas de Azeroth!	
VO_BRMA02_1_VOLJIN_17	¡Silencio! Tenemos un invitado especial: ¡el Jefe de Guerra Vol'jin!	
VO_BRMA03_1_CARD_04	Por el poder de Ragnaros, ¡yo tengo el poder!	
VO_BRMA03_1_DEATH_09	¡Aaaaaaaaaah!	
VO_BRMA03_1_HERO_POWER_06	¡¡¡Muereee!!!	
VO_BRMA03_1_MOIRA_DEATH_05	¡No! ¡Moira! ¡ME LAS PAGARÁS!	
VO_BRMA03_1_RESPONSE_03	¡Cierra la boca o te la cierro yo!	
VO_BRMA03_1_START_01	¡Los enanos Hierro Negro jamás caerán!	
VO_BRMA03_1_TURN1_02	¡Eh! ¡Deja a mi mujer en paz!	
VO_BRMA03_1_VS_RAG_07	¡No! ¡Ragnaros! ¡Otra vez no!	
VO_BRMA04_1_CARD_04	Jurafuegos, ¡vamos allá!	
VO_BRMA04_1_DEATH_06	¡Rrrrrrrrrrrrh!	
VO_BRMA04_1_HERO_POWER_05	¡Magma!	
VO_BRMA04_1_RESPONSE_03	Piedra siempre gana.	
VO_BRMA04_1_START_01	Te voy a dejar de piedra.	
VO_BRMA04_1_TURN1_02	Te haré pedazos.	
VO_BRMA05_1_CARD_05	¡Tic, tac, mortal!	
VO_BRMA05_1_DEATH_04	Un último servicio...	
VO_BRMA05_1_HERO_POWER_06	¡Arde!	
VO_BRMA05_1_RESPONSE_03	¡Armagedón!	
VO_BRMA05_1_START_01	¡Arderás!	
VO_BRMA05_1_TURN1_02	¡Ragnaros te consumirá!	
VO_BRMA06_1_DEATH_04	¡Me rindo! ¡Me rindo!	
VO_BRMA06_1_RESPONSE_03	¿Crees que ya has ganado? ¡Pues yo creo que necesitas otra lección de dolor!	
VO_BRMA06_1_START_01	¡Nadie puede desafiar a la llama eterna!	
VO_BRMA06_1_SUMMON_RAG_05	¡Contemplad a Ragnaros, el que ya era anciano cuando el mundo aún era joven!	
VO_BRMA06_1_TURN1_02_ALT	¡Perseguidlo!	
VO_BRMA06_3_INTRO_01	¡DEMASIADO PRONTO! ¡ME HAS DESPERTADO DEMASIADO PRONTO, EXECUTUS!	
VO_BRMA06_3_RESPONSE_03	¿¿¿QUÉ SIGNIFICA ESTA INTRUSIÓN???	
VO_BRMA06_3_TURN1_02	¡MORTAL! ¿TE ATREVES A ENTRAR EN MIS DOMINIOS?	
VO_BRMA07_1_CARD_04	¡Hora de machacar!	
VO_BRMA07_1_DEATH_06	¡Rrrnoooooo!	
VO_BRMA07_1_HERO_POWER_05	¡Yo machacar! ¡Tú morir!	
VO_BRMA07_1_RESPONSE_03	¡¡¡Raaar!!! ¡Yo machacar!	
VO_BRMA07_1_START_01	¡Yo aplastarte!	
VO_BRMA07_1_TURN1_02	¿Aplastar o machacar? ¡DECISIÓN DIFÍCIL!	
VO_BRMA08_1_CARD_05	¡Protegeré la Cumbre!	
VO_BRMA08_1_DEATH_06	Rrh. ¡Aah! ¡Noooooo!	
VO_BRMA08_1_RESPONSE_04	¡¿Por qué?! ¡Dime por qué! Me gustabas.	
VO_BRMA08_1_START_01	¿¿Qué haces tú aquí??	
VO_BRMA08_1_TURN1_03	¡Lord Nefarius! ¿No fue este sujeto quien se encargó de Ragnaros por nosotros?	
VO_BRMA08_1_TURN1_ALT_02	¿Vienes para ayudarme a destruir a los mortales de este mundo?	
VO_BRMA09_1_CARD_05	¡La Cumbre es NUESTRA!	
VO_BRMA09_1_DEATH_11	¡Gaaaaaaah!	
VO_BRMA09_1_HERO_POWER1_06	¡Abrid las puertas!	
VO_BRMA09_1_HERO_POWER2_07	¡Hay que matar al del fondo!	
VO_BRMA09_1_HERO_POWER3_08	¡Centraos en el héroe, necios!	
VO_BRMA09_1_HERO_POWER4_09	¡Juntos somos IMPARABLES!	
VO_BRMA09_1_RESPONSE_04	¡Muajajajaja!	
VO_BRMA09_1_START_01	¡Somos la verdadera Horda!	
VO_BRMA09_1_TURN1_03	¡Estás escalando la montaña equivocada!	
VO_BRMA09_1_TURN1_ALT_02	¡Nadie nos detendrá! ¡¡¡MUERE!!!	
VO_BRMA10_1_DEATH_08	¡Rrrrrrrrrrrh!	
VO_BRMA10_1_EGG_DEATH_1_05	¡Loco! ¡Esos huevos son más valiosos de lo que crees!	
VO_BRMA10_1_EGG_DEATH_2_06	¡No, otro no! ¡Rodará tu cabeza por esta infamia!	
VO_BRMA10_1_EGG_DEATH_3_07	¡Pagarás por esto!	
VO_BRMA10_1_HERO_POWER_04	¡Aléjate de esos huevos!	
VO_BRMA10_1_RESPONSE_03	¡Te haré picadillo!	
VO_BRMA10_1_START_01	¡Contempla los huevos corruptos de nuestro nuevo Vuelo!	
VO_BRMA10_1_TURN1_02	¡Estos huevos serán tu perdición!	
VO_BRMA11_1_ALEXSTRAZA_07	Ayúdame. ¡Protectora! ¡Ayúdame!	
VO_BRMA11_1_CARD_04	¡La furia de Roca Negra corre por mis venas!	
VO_BRMA11_1_DEATH_ALT_08	Por fin termina la agonía...	
VO_BRMA11_1_HERO_POWER_05	¡Aaaah! ¡Destrucción!	
VO_BRMA11_1_KILL_PLAYER_06	Perdóname, he fracasado.	
VO_BRMA11_1_RESPONSE_03	¡Deberías haber escapado mientras podías, mortal!	
VO_BRMA11_1_START_01	¡Huye! ¡Antes de que pierda el control!	
VO_BRMA11_1_TURN1_02	Demasiado tarde… ¡Ahora estoy poseído por la corrupción de Nefarian!	
VO_BRMA13_1_DEATH_ALT_23	¡NO! ¡VOLVERÉEEE!	
VO_BRMA13_1_DEATHWING_19	¿¿Papi??	
VO_BRMA13_1_HP_DRUID_14	Druida, ¡yo controlo lo salvaje!	
VO_BRMA13_1_HP_GENERIC_18	¡Tu magia me pertenece!	
VO_BRMA13_1_HP_HUNTER_12	¡El cazador se convierte en presa!	
VO_BRMA13_1_HP_MAGE_11	Mago, deberías tener más cuidado al jugar con magia.	
VO_BRMA13_1_HP_PALADIN_07	Paladín, ¿te ha abandonado la Luz?	
VO_BRMA13_1_HP_PRIEST_08	Sacerdote, ¡ahora la Luz me sirve a mí!	
VO_BRMA13_1_HP_ROGUE_15	Pícaro, ¡sal y enfréntate a mí!	
VO_BRMA13_1_HP_SHAMAN_13	Chamán, ahora los elementos me obedecen a mí.	
VO_BRMA13_1_HP_WARLOCK_10	Brujo, ¡juegas con magia que escapa a tu comprensión!	
VO_BRMA13_1_HP_WARRIOR_09	Guerrero, ¡tu fuerza es tu debilidad!	
VO_BRMA13_1_RESPONSE_05	¡Yo soy aquí el maestro!	
VO_BRMA13_1_START_01	¡Te doy la bienvenida a mi sagrario personal!	
VO_BRMA13_1_TURN1_PT1_02	¡Ja, ja, ja! ¡Contempla el verdadero poder de NEFARIAN!	
VO_BRMA13_1_TURN1_PT2_03	¡Maná infinito! ¡Dragontina acorazada!	
VO_BRMA14_1_CARD_09	Redirigiendo exceso de energía.	
VO_BRMA14_1_DEATH_08	Sistemas de defensa destruidos. Apagando…	
VO_BRMA14_1_HP1_03	Unidad Electron activada.	
VO_BRMA14_1_HP2_04	Unidad Toxitron activada.	
VO_BRMA14_1_HP3_05	Unidad Arcanotron activada.	
VO_BRMA14_1_HP4_06	Unidad Magmatron activada.	
VO_BRMA14_1_HP5_07	Unidad de defensa conectada.	
VO_BRMA14_1_RESPONSE1_10	Bip, bop, bip.	
VO_BRMA14_1_RESPONSE2_11	Intentando conectar.	
VO_BRMA14_1_RESPONSE3_12	Conexión establecida. Descargando actualizaciones.	
VO_BRMA14_1_RESPONSE4_13	Actualización instalada. ¡Hola! ¡Hola! ¡Hola!	
VO_BRMA14_1_RESPONSE5_14	¡Hola! ¡Hola! ¡Hola!	
VO_BRMA14_1_START_01	Detectados intrusos.	
VO_BRMA14_1_TURN1_02	Iniciada matriz de defensa primaria.	
VO_BRMA15_1_CARD_05	¡Mis fracasos serán vuestra caída!	
VO_BRMA15_1_DEATH_04	¡Aaaaaaaahhhhh!	
VO_BRMA15_1_HERO_POWER_06	Mezclar y agitar, aplicar calor...	
VO_BRMA15_1_RESPONSE_03	¡Todo se aprovecha!	
VO_BRMA15_1_START_01	¡No, no puede haber interrupciones!	
VO_BRMA15_1_TURN1_02	¡Ooh! ¡No debo hacer esperar al maestro! ¡No debo fallar otra vez!	
VO_BRMA16_1_CARD_04	No puedes esconderte.	
VO_BRMA16_1_DEATH_06	¡Rrrraaaaaaaah!	
VO_BRMA16_1_GONG1_10	¡Aah! ¡¡Ese sonido!!	
VO_BRMA16_1_GONG2_11	¡Noo! ¡¡Qué cerca!!	
VO_BRMA16_1_GONG3_12	¡¡MIS OÍDOS!!	
VO_BRMA16_1_HERO_POWER_05	¡Tus torpes pasos y tu hediondo olor te delatan!	
VO_BRMA16_1_RESPONSE_03	Sí, habla, ¡me estoy acercando!	
VO_BRMA16_1_START_01	¡Oigo los latidos de tu corazón!	
VO_BRMA16_1_TRIGGER1_07	¡Ah! Te oigo…	
VO_BRMA16_1_TRIGGER2_08	Oigo pasos.	
VO_BRMA16_1_TRIGGER3_09	Oigo los latidos de tu corazón. ¡No puedes huir!	
VO_BRMA16_1_TURN1_02	¡La muerte aguarda en la oscuridad!	
VO_BRMA17_1_CARD_86	Espero que sepas nadar… ¡EN LAVA FUNDIDA!	
VO_BRMA17_1_DEATH_97	¡Aaaaaaaaaaah!	
VO_BRMA17_1_DEATH_HEROIC_98	¡NOOOOOOOOOO!	
VO_BRMA17_1_DEATHWING_88	¿¿PAPI??	
VO_BRMA17_1_HERO_POWER_87	¡Mi llama de las sombras da vida a sus huesos!	
VO_BRMA17_1_NEF_AIR1_89	¡Mírame lanzar fuego desde arriba! ¡1 p. de daño es solo el principio!	
VO_BRMA17_1_NEF_AIR2_90	¡Dos bolas de fuego! ¡Las lanzo desde lo alto!	
VO_BRMA17_1_NEF_AIR3_91	Esta vez solo lanzaré una bola de fuego porque me estoy reservando para un turno glorioso.	
VO_BRMA17_1_NEF_AIR4_92	¡Jo, jo! ¡Tres bolas de fuego! ¡Toma ya! ¡Desde arriba!	
VO_BRMA17_1_NEF_AIR5_93	¡Desde ahora solo lanzaré una bola de fuego!	
VO_BRMA17_1_NEF_AIR6_94	¡Era broma! ¡CUATRO bolas de fuego! ¡Ja, ja, ja!	
VO_BRMA17_1_NEF_AIR7_95	Esta vez no lanzaré ninguna bola de fuego. Pero prepárate…	
VO_BRMA17_1_NEF_AIR8_96	¡VEINTE BOLAS DE FUEGO! ¡JA, JA, JA!	
VO_BRMA17_1_RESPONSE_85	Mentes mortales... Tan fáciles de manipular.	
VO_BRMA17_1_RESURRECT1_82	¡La destrucción llegará desde arriba!	
VO_BRMA17_1_RESURRECT2_83	Estoy arriba, ¡pero tengo una sorpresa para ti ahí abajo!	
VO_BRMA17_1_RESURRECT3_84	¡Contempla mi creación definitiva! ¡Álzate, hermana! ¡Álzate, Onyxia!	
VO_BRMA17_1_START_78	¡Has llegado hasta el glorioso final!	
VO_BRMA17_1_TRANSFORM1_80	He intentado ser un buen anfitrión, ¡PERO NO MUERES!	
VO_BRMA17_1_TRANSFORM2_81	Es hora de dejarnos de tonterías y simplemente... ¡MATARTE!	
VO_BRMA17_1_TURN1_79	Mi creación definitiva espera, mortal.	
VO_COOP02_00	¡Os purificaré a ambos de la maldición de la carne!	
VO_COOP02_02	¡Derrotad al maestro de palancas Mecazod para ganar!	
VO_COOP02_ABILITY_05	¡Voy a darle cuerda!	
VO_COOP02_ABILITY_06	¡Hora de cerrar la imprenta, eremita Cho!	
VO_COOP03_01	¡Yo soy aquí el maestro!	
VO_COOP03_02	¡No! ¡No! ¡Te destruiré!	
VO_COOP03_03	Mentes mortales... Tan fáciles de manipular.	
VO_COOP03_04	He intentado ser un buen anfitrión, ¡PERO NO MUERES!	
VO_COOP03_05	Es hora de dejarnos de tonterías y simplemente... ¡MATARTE!	
VO_COOP03_06	Sacerdote, ¡ahora la Luz me sirve a mí!	
VO_COOP03_07	Chamán, ahora los elementos me obedecen a mí.	
VO_COOP03_08	¡Ja, ja, ja! ¡Contempla el verdadero poder de Nefarian!	
VO_COOP03_09	¡Ja, ja, ja! ¡Has llegado hasta el glorioso final!	
VO_Crone_Female_Troll_CroneDeath_02	¡No! ¡Caeráh en mi poder! Cae... ráh...	
VO_Crone_Female_Troll_CroneEmoteResponse_02	¡Jaaa, ja, ja, ja, ja!	
VO_Crone_Female_Troll_CroneFlyingMonkeys_01	¡Traedme a la niña!	
VO_Crone_Female_Troll_CroneHeroPower_02	¡Ji, ji, ji ji!	
VO_Crone_Female_Troll_CroneOpen_01	¡Ja, ja, ja, ja! ¡Volad, queridoh míoh!	
VO_Curator_Male_ArcaneGolem_CuratorArcaneGolem_01	Curioso. El parecido es extraordinario.	
VO_Curator_Male_ArcaneGolem_CuratorBeasts_01	Este Curator es alérgico a las bestias.	
VO_Curator_Male_ArcaneGolem_CuratorDemons_01	Los demonios no deberían estar aquí.	
VO_Curator_Male_ArcaneGolem_CuratorDragons_01	No más excrementos de dragón.	
VO_Curator_Male_ArcaneGolem_CuratorEmoteResponse_01	No se puede procesar tu petición.	
VO_Curator_Male_ArcaneGolem_CuratorHarrison_02	¡Ladrón detectado! Harrison Jones no puede entrar aquí.	
VO_Curator_Male_ArcaneGolem_CuratorMechs_01	Reprogramando ayudantes.	
VO_Curator_Male_ArcaneGolem_CuratorMedivhSkin_01	Falso Medivh detectado. Tiene ojos de demente.	
VO_Curator_Male_ArcaneGolem_CuratorMurlocs_01	Soltando pezqueñín.	
VO_Curator_Male_ArcaneGolem_CuratorPirates_01	Los piratas arrrmarán una buena.	
VO_Curator_Male_ArcaneGolem_CuratorReno_02	¡Ladrón detectado! Reno Jackson no puede entrar aquí.	
VO_Curator_Male_ArcaneGolem_CuratorTurn1_01	Este Curator está equipado para gestionar la Sala de las Fieras.	
VO_Curator_Male_ArcaneGolem_CuratorTurn5_01	Sigue los protocolos de la galería.	
VO_Curator_Male_ArcaneGolem_CuratorTurn9_01	Los invitados deben permanecer en la Sala de las Fieras.	
VO_Curator_Male_ArcaneGolem_IllhoofKilrekResponse_01	A este Curator no le importa. Está prohibido invocar.	
VO_Curator_Male_ArcaneGolem_IllhoofSenseDemons_01	Múltiples demonios detectados.	
VO_Curator_Male_ArcaneGolem_IllhoofTurn1_01	Los rituales de invocación están prohibidos.	
VO_Curator_Male_ArcaneGolem_IllhoofTurn5_01	Los rituales dañan a los inquilinos. El demonio no debe seguir.	
VO_Curator_Male_ArcaneGolem_IllhoofWin_01	Este Curator te lo agradece. La Sala de las Fieras se restablecerá.	
VO_Curator_Male_ArcaneGolem_NightbaneCorruption_01	¡No! ¡La Sala de las Fieras no debe corromperse!	
VO_Curator_Male_ArcaneGolem_NightbaneTour_01	La magia descontrolada pervirtió la mente del dragón Nocturno, antes conocido como Arcanagos.	
VO_Curator_Male_ArcaneGolem_NightbaneTour_02	A la izquierda, un busto de Aran. A la derecha, el Farol de poder.	
VO_Curator_Male_ArcaneGolem_NightbaneTurn1_01	Las criaturas pueden sufrir daño. Deben regresar a la Sala de las Fieras.	
VO_Curator_Male_ArcaneGolem_NightbaneTurn3_01	Primero, hay que salvar a las criaturas. Luego, podrás continuar.	
VO_Curator_Male_ArcaneGolem_NightbaneUnstablePortal_01	Los invitados deben ir con cuidado. Este dragón teme la magia inestable.	
VO_Curator_Male_ArcaneGolem_NightbaneWin_01	Se requiere ayuda adicional.	
VO_Curator_Neither_ArcaneGolem_CuratorDeath_04	Des-co-ne-xióoon...	
VO_Curator_Neither_ArcaneGolem_CuratorOpen_01	No toques la exposición.	
VO_ELISE_LOE16_ALT_1_FIRST_HALF_02	Mientras el bastón se carga, Rafaam es invulnerable.	
VO_ELISE_LOE16_ALT_1_SECOND_HALF_03	Cuando acabe, podremos atacarlo, ¡pero también habrá que lidiar con la criatura que invoque!	
VO_ELISE_WEIRD_DECK_05	Perdón por el mazo. Lo creamos para un torneo el año pasado y no lo hemos actualizado.	
VO_EMOTE_HERO_TBKTRAF_KT_DRAWING_BOARD	Vuelta al punto de partida...	
VO_EMOTE_HERO_TBKTRAF_KT_GLOAT	Suplica clemencia.	
VO_EMOTE_HERO_TBKTRAF_KT_MINIONS_SERVANTS	Esbirros, sirvientes, soldados de la fría oscuridad...	
VO_FP1_014t_EnterPlay_01	¡Ahora sientes dolor!	
VO_FP1_031_Attack_07	Corderos al matadero...	
VO_FP1_031_EnterPlay_06	¡La Plaga te consumirá!	
VO_GIL_504_Female_Orc_TUT_LootSelect2_01	¿Quién osa destruir a mis monstruosos hijos?	
VO_GIL_504_Female_Orc_TUT_Victory_Generic_01	Una victoria hueca. El bosque y yo somos uno, y no caeré fácilmente.	
VO_GIL_504_Female_Orc_TUT_Victory1_01	El Bosque Embrujado no sucumbirá con facilidad. ¿Les irá a todos tan bien como a ti?	
VO_GIL_504_Female_Orc_TUT_Victory2_01	Dos héroes han logrado conquistar el Bosque Embrujado, pero aún no me habéis encontrado.	
VO_GIL_504_Female_Orc_TUT_Victory3_01	Tu camino te acerca a mí. ¿Triunfará también tu último campeón?	
VO_GIL_504_Female_Orc_TUT_Victory4_01	Esto termina esta noche. ¡Encuéntrame y contempla el horror que yace en el corazón del bosque!	
VO_GIL_504_Female_Orc_UI_Monster_Azlina_02	Oh, la pobre Azalina, siempre perdida. Saldrá de aquí... De una forma u otra.	
VO_GIL_504_Female_Orc_UI_Monster_Baran_01	Baran era un alma tan noble... Desgraciadamente, necesitaba sus ojos.	
VO_GIL_504_Female_Orc_UI_Monster_Brushwood_Cent_01	La rabia de este poderoso druida fue fácil de manipular.	
VO_GIL_504_Female_Orc_UI_Monster_Chupacabran_01	El Chupacabras. ¡Oh! Me costó mucho someterlo a mi voluntad.	
VO_GIL_504_Female_Orc_UI_Monster_Cragtorr_01	Enfréntate a la ira de la tierra atormentada. ¡Álzate, Abruptor!	
VO_GIL_504_Female_Orc_UI_Monster_Crowskin_01	Glinda, acaba con él. Tienes todo el culto a tu disposición.	
VO_GIL_504_Female_Orc_UI_Monster_DrSezavo_01	No sois más que una enfermedad, y Sezavo tiene la cura.	
VO_GIL_504_Female_Orc_UI_Monster_Experiment3C_01	Mmm... Esa cosa no es mía.	
VO_GIL_504_Female_Orc_UI_Monster_Face_Collector_01	Serías una pieza idónea para su colección.	
VO_GIL_504_Female_Orc_UI_Monster_Gnarlroot_01	Antiguos espíritus, ¡oíd lo que os digo! Por la raíz y la zarza, ¡que no quede uno vivo!	
VO_GIL_504_Female_Orc_UI_Monster_Griselda_01	Griselda pagó cara su intromisión.	
VO_GIL_504_Female_Orc_UI_Monster_Groddo_01	Mi querido guardián de la ciénaga... Cuando me dieron por muerta, cuidó de mí.	
VO_GIL_504_Female_Orc_UI_Monster_Grubb_01	Ni yo puedo controlar a Grubb.	
VO_GIL_504_Female_Orc_UI_Monster_Grum_01	¡Tierra y marga ancestrales, alzaos y arrasad sus hogares!	
VO_GIL_504_Female_Orc_UI_Monster_Gustave_01	¡Gustavo! Deja algo para tu ama.	
VO_GIL_504_Female_Orc_UI_Monster_Hannigul_01	Una vez Hannigul eliminó a las alimañas de la ciudad. Alimañas como tú.	
VO_GIL_504_Female_Orc_UI_Monster_Havnixx_01	Hav'nixx puede oír tus pensamientos. Se alimenta de tu miedo.	
VO_GIL_504_Female_Orc_UI_Monster_Infinite_Toki_01	Gnoma entrometida. Esto termina aquí. ¿Os conocéis?	
VO_GIL_504_Female_Orc_UI_Monster_Ivan_01	Ivan era uno de los vuestros. Ahora es mío.	
VO_GIL_504_Female_Orc_UI_Monster_Lord_Godfrey_01	¡Godfrey! Teníamos un acuerdo. Este es todo tuyo.	
VO_GIL_504_Female_Orc_UI_Monster_Lovers_01	Es una historia de amor. Una historia de fantasmas. Es la historia de vuestro fin.	
VO_GIL_504_Female_Orc_UI_Monster_Mistwraith_01	En la noche más profunda, los susurros del bosque contestan.	
VO_GIL_504_Female_Orc_UI_Monster_Mute_01	Silenciosa. Letal.	
VO_GIL_504_Female_Orc_UI_Monster_Niira_01	Basta de juegos, Niira. ¡Acaba con esto!	
VO_GIL_504_Female_Orc_UI_Monster_Raeth_01	No todos los Renegados han abandonado este bosque. Algunos me sirven.	
VO_GIL_504_Female_Orc_UI_Monster_Rancel_01	Los venenos de Rancel ayudaron a crear este oscuro bosque.	
VO_GIL_504_Female_Orc_UI_Monster_Sazzmi_01	Quédate un rato y escucha. Quédate para siempre.	
VO_GIL_504_Female_Orc_UI_Monster_Sephira_01	Con ala y garra, hermanas arpías, mantened la paz en mi bosque.	
VO_GIL_504_Female_Orc_UI_Monster_Shivers_01	¡Álzate, Escalofríos! La venganza está a tu alcance. Te entrego a la princesa de Gilneas.	
VO_GIL_504_Female_Orc_UI_Monster_Shudderwock_01	¡El Espantagón! Una bestia terrible... Un espectáculo maravilloso.	
VO_GIL_504_Female_Orc_UI_Monster_Splintergraft_01	El bosque rezuma miedo y aullidos. Ramas y tallos, aplastad a mis enemigos.	
VO_GIL_504_Female_Orc_UI_Monster_Sthara_01	Los gilneanos me adorarán... en cuanto S'thara los convenza.	
VO_GIL_504_Female_Orc_UI_Monster_Vitus_01	En mi bosque hay sitio para los proscritos.	
VO_GIL_504_Female_Orc_UI_Monster_Wharrgarbl_01	Adoro a los múrlocs. Son como ranas, pero... con peor coordinación.	
VO_GIL_598_Female_Human_SpecialSylvanas_01	Maldita bruja... ¡Mataste a mi hermano!	
VO_GIL_692_Male_Worgen_TUT_AdventureSelect_01	¡Héroes! ¿Quién de vosotros osará adentrarse en el Bosque Embrujado?	
VO_GIL_692_Male_Worgen_TUT_BossReveal1_01	El bosque que rodea Gilneas está repleto de monstruos terribles. Cázalos uno a uno.	
VO_GIL_692_Male_Worgen_TUT_BossReveal2_01	A medida que te adentres en el bosque, las criaturas serán más peligrosas.	
VO_GIL_692_Male_Worgen_TUT_BossReveal3_01	Hagatha es la fuente del poder oscuro que se oculta en el Bosque Embrujado. ¡Encuéntrala y detenla!	
VO_GIL_692_Male_Worgen_TUT_BossReveal3ALT_01	Estos monstruos son obra de Hagatha. ¡Derrótalos hasta que demos con ella!	
VO_GIL_692_Male_Worgen_TUT_CharacterSelect_01	Formáis parte de un equipo de élite con habilidades únicas para el combate.	
VO_GIL_692_Male_Worgen_TUT_Defeat1_01	Si te derrotan en el Bosque Embrujado, perderás el mazo que has creado.	
VO_GIL_692_Male_Worgen_TUT_FightBegin1Crowley_01	¡Crowley! Maneja el cañón para aprovechar al máximo su potencia.	
VO_GIL_692_Male_Worgen_TUT_FightBegin1Shaw_01	Se abre la veda, Shaw. Envía a tus perros para ganar ventaja frente a los enemigos.	
VO_GIL_692_Male_Worgen_TUT_FightBegin1Tess_01	Estarás sola ahí fuera. Recorre el campo de batalla en busca de hechizos.	
VO_GIL_692_Male_Worgen_TUT_FightBegin1Tess_02	Eres la única hija que me queda, Tess. Ten cuidado ahí fuera.	
VO_GIL_692_Male_Worgen_TUT_FightBegin1Toki_01	Toki, gracias a tu manipulación del tiempo, tienes más suerte que la mayoría.	
VO_GIL_692_Male_Worgen_TUT_FightBegin2_01	Estas... cosas... no son naturales. ¡Algo está volviendo este bosque en nuestra contra!	
VO_GIL_692_Male_Worgen_TUT_LootSelect1_01	Crea tu mazo para poder adentrarte aún más en el Bosque Embrujado.	
VO_GIL_692_Male_Worgen_TUT_LootSelect2_02	¡Tú! ¿Eres tú quien está creando estas cosas?	
VO_GIL_692_Male_Worgen_TUT_TreasureSelect1_01	Acaba con monstruos para conseguir un botín increíble. ¡Elige tus recompensas con cuidado!	
VO_GIL_692_Male_Worgen_TUT_Victory_Final_01	¡Se acabó! El bosque vuelve a estar tranquilo y la luz vuelve a brillar en nuestra ciudad.	
VO_GILA_400h_Male_Human_EVENT_HAGATHA_ALMOSTDEAD_02	¡Tendrá que esforzarse más!	
VO_GILA_400h_Male_Human_EVENT_HAGATHA_INTRO_01	¡Mis perros han encontrado a Hagatha!	
VO_GILA_400h_Male_Human_EVENT_HAGATHA_LOWHEALTH_01	Está herida. ¡Seguid su rastro!	
VO_GILA_400h_Male_Human_EVENT_HAGATHA_TURN4_01	Y yo una jauría de perros.	
VO_GILA_400h_Male_Human_EVENT_IVAN_INTRO_01	¡Eras de los nuestros, Ivan!	
VO_GILA_400h_Male_Human_EVENT_NEMESIS_INTRO_01	¡Por fin te encontré, Piel de Cuervo!	
VO_GILA_400h_Male_Human_EVENT_NEMESIS_TURN2_01	¿Por qué te uniste a Hagatha?	
VO_GILA_500h3_Female_Human_EVENT_HAGATHA_SUB_IN_01	¡Ponte a salvo! Yo me encargo.	
VO_GILA_500h3_Female_Human_EVENT_HAGATHA_TURN2_01	Gilneas ha sobrevivido a cosas peores.	
VO_GILA_500h3_Female_Human_EVENT_HAGATHA_TURN4_01	¡Fuera de aquí, bruja!	
VO_GILA_500h3_Female_Human_EVENT_HAGATHA_WOUNDED_01	Vete del bosque y te dejaré vivir.	
VO_GILA_500h3_Female_Human_EVENT_IVAN_INTRO_01	¡Ivan! Tú te vienes conmigo.	
VO_GILA_500h3_Female_Human_EVENT_NEMESIS_INTRO_01	Escalofríos... ¿No estabas muerto?	
VO_GILA_500h3_Female_Human_EVENT_NEMESIS_TURN2_01	Terminaré lo que mi padre empezó.	
VO_GILA_600h_Male_Worgen_EVENT_HAGATHA_SUB_IN_01	Voy a por ti, Hagatha.	
VO_GILA_600h_Male_Worgen_EVENT_HAGATHA_TURN2_01	Esta tierra es de los gilneanos.	
VO_GILA_600h_Male_Worgen_EVENT_HAGATHA_TURN4_01	Al menos YO no estoy solo.	
VO_GILA_600h_Male_Worgen_EVENT_HAGATHA_WOUNDED_01	Entonces derribaré hasta el último árbol.	
VO_GILA_600h_Male_Worgen_EVENT_IVAN_INTRO_01	¡Traidor! ¡Por fin te daré tu merecido!	
VO_GILA_600h_Male_Worgen_EVENT_NEMESIS_INTRO_01	¡Traidor! ¡Por fin te daré tu merecido!	
VO_GILA_600h_Male_Worgen_EVENT_NEMESIS_TURN02_01	Tú ya estabas podrido antes de morir, Godfrey.	
VO_GILA_900h_Female_Gnome_EVENT_HAGATHA_ALMOST_DEAD_01	El tiempo lo cura todo.	
VO_GILA_900h_Female_Gnome_EVENT_HAGATHA_SUB_IN_01	Descansa, ¡ahora me toca a mí!	
VO_GILA_900h_Female_Gnome_EVENT_HAGATHA_TURN2_01	He removido cielo y tierra para destruirte.	
VO_GILA_900h_Female_Gnome_EVENT_HAGATHA_WOUNDED_01	Se acerca tu hora, bruja.	
VO_GILA_900h_Female_Gnome_EVENT_IVAN_INTRO_01	Ivan, ¡estás perdido! He visto cómo acaba esto.	
VO_GILA_900h_Female_Gnome_EVENT_NEMESIS_INTRO_B_01	Esto... ¿ha pasado antes?	
VO_GILA_900h_Female_Gnome_EVENT_NEMESIS_TURN2_02	¡¿Pero qué creo que estoy haciendo?!	
VO_GILA_900h_Female_Gnome_EVENT_NEMESIS_TURN6_01	¿Vienes del futuro? ¿Quién gana, tú o yo?	
VO_GILA_BOSS_20h_MangyWolf_DefeatPlayer	¡Grrrourooo!	
VO_GILA_BOSS_20h_MangyWolf_Emote	¡Grrruraaah!	
VO_GILA_BOSS_20h_MangyWolf_Intro	¡Rouuauu!	
VO_GILA_BOSS_21h_Rottooth_Emote	¡ROOOooooah!	
VO_GILA_BOSS_21h_Rottooth_Intro	Nrgruhh... ¡UUUUH!	
VO_GILA_BOSS_21h_Rottooth_PlayerDefeat	Uff, uff... ¡Grrrr!	
VO_GILA_BOSS_22h_Male_Undead_Death_01	<Muerte.>	
VO_GILA_BOSS_22h_Male_Undead_DefeatPlayer_01	¡Arr! Por fin tengo para comprarme una funda para la daga.	
VO_GILA_BOSS_22h_Male_Undead_EmoteResponse_01	Sigue hablando, mi tripulación está en camino.	
VO_GILA_BOSS_22h_Male_Undead_EmoteResponseTess_01	¡Guárdate los ruegos para el capitán Escalofríos, princesa!	
VO_GILA_BOSS_22h_Male_Undead_EventPlaysCoin_01	¡Sabía que llevabas monedas!	
VO_GILA_BOSS_22h_Male_Undead_EventPlaysShiv_01	Me gusta cómo trabajas.	
VO_GILA_BOSS_22h_Male_Undead_Intro_01	¡El capitán quiere que te "desaparezca"!	
VO_GILA_BOSS_22h_Male_Undead_IntroCrowley_01	¿Quieres un comandante? ¿Pagas bien?	
VO_GILA_BOSS_22h_Male_Undead_IntroTess_01	El capitán está mosca contigo, princesa.	
VO_GILA_BOSS_23h_Male_Ettin_DefeatPlayer_01	¡Yo ganar!\n(<i>¿Dónde estar todos mis esbirros?</i>)	
VO_GILA_BOSS_23h_Male_Ettin_EmoteResponse_02	¡Tú no gustarme!\n(<i>¡Tú solo gustarme un poco!</i>)	
VO_GILA_BOSS_23h_Male_Ettin_HeroPower_01	¡Tú arriba!	
VO_GILA_BOSS_23h_Male_Ettin_HeroPower_02	¡Arriba!	
VO_GILA_BOSS_23h_Male_Ettin_HeroPower_03	¡Huah!	
VO_GILA_BOSS_23h_Male_Ettin_HeroPower_04	¡VOLAR!	
VO_GILA_BOSS_23h_Male_Ettin_HeroPower_05	¡A por ellos!	
VO_GILA_BOSS_23h_Male_Ettin_Intro_01	Tú parecer fácil de lanzar.\n(<i>¡Muy fácil!</i>)	
VO_GILA_BOSS_24h_Male_Bogbeast_DefeatPlayer_01	Primero flotan y luego explotan...	
VO_GILA_BOSS_24h_Male_Bogbeast_EmoteResponse_01	Púdrete ya...	
VO_GILA_BOSS_24h_Male_Bogbeast_EventPlaysSmallMinion_01	Bua, je, je, ja.	
VO_GILA_BOSS_24h_Male_Bogbeast_EventPlaysSmallMinion_02	Ua, ja, ja, ja.	
VO_GILA_BOSS_24h_Male_Bogbeast_EventPlaysSmallMinion_03	Mu, ju, ja, ja.	
VO_GILA_BOSS_24h_Male_Bogbeast_EventPlaysSmallMinion_04	Error.	
VO_GILA_BOSS_24h_Male_Bogbeast_HeroPower_01	Nunca estoy solo.	
VO_GILA_BOSS_24h_Male_Bogbeast_HeroPower_02	La ciénaga guarda secretos.	
VO_GILA_BOSS_24h_Male_Bogbeast_HeroPower_04	Mira quién ha venido.	
VO_GILA_BOSS_24h_Male_Bogbeast_Intro_01	En MI ciénaga solo viven los muertos.	
VO_GILA_BOSS_25h_Male_Dwarf_DefeatPlayerALT_01	Hagatha le ha puesto precio a tu cabeza, ¿sabes?	
VO_GILA_BOSS_25h_Male_Dwarf_EmoteResponse_01	Tú sigue ladrando, que yo te sigo atrapando.	
VO_GILA_BOSS_25h_Male_Dwarf_EventPlayCompass_01	Bonita brújula. Creo que me la quedo.	
VO_GILA_BOSS_25h_Male_Dwarf_EventPlaysSecret_01	Yo también sé jugar a eso.	
VO_GILA_BOSS_25h_Male_Dwarf_EventPlaysSecret_02	Ese ya lo he visto antes.	
VO_GILA_BOSS_25h_Male_Dwarf_EventPlaysSecret_03	¿Te crees que me puedes engañar?	
VO_GILA_BOSS_25h_Male_Dwarf_EventPlayToolsOfTheTrade_01	Algunas de esas armas eran mías, señorita.	
VO_GILA_BOSS_25h_Male_Dwarf_EventPlayTrapper_01	¡Bah! ¡Para eso hace falta maña!	
VO_GILA_BOSS_25h_Male_Dwarf_EventTokiAbility_01	¡He dicho que nada de trucos, gnoma!	
VO_GILA_BOSS_25h_Male_Dwarf_HeroPower_01	Mira bien dónde pisas.	
VO_GILA_BOSS_25h_Male_Dwarf_HeroPower_02	Mejor que andes con cuidado.	
VO_GILA_BOSS_25h_Male_Dwarf_HeroPower_03	Siempre un paso por delante.	
VO_GILA_BOSS_25h_Male_Dwarf_HeroPower_04	No hay lugar seguro.	
VO_GILA_BOSS_25h_Male_Dwarf_Intro_01	Tu cabeza tiene un precio jugoso.	
VO_GILA_BOSS_25h_Male_Dwarf_IntroDarius_01	Te crees muy poderoso con tu cañón, Crowley.	
VO_GILA_BOSS_25h_Male_Dwarf_IntroShaw_01	Yo no soy como tú. No creo en las causas perdidas.	
VO_GILA_BOSS_25h_Male_Dwarf_IntroTess_02	Estás en mi lista, Cringrís. ¡Y tu padre es el siguiente!	
VO_GILA_BOSS_25h_Male_Dwarf_IntroToki_01	¡No intentes ninguno de tus trucos, gnoma!	
VO_GILA_BOSS_26h_Male_Tauren_Death_01	Mis... gnomos...	
VO_GILA_BOSS_26h_Male_Tauren_DeathToki_01	¡Qué ironía!	
VO_GILA_BOSS_26h_Male_Tauren_DefeatPlayer_01	No creo que quepas en mi mochila.	
VO_GILA_BOSS_26h_Male_Tauren_DefeatPlayerToki_01	Nada mejor que añadir un gnomo poco común a tu colección.	
VO_GILA_BOSS_26h_Male_Tauren_EmoteResponse_01	¡No pienso compartir!	
VO_GILA_BOSS_26h_Male_Tauren_EmoteResponseToki_01	Mmm... A ti también te gusta hablar...	
VO_GILA_BOSS_26h_Male_Tauren_EventBurgle_01	¿Tienes gnomos por ahí?	
VO_GILA_BOSS_26h_Male_Tauren_EventBurgle_03	¿Es un gnomo eso de tu bolsillo?	
VO_GILA_BOSS_26h_Male_Tauren_EventPlayClockworkAssistant_01	Esa es una imitación de baja calidad.	
VO_GILA_BOSS_26h_Male_Tauren_EventPlayGattlingGunner_01	¿Dónde has encontrado ese?	
VO_GILA_BOSS_26h_Male_Tauren_EventPlaysClockwork_02	Es un modelo antiguo, difícil de encontrar.	
VO_GILA_BOSS_26h_Male_Tauren_EventPlaysGnome_01	¡Tengo uno de esos! En alguna parte.	
VO_GILA_BOSS_26h_Male_Tauren_EventPlaysGnome_02	¡Ese es extraordinario!	
VO_GILA_BOSS_26h_Male_Tauren_EventPlaysGnome_05	Tienes buen gusto.	
VO_GILA_BOSS_26h_Male_Tauren_EventPlaysGnome_06	Voy a añadir ese a mi colección.	
VO_GILA_BOSS_26h_Male_Tauren_EventPlaysLeper_01	Este es un poco asqueroso.	
VO_GILA_BOSS_26h_Male_Tauren_EventPlaysMillhouse_02	¡Este no se calla ni debajo del agua!	
VO_GILA_BOSS_26h_Male_Tauren_EventPlaysThermaplugg_02	¡Este gnomo vale su peso en oro!	
VO_GILA_BOSS_26h_Male_Tauren_EventSackOfGnomes_01	He olvidado lo que había puesto aquí.	
VO_GILA_BOSS_26h_Male_Tauren_EventSackOfGnomes_03	He perdido la cuenta de los que tengo.	
VO_GILA_BOSS_26h_Male_Tauren_EventSackOfGnomes_04	A ver qué tenemos por aquí.	
VO_GILA_BOSS_26h_Male_Tauren_EventSackOfGnomes_05	Estos son los restos.	
VO_GILA_BOSS_26h_Male_Tauren_EventSilence_03	Silencio...	
VO_GILA_BOSS_26h_Male_Tauren_Intro_02	¿Has venido a por mis gnomos?	
VO_GILA_BOSS_26h_Male_Tauren_IntroToki_02	Oh, otro para mi colección...	
VO_GILA_BOSS_27h_Male_Construct_Death_02	¡Al fin hemos escapado!	
VO_GILA_BOSS_27h_Male_Construct_DefeatPlayer_01	¡No eras... mi objetivo!	
VO_GILA_BOSS_27h_Male_Construct_EmoteResponse_01	Lo siento, a veces hago eso.	
VO_GILA_BOSS_27h_Male_Construct_EventPlayDrBoom_02	¿Dr. Bum? ¡No me lleves de vuelta al laboratorio!	
VO_GILA_BOSS_27h_Male_Construct_EventPlaySparePart_01	Había muchas piezas así... en el laboratorio...	
VO_GILA_BOSS_27h_Male_Construct_EventPlayUnstablePortal_01	El laboratorio... en Tormenta Abisal...	
VO_GILA_BOSS_27h_Male_Construct_HeroPowerBeast_02	... una bestia en mi interior...	
VO_GILA_BOSS_27h_Male_Construct_HeroPowerDemon_01	... una gran oscuridad...	
VO_GILA_BOSS_27h_Male_Construct_HeroPowerDragon_01	... qué criatura tan magnífica...	
VO_GILA_BOSS_27h_Male_Construct_HeroPowerGeneric_01	... otro...	
VO_GILA_BOSS_27h_Male_Construct_HeroPowerMech_02	... ¡un corazón mecánico!	
VO_GILA_BOSS_27h_Male_Construct_HeroPowerMurloc_01	... más pescado...	
VO_GILA_BOSS_27h_Male_Construct_HeroPowerPirate_01	... ¿arr?	
VO_GILA_BOSS_27h_Male_Construct_Intro_01	Encantado de olerte.	
VO_GILA_BOSS_29h_Female_Satyr_DefeatPlayer_01	Estos bosques tienen su propia melodía.	
VO_GILA_BOSS_29h_Female_Satyr_EmoteResponse_01	Cuánto atrevimiento.	
VO_GILA_BOSS_29h_Female_Satyr_EventPlaysEnchantingTune_01	Nadie se resiste a mi melodía.	
VO_GILA_BOSS_29h_Female_Satyr_EventPlaysEnchantingTune_02	¿No podemos llevarnos todos bien?	
VO_GILA_BOSS_29h_Female_Satyr_EventPlaysEnchantingTune_03	¡Nunca muerdo a quien me sigue!	
VO_GILA_BOSS_29h_Female_Satyr_EventPlaysOldMilitiaHorn_01	¿Un dúo?	
VO_GILA_BOSS_29h_Female_Satyr_EventPlaysSmallMinion_01	Eres una monada.	
VO_GILA_BOSS_29h_Female_Satyr_EventPlaysSmallMinion_02	¡Eres casi tan adorable como yo! Bueno...	
VO_GILA_BOSS_29h_Female_Satyr_EventPlaysSmallMinion_03	¡Estás para comerte!	
VO_GILA_BOSS_29h_Female_Satyr_HeroPower_01	Encandilo a todas las criaturitas.	
VO_GILA_BOSS_29h_Female_Satyr_HeroPower_02	¡Un, dos, tres! ¡A mis pies!	
VO_GILA_BOSS_29h_Female_Satyr_HeroPower_03	¡Por aquí! Venga.	
VO_GILA_BOSS_29h_Female_Satyr_HeroPower_04	Mi melodía es cautivadora, ¿eh?	
VO_GILA_BOSS_29h_Female_Satyr_HeroPower_05	Siempre cuido de los que me siguen.	
VO_GILA_BOSS_29h_Female_Satyr_Intro_01	¡Por fin! Público.	
VO_GILA_BOSS_30h_Female_Gnome_DefeatPlayer_01	No muerdas más de lo que puedes tragar.	
VO_GILA_BOSS_30h_Female_Gnome_EmoteResponse_01	Oh, ya es demasiado tarde.	
VO_GILA_BOSS_30h_Female_Gnome_EventBloodMagic_01	Qué fragilidad.	
VO_GILA_BOSS_30h_Female_Gnome_EventBloodMagic_02	Muerde un trozo.	
VO_GILA_BOSS_30h_Female_Gnome_EventBloodMagic_04	¡Chaíto!	
VO_GILA_BOSS_30h_Female_Gnome_EventBloodMagic_05	Todos son iguales ante mi magia.	
VO_GILA_BOSS_30h_Female_Gnome_EventBloodMagic_06	Qué rica, ¿verdad?	
VO_GILA_BOSS_30h_Female_Gnome_Intro_01	¿Quieres darle un bocado?	
VO_GILA_BOSS_31h_Male_Treant_Death_01	<Muerte.>	
VO_GILA_BOSS_31h_Male_Treant_DefeatPlayer_01	Todos son hormigas ante los árboles.	
VO_GILA_BOSS_31h_Male_Treant_Emote Response_01	Si un árbol te cae encima en el bosque... ¿seguirás haciendo ruido?	
VO_GILA_BOSS_31h_Male_Treant_HeroPower_01	Sé libre.	
VO_GILA_BOSS_31h_Male_Treant_HeroPower_02	De tal árbol tal astilla.	
VO_GILA_BOSS_31h_Male_Treant_HeroPower_03	Adelante, pequeño.	
VO_GILA_BOSS_31h_Male_Treant_HeroPower_05	Una parte de mí.	
VO_GILA_BOSS_31h_Male_Treant_Intro_01	No eches raíces aquí.	
VO_GILA_BOSS_32h_Female_Sprite_Death_01	¡No es divertido!	
VO_GILA_BOSS_32h_Female_Sprite_DefeatPlayer_01	¡Venga, juguemos más! Oh, oh... ¡uy!	
VO_GILA_BOSS_32h_Female_Sprite_EmoteResponse_01	Sí, sí. ¡Podemos jugar a eso más tarde!	
VO_GILA_BOSS_32h_Female_Sprite_EventPlaysAoEBuff_01	¡Este juego se te da bien!	
VO_GILA_BOSS_32h_Female_Sprite_EventPlaysAoEBuff_02	Ya has jugado antes a esto.	
VO_GILA_BOSS_32h_Female_Sprite_EventPlaysBigMinion_01	¡Eh! ¡Eso es trampa!	
VO_GILA_BOSS_32h_Female_Sprite_EventPlaysBigMinion_02	¡Guau!	
VO_GILA_BOSS_32h_Female_Sprite_HeroPower_01	¡Crece, crece! ¡Más rápido!	
VO_GILA_BOSS_32h_Female_Sprite_HeroPower_02	¡Más grande! ¡Vamos!	
VO_GILA_BOSS_32h_Female_Sprite_HeroPower_03	¡Arriba, arriba, arriba! ¡Arriba!	
VO_GILA_BOSS_32h_Female_Sprite_HeroPower_04	Je, je, ¡creo que voy ganando!	
VO_GILA_BOSS_32h_Female_Sprite_Intro_01	¿Quieres jugar a un juego?	
VO_GILA_BOSS_33h_Male_Mech_Attack_01	Atacar.	
VO_GILA_BOSS_33h_Male_Mech_Death_01	Segmentación defectuo...	
VO_GILA_BOSS_33h_Male_Mech_DefeatPlayer_01	Error: No quedan objetivos. Retomar patrulla.	
VO_GILA_BOSS_33h_Male_Mech_EmoteResponse_01	Encantado de segarte.	
VO_GILA_BOSS_33h_Male_Mech_EventPlayHarvestGolem_01	Alerta: El objetivo no tiene alma.	
VO_GILA_BOSS_33h_Male_Mech_EventWeaponKill_01	Buena siega.	
VO_GILA_BOSS_33h_Male_Mech_EventWeaponKill_02	Una mejora.	
VO_GILA_BOSS_33h_Male_Mech_EventWeaponKill_03	Destrucción.	
VO_GILA_BOSS_33h_Male_Mech_HeroPower_01	Cosechando.	
VO_GILA_BOSS_33h_Male_Mech_HeroPower_02	Sustento.	
VO_GILA_BOSS_33h_Male_Mech_HeroPower_03	Reponiendo...	
VO_GILA_BOSS_33h_Male_Mech_HeroPower_04	Reciclaje.	
VO_GILA_BOSS_33h_Male_Mech_Intro_01	Comienza la siega.	
VO_GILA_BOSS_34h_Male_Demon_DefeatPlayer_01	Tu alma es... poderosa. ¡Me alimentará durante semanas!	
VO_GILA_BOSS_34h_Male_Demon_EmoteResponse_01	Espero que tu alma no sea tan... charlatana.	
VO_GILA_BOSS_34h_Male_Demon_HeroPower_01	Ambrosía.	
VO_GILA_BOSS_34h_Male_Demon_HeroPower_02	Una delicia.	
VO_GILA_BOSS_34h_Male_Demon_HeroPower_03	Estás perdiendo el color.	
VO_GILA_BOSS_34h_Male_Demon_HeroPower_04	Deja que te quite ese peso de encima.	
VO_GILA_BOSS_34h_Male_Demon_HeroPower_05	Un alma es solo una carga.	
VO_GILA_BOSS_34h_Male_Demon_Intro_01	Pronto serás un recipiente hueco.	
VO_GILA_BOSS_35h_Male_Beast_DefeatPlayer	¡Aaageaa!	
VO_GILA_BOSS_35h_Male_Beast_EmoteResponse	¡Aur aag jarajrag!	
VO_GILA_BOSS_35h_Male_Beast_Intro	¡Rrgaagaogc!	
VO_GILA_BOSS_36h_Female_Human_Death_01	¡Cruac!	
VO_GILA_BOSS_36h_Female_Human_DefeatPlayer_01	¡Está claro que no eres mi príncipe!	
VO_GILA_BOSS_36h_Female_Human_Emote Response_01	Basta de palabrería. ¡A ver esos morritos!	
VO_GILA_BOSS_36h_Female_Human_EventHex_01	¡Oh! ¡Qué... encanto!	
VO_GILA_BOSS_36h_Female_Human_EventHex_02	Cariño, sé lo que se siente.	
VO_GILA_BOSS_36h_Female_Human_HeroPower_01	¡Besoooo!	
VO_GILA_BOSS_36h_Female_Human_HeroPower_02	<Beso.>	
VO_GILA_BOSS_36h_Female_Human_HeroPower_03	¡Mua!	
VO_GILA_BOSS_36h_Female_Human_Intro_01	Oh, no, otra vez no.	
VO_GILA_BOSS_37h_Male_Murloc_DefeatPlayer_01	...	
VO_GILA_BOSS_37h_Male_Murloc_EmoteResponse_01	¡...!	
VO_GILA_BOSS_37h_Male_Murloc_EventPlayMurlocHolmes_02	¿...? ¡...!	
VO_GILA_BOSS_37h_Male_Murloc_EventPlayPlague_01	¡...!	
VO_GILA_BOSS_37h_Male_Murloc_EventPlayPlague_02	¡...!	
VO_GILA_BOSS_37h_Male_Murloc_EventPlayPlague_07	¡...!	
VO_GILA_BOSS_37h_Male_Murloc_HeroPower_01	...	
VO_GILA_BOSS_37h_Male_Murloc_HeroPower_02	...	
VO_GILA_BOSS_37h_Male_Murloc_HeroPower_03	¡...!	
VO_GILA_BOSS_37h_Male_Murloc_HeroPower_04	...	
VO_GILA_BOSS_37h_Male_Murloc_Intro_01	...	
VO_GILA_BOSS_38h_Male_Goblin_Death_01	¡Nunca... más!	
VO_GILA_BOSS_38h_Male_Goblin_DefeatPlayer_01	Dijo el cuervo: «caaaa».	
VO_GILA_BOSS_38h_Male_Goblin_EmoteResponse_01	¡Con eso no va a venir ningún pájaro!	
VO_GILA_BOSS_38h_Male_Goblin_EventBirdDead_01	Tú... ¡monstruo!	
VO_GILA_BOSS_38h_Male_Goblin_EventBirdDead_02	¿Pero qué te han hecho?	
VO_GILA_BOSS_38h_Male_Goblin_EventBirdDead_03	¿¡Por qué!? ¡Solo son pájaros!	
VO_GILA_BOSS_38h_Male_Goblin_EventPlayBird_01	¡Vuela, sé libre!	
VO_GILA_BOSS_38h_Male_Goblin_EventPlayBird_02	¡La clave es el pájaro!	
VO_GILA_BOSS_38h_Male_Goblin_EventPlayBird_03	¿Quién es un pájaro majo?	
VO_GILA_BOSS_38h_Male_Goblin_EventPlayBird_04	A veces me gustaría ser un pájaro.	
VO_GILA_BOSS_38h_Male_Goblin_EventPlayerPlayBird_01	Buena jugada.	
VO_GILA_BOSS_38h_Male_Goblin_EventPlayerPlayBird_02	Entre pájaros anda el juego.	
VO_GILA_BOSS_38h_Male_Goblin_EventPlayNestingRoc_01	No... pretendía llamar a ese.	
VO_GILA_BOSS_38h_Male_Goblin_EventPlayNestingRoc_02	Bueno... Me vale.	
VO_GILA_BOSS_38h_Male_Goblin_HeroPower_01	¡Caa! ¡Caa!	
VO_GILA_BOSS_38h_Male_Goblin_HeroPower_02	Caa... coff... blarg.	
VO_GILA_BOSS_38h_Male_Goblin_HeroPower_03	Caa. Caa. ¡Caa!	
VO_GILA_BOSS_38h_Male_Goblin_Intro_01	¿Luchar o huir? ¿Por qué no ambos?	
VO_GILA_BOSS_40h_Female_Treant_Death_01	Tronco va.	
VO_GILA_BOSS_40h_Female_Treant_DefeatPlayer_01	Una de muchas. Comienza mi cosecha.	
VO_GILA_BOSS_40h_Female_Treant_EmoteResponse_01	¡Más madera!	
VO_GILA_BOSS_40h_Female_Treant_EventPlaysAxe_01	Muchos han sido talados en la flor de la vida.	
VO_GILA_BOSS_40h_Female_Treant_EventPlaysAxe_02	¿Cuántos de los míos tienen que sufrir?	
VO_GILA_BOSS_40h_Female_Treant_EventPlaysWoodsmansAxe_01	Aberrante.	
VO_GILA_BOSS_40h_Female_Treant_HeroPower_01	El bosque los reclama.	
VO_GILA_BOSS_40h_Female_Treant_HeroPower_02	Estos bosques están vivos.	
VO_GILA_BOSS_40h_Female_Treant_HeroPower_03	Venid. Llegó nuestro momento.	
VO_GILA_BOSS_40h_Female_Treant_HeroPower_04	Sentirás nuestro odio.	
VO_GILA_BOSS_40h_Female_Treant_Intro_01	Los tuyos pagarán.	
VO_GILA_BOSS_41h_Female_HumanGhost_Death_01	Cariño...	
VO_GILA_BOSS_41h_Female_HumanGhost_DefeatPlayer_01	Nada puede separarnos.	
VO_GILA_BOSS_41h_Female_HumanGhost_EmoteResponse_01	Déjanos.	
VO_GILA_BOSS_41h_Female_HumanGhost_EventFatigue_01	¿Mi amor? ¿A dónde has ido?	
VO_GILA_BOSS_41h_Female_HumanGhost_EventFatigue_02	Ya no siento su presencia...	
VO_GILA_BOSS_41h_Female_HumanGhost_EventFatigueDeath_01	Somos... ¿libres por fin? ¡Gracias!	
VO_GILA_BOSS_41h_Female_HumanGhost_EventPlayRin_01	¿Será ella quien nos libere?	
VO_GILA_BOSS_41h_Female_HumanGhost_EventShuffle_01	Nos... entiendes... ¿verdad?	
VO_GILA_BOSS_41h_Female_HumanGhost_EventShuffle_02	Juntos... para siempre.	
VO_GILA_BOSS_41h_Female_HumanGhost_EventShuffle_03	Eres como nosotros.	
VO_GILA_BOSS_41h_Female_HumanGhost_HeroPower_01	Nunca te dejaré ir.	
VO_GILA_BOSS_41h_Female_HumanGhost_HeroPower_02	¡Vuelve a mí!	
VO_GILA_BOSS_41h_Female_HumanGhost_HeroPower_03	No te vayas...	
VO_GILA_BOSS_41h_Female_HumanGhost_HeroPower_04	Te mantendré cerca.	
VO_GILA_BOSS_41h_Female_HumanGhost_Intro_01	Pronto volveré contigo, amor.	
VO_GILA_BOSS_41h_Male_NightElf_Death_01	No...	
VO_GILA_BOSS_41h_Male_NightElf_DefeatPlayer_01	¡El Bosque Embrujado no te necesita!	
VO_GILA_BOSS_41h_Male_NightElf_EmoteResponse_02	Tus palabras no me convencen.	
VO_GILA_BOSS_41h_Male_NightElf_EventHack_01	¡Cuarenta hachazos!	
VO_GILA_BOSS_41h_Male_NightElf_EventHack_02	Castigo.	
VO_GILA_BOSS_41h_Male_NightElf_EventHack_03	¡Fuera... de... este... bosque!	
VO_GILA_BOSS_41h_Male_NightElf_HeroPower_01	¡Que sobreviva el más fuerte!	
VO_GILA_BOSS_41h_Male_NightElf_HeroPower_02	Por la raíz y el tallo.	
VO_GILA_BOSS_41h_Male_NightElf_HeroPower_03	¡Prueba tu fuerza!	
VO_GILA_BOSS_41h_Male_NightElf_HeroPower_04	Resolved esto.	
VO_GILA_BOSS_41h_Male_NightElf_Intro_01	Fuera de este lugar.	
VO_GILA_BOSS_42h_Male_Ogre_DefeatPlayer_01	Tú nunca verlo venir. Yo tampoco.	
VO_GILA_BOSS_42h_Male_Ogre_EmoteResponse_01	¡Tú hablar y yo pisotear!	
VO_GILA_BOSS_42h_Male_Ogre_EventHeroPowerEnemy_01	¡Yo tenerte!	
VO_GILA_BOSS_42h_Male_Ogre_EventHeroPowerEnemy_02	¡Aplastar!	
VO_GILA_BOSS_42h_Male_Ogre_EventHeroPowerEnemy_03	¡Yo nunca fallar!	
VO_GILA_BOSS_42h_Male_Ogre_EventHeroPowerFriendly_01	Oh. Eso no salir bien.	
VO_GILA_BOSS_42h_Male_Ogre_EventHeroPowerFriendly_02	Yo aplastar algo.	
VO_GILA_BOSS_42h_Male_Ogre_Intro_01	¿Quién andar ahí? Yo poder olerte.	
VO_GILA_BOSS_43h_Male_HumanGhost_DefeatPlayer_01	Ahora debo cavar.	
VO_GILA_BOSS_43h_Male_HumanGhost_EmoteResponse_01	Fuera de aquí.	
VO_GILA_BOSS_43h_Male_HumanGhost_EventPlaysDeathrattle_01	Ese aroma del último aliento...	
VO_GILA_BOSS_43h_Male_HumanGhost_EventPlaysDeathrattle_02	Los muertos tienen historias que contar.	
VO_GILA_BOSS_43h_Male_HumanGhost_EventPlaysDeathrattle_03	No somos tan diferentes.	
VO_GILA_BOSS_43h_Male_HumanGhost_EventPlaysDeathrattle_04	Sal a buscar el descanso.	
VO_GILA_BOSS_43h_Male_HumanGhost_EventPlaysDeathrattle_05	Su tumba no era muy honda.	
VO_GILA_BOSS_43h_Male_HumanGhost_EventPlayStrokeOfMidnight_01	Ah, echaba de menos las campanas.	
VO_GILA_BOSS_43h_Male_HumanGhost_Intro_01	No deberías andar fuera tan tarde.	
VO_GILA_BOSS_44h_Male_Troll_Death_01	<Muerte.>	
VO_GILA_BOSS_44h_Male_Troll_DefeatPlayer_02	¡Prevenir eh zurrar!	
VO_GILA_BOSS_44h_Male_Troll_EmoteResponse_01	El doctor siempre tiene razón.	
VO_GILA_BOSS_44h_Male_Troll_EventHeals_01	Aaaaah…	
VO_GILA_BOSS_44h_Male_Troll_EventHeals_02	Me sienta genial...	
VO_GILA_BOSS_44h_Male_Troll_EventHeals_04	Ja, ja, ja. Ay...	
VO_GILA_BOSS_44h_Male_Troll_EventPlayerHeals_03	Lo ehtáh haciendo mal.	
VO_GILA_BOSS_44h_Male_Troll_EventPlayerHeals_04	Deja que me ocupe yo.	
VO_GILA_BOSS_44h_Male_Troll_EventPlaysBandages_01	¡Eso eh material de calidad!	
VO_GILA_BOSS_44h_Male_Troll_HeroPower_01	Puede que noteh un pinchazo.	
VO_GILA_BOSS_44h_Male_Troll_HeroPower_02	¿Te asuhtan lah agujah?	
VO_GILA_BOSS_44h_Male_Troll_HeroPower_03	Rápido y casi sin dolor.	
VO_GILA_BOSS_44h_Male_Troll_HeroPower_04	¿Vudú? Eh, tengo un diploma.	
VO_GILA_BOSS_44h_Male_Troll_HeroPower_05	Sienta bien, ¿no?	
VO_GILA_BOSS_44h_Male_Troll_HeroPower_06	Igual ehcuece un poco.	
VO_GILA_BOSS_44h_Male_Troll_Intro_01	¡Ven! Siéntate y señala dónde te va a doler.	
VO_GILA_BOSS_45h_Female_Human_Death_02	<Muerte.>	
VO_GILA_BOSS_45h_Female_Human_DefeatPlayer_01	Deposité mis esperanzas en ti...	
VO_GILA_BOSS_45h_Female_Human_EmoteResponse_01	Charlemos mientras tomamos algo.	
VO_GILA_BOSS_45h_Female_Human_EventDrawsExtraCards_01	Sí. ¡Bebe!	
VO_GILA_BOSS_45h_Female_Human_EventDrawsExtraCards_02	¿A qué sabe?	
VO_GILA_BOSS_45h_Female_Human_EventDrawsExtraCards_03	Echa un buen trago. Venga.	
VO_GILA_BOSS_45h_Female_Human_EventFirstDamage_01	Entiendo que no quieres unirte a mí.	
VO_GILA_BOSS_45h_Female_Human_EventPlayHallowedWater_01	¿Agua bendita? ¡Puaj! Nunca me ha gustado el sabor.	
VO_GILA_BOSS_45h_Female_Human_EventPlaysAcolyte_01	Oh... Este me gusta.	
VO_GILA_BOSS_45h_Female_Human_EventPlaysHoarder_01	Puedes beber cuando se haya ido.	
VO_GILA_BOSS_45h_Female_Human_EventPlaysNovice_01	Llega nuestra nueva iniciada. ¡A su salud!	
VO_GILA_BOSS_45h_Female_Human_Intro_01	Entrega las armas. Únete a nosotros.	
VO_GILA_BOSS_46h_Male_Worgen_DefeatPlayer_01	Solo los más fuertes sobreviven.	
VO_GILA_BOSS_46h_Male_Worgen_EmoteResponse_01	¿Hueles eso? Es tu miedo.	
VO_GILA_BOSS_46h_Male_Worgen_EventPlayBloodMoon_01	¡AUUUUU!	
VO_GILA_BOSS_46h_Male_Worgen_EventPlaysWorgen_01	Deplorable.	
VO_GILA_BOSS_46h_Male_Worgen_EventPlaysWorgen_03	Alfeñique.	
VO_GILA_BOSS_46h_Male_Worgen_EventPlaysWorgen_06	No eres nada.	
VO_GILA_BOSS_46h_Male_Worgen_EventPlayTrapper_02	¡Sucumbe a tu ira!	
VO_GILA_BOSS_46h_Male_Worgen_Intro_01	¿Aún intentas darme caza?	
VO_GILA_BOSS_47h_Male_Monster_Death_01	¡Es mi fin!	
VO_GILA_BOSS_47h_Male_Monster_DefeatPlayer_01	Cada héroe devorado deja al bosque aventajado...	
VO_GILA_BOSS_47h_Male_Monster_EmoteResponse_01	¡Habla y bala! Es tan vulgar que su hambre con bestias pretende saciar.	
VO_GILA_BOSS_47h_Male_Monster_HeroPower_01	Estrago duplicado.	
VO_GILA_BOSS_47h_Male_Monster_HeroPower_02	No una vez, sino dos, sentirás el pavor.	
VO_GILA_BOSS_47h_Male_Monster_HeroPower_03	Nos vemos, nos despedimos, gritamos, ¿repetimos?	
VO_GILA_BOSS_47h_Male_Monster_IntroALT_01	¿Quién anda por las rocas malditas donde el Espantagón habita?	
VO_GILA_BOSS_48h_Female_Gnome_Death_01	¡Esto te dolerá a ti más que a mí!	
VO_GILA_BOSS_48h_Female_Gnome_DefeatPlayer_01	Bueno, ya me he librado de MÍ. Vaya paradoja...	
VO_GILA_BOSS_48h_Female_Gnome_EmoteResponse_01	Sabía que iba a decir eso.	
VO_GILA_BOSS_48h_Female_Gnome_EventAlt_01	¡No! Volvemos a empezar de nuevo.	
VO_GILA_BOSS_48h_Female_Gnome_EventAlt_02	¿Esto cómo era? ¿Así?	
VO_GILA_BOSS_48h_Female_Gnome_EventAlt_03	¡Para! Rebobinemos.	
VO_GILA_BOSS_48h_Female_Gnome_EventPlayerAltTime_01	Esta es la primera vez que lo uso.	
VO_GILA_BOSS_48h_Female_Gnome_EventPlayerAltTime_02	Vaya, pues sí que hemos fastidiado la línea temporal.	
VO_GILA_BOSS_48h_Female_Gnome_EventPlayerTimeWarp_01	Esto empieza a ser confuso.	
VO_GILA_BOSS_48h_Female_Gnome_EventPlayerTimeWarp_02	Nota para mí misma: Evitar esta pelea.	
VO_GILA_BOSS_48h_Female_Gnome_EventPlayerTimeWarpToki_01	¡Eh, se supone que aún no deberías saber eso!	
VO_GILA_BOSS_48h_Female_Gnome_EventPlayerTimeWarpToki_02	¡Recuerdo esta parte de la última vez!	
VO_GILA_BOSS_48h_Female_Gnome_EventTimeWarp_01	Aprenderás esto en un par de años.	
VO_GILA_BOSS_48h_Female_Gnome_EventTimeWarp_02	Esto me costó averiguarlo.	
VO_GILA_BOSS_48h_Female_Gnome_EventTurn2_01	¡Tengo que pararme! ¡Antes de que sea tarde!	
VO_GILA_BOSS_48h_Female_Gnome_EventTurn4_01	¡No puedes ganar! ¡Me conozco a la perfección!	
VO_GILA_BOSS_48h_Female_Gnome_EventTurn6_01	Nos arrepentiremos de lo que vas a hacer. ¡A menos que te detenga!	
VO_GILA_BOSS_48h_Female_Gnome_HeroPower_01	¡Es hora de acelerar!	
VO_GILA_BOSS_48h_Female_Gnome_HeroPower_02	¡Tic, toc, tic, toc!	
VO_GILA_BOSS_48h_Female_Gnome_HeroPower_03	Acabemos con esto.	
VO_GILA_BOSS_48h_Female_Gnome_Intro_01	¡Ah, volvemos a encontrarnos! ¡Por primera vez!	
VO_GILA_BOSS_48h_Female_Gnome_Intro_02	¿Yo de nuevo? Es la segunda vez que luchamos.	
VO_GILA_BOSS_48h_Female_Gnome_Intro_03	Es la tercera vez que luchamos. ¡Ríndete!	
VO_GILA_BOSS_48h_Female_Gnome_Intro_04	¡Sigues... regresando! ¡Para ya!	
VO_GILA_BOSS_48h_Female_Gnome_Intro_05	¿Cuántas veces tenemos que encontrarnos?	
VO_GILA_BOSS_48h_Female_Gnome_PlayerHeroPower_01	¿Por qué pensé que era una buena idea?	
VO_GILA_BOSS_48h_Female_Gnome_PlayerHeroPower_02	Solía pensar que era muy lista.	
VO_GILA_BOSS_48h_Female_Gnome_PlayerHeroPower_03	¡Otra vez no!	
VO_GILA_BOSS_48h_Female_Gnome_PlayerHeroPower_04	Me estoy poniendo de los nervios.	
VO_GILA_BOSS_49h_Female_Undead_Death_01	Un corazón... podrido...	
VO_GILA_BOSS_49h_Female_Undead_DefeatPlayer_01	Podrías haberte unido a nosotros.	
VO_GILA_BOSS_49h_Female_Undead_EmoteResponse_01	Únete a nuestro culto. ¡Tenemos los mejores brebajes!	
VO_GILA_BOSS_49h_Female_Undead_EventFaithfulDies_01	¡Lo necesitaba!	
VO_GILA_BOSS_49h_Female_Undead_EventFaithfulDies_02	Es difícil conseguir buenos esbirros a través del control mental.	
VO_GILA_BOSS_49h_Female_Undead_EventFaithfulDies_03	Nunca te olvidaré, anónimo subalterno.	
VO_GILA_BOSS_49h_Female_Undead_EventPact_01	Únete a nosotros...	
VO_GILA_BOSS_49h_Female_Undead_EventPact_02	¡Otra alma bajo mi control!	
VO_GILA_BOSS_49h_Female_Undead_EventPact_03	Ven a mí, sí...	
VO_GILA_BOSS_49h_Female_Undead_EventPact_05	Mi culto crece.	
VO_GILA_BOSS_49h_Female_Undead_EventPlayBird_01	Espina de flor de paz y púa de frondasueño, pata de lagarto y ala de mochuelo.	
VO_GILA_BOSS_49h_Female_Undead_EventPlayCauldron_01	Dobla, dobla la zozobra; arde fuego; hierve, olla.	
VO_GILA_BOSS_49h_Female_Undead_EventPlayDragon_01	Escama de drago, colmillo de lobo; con la raíz de tierra se completa el todo.	
VO_GILA_BOSS_49h_Female_Undead_EventPlayFaithful_01	Venid, hijos míos.	
VO_GILA_BOSS_49h_Female_Undead_EventPlayFaithful_02	Avanzad, mis fieles...	
VO_GILA_BOSS_49h_Female_Undead_EventPlayFaithful_03	Dame tu vida.	
VO_GILA_BOSS_49h_Female_Undead_EventPlayFaithful_04	¡Mis fieles seguidores!	
VO_GILA_BOSS_49h_Female_Undead_EventPlayFaithful_05	¡Servidme una vez más!	
VO_GILA_BOSS_49h_Female_Undead_EventPlayHex_01	Dedo de rana y ojo de tritón; lengua de víbora y diente de lución.	
VO_GILA_BOSS_49h_Female_Undead_EventPlaySnake_01	Rodaja de bicha que vive en la ciénaga, aquí, en el puchero, que hierva y se cueza.	
VO_GILA_BOSS_49h_Female_Undead_EventPlayTreant_01	Se enfría el caldo con sangre de mico y firme y seguro será el hechizo.	
VO_GILA_BOSS_49h_Female_Undead_EventTurn02_01	Si conocieras su poder, Shaw, obedecerías como tus perros.	
VO_GILA_BOSS_49h_Female_Undead_Intro_02	¿Nos has encontrado? ¿O has caído en nuestra trampa?	
VO_GILA_BOSS_50h_Male_Spirit_DefeatPlayer_01	Mejor arder que desvanecerse...	
VO_GILA_BOSS_50h_Male_Spirit_EmoteResponse_01	Respira...	
VO_GILA_BOSS_50h_Male_Spirit_EventPlaysEcho_01	Sí...	
VO_GILA_BOSS_50h_Male_Spirit_EventPlaysEcho_02	Otro...	
VO_GILA_BOSS_50h_Male_Spirit_EventPlaysEcho_03	¡Más...!	
VO_GILA_BOSS_50h_Male_Spirit_EventPlaysEcho_04	Mua, ja, ja, ja.	
VO_GILA_BOSS_50h_Male_Spirit_Intro_01	La niebla llama... 	
VO_GILA_BOSS_51h_Male_Undead_Death_01	<Muerte.>	
VO_GILA_BOSS_51h_Male_Undead_DefeatPlayer_01	¡Oh! Parece que ya no vas a necesitar ese oro.	
VO_GILA_BOSS_51h_Male_Undead_EmoteResponse_01	Muérdete la lengua.	
VO_GILA_BOSS_51h_Male_Undead_EventPlayCoinPouch_01	Venga. Dame eso.	
VO_GILA_BOSS_51h_Male_Undead_EventPlayMinion_01	¡Eh! Tienes que pagar un impuesto por eso.	
VO_GILA_BOSS_51h_Male_Undead_EventPlayMinion_03	Eso te saldrá caro.	
VO_GILA_BOSS_51h_Male_Undead_EventPlayMinion_04	Pagarás por eso. Muy pronto.	
VO_GILA_BOSS_51h_Male_Undead_HeroPower_01	Paga al recaudador.	
VO_GILA_BOSS_51h_Male_Undead_HeroPower_02	Paga tus deudas.	
VO_GILA_BOSS_51h_Male_Undead_HeroPower_03	No pido mucho en realidad.	
VO_GILA_BOSS_51h_Male_Undead_HeroPower_04	Vacía. Los. Bolsillos.	
VO_GILA_BOSS_51h_Male_Undead_Intro_01	Tienes pinta de deberme dinero.	
VO_GILA_BOSS_52h_Male_Human_DefeatPlayerALT_02	¡No pienso volver al trullo! ¡Hoy no!	
VO_GILA_BOSS_52h_Male_Human_EmoteResponse_02	Ahí no hay más que cenizas y humo.	
VO_GILA_BOSS_52h_Male_Human_EventPlayRoyalGift_02	¡Oh, cómo brilla! No me importaría echarle el guante.	
VO_GILA_BOSS_52h_Male_Human_EventPlayStealth_02	¡Doble rasero!	
VO_GILA_BOSS_52h_Male_Human_EventPlayStealth_03	O sea que YO soy un ladrón por usar sigilo.	
VO_GILA_BOSS_52h_Male_Human_EventTransform_01	¡Ya la has liado!	
VO_GILA_BOSS_52h_Male_Human_HeroPower_01	¡No se ha visto!	
VO_GILA_BOSS_52h_Male_Human_HeroPower_02	¡No estoy usando sigilo, lo juro!	
VO_GILA_BOSS_52h_Male_Human_HeroPower_03	Esto es camuflaje urbano.	
VO_GILA_BOSS_52h_Male_Human_HeroPower_04	Solo un toque de hollín.	
VO_GILA_BOSS_52h_Male_Human_HeroPower_05	¡Están que echan humo!	
VO_GILA_BOSS_52h_Male_Human_IntroALT_02	¡¿Ladrón?! ¿Yo? Habrase visto...	
VO_GILA_BOSS_52h2_Male_Worgen_EmoteResponse_02	¡Mira lo que me has obligado a hacer!	
VO_GILA_BOSS_52h2_Male_Worgen_HeroPower_01	¡AUUUUU!	
VO_GILA_BOSS_52h2_Male_Worgen_HeroPower_02	¡A por ellos!	
VO_GILA_BOSS_52h2_Male_Worgen_HeroPower_03	¡Siente la bestia que hay dentro!	
VO_GILA_BOSS_54h_Male_Golem_DefeatPlayer_01	Hazte añicos mientras tus huesos crujen...	
VO_GILA_BOSS_54h_Male_Golem_EmoteResponse_01	Las palabras no mueven rocas.	
VO_GILA_BOSS_54h_Male_Golem_HeroPower_01	Todo será nuestro.	
VO_GILA_BOSS_54h_Male_Golem_HeroPower_02	El Bosque Embrujado se extiende.	
VO_GILA_BOSS_54h_Male_Golem_HeroPower_03	Arrasad la tierra. Sembrad las semillas.	
VO_GILA_BOSS_54h_Male_Golem_HeroPower_04	El abrazo de Hagatha nos fortalece.	
VO_GILA_BOSS_54h_Male_Golem_HeroPower_05	Por la voluntad de Hagatha.	
VO_GILA_BOSS_54h_Male_Golem_Intro_01	Yo seré quien lance la primera piedra.	
VO_GILA_BOSS_55h_Female_NightElf_Death_01	¿Quién los salvará?	
VO_GILA_BOSS_55h_Female_NightElf_DefeatPlayer_01	Shh. Guiaré a tu espíritu a un lugar seguro.	
VO_GILA_BOSS_55h_Female_NightElf_EmoteResponse_01	¡Shh! Delante de los fuegos fatuos no.	
VO_GILA_BOSS_55h_Female_NightElf_EventAssimilation_01	Lo tuyo será nuestro.	
VO_GILA_BOSS_55h_Female_NightElf_EventAssimilation_02	Sus cuerpos... ¡A por ellos!	
VO_GILA_BOSS_55h_Female_NightElf_EventAssimilation_03	¡Ahí está nuestra oportunidad!	
VO_GILA_BOSS_55h_Female_NightElf_EventKillsWisp_02	¡No!	
VO_GILA_BOSS_55h_Female_NightElf_EventKillsWisp_03	¡Alto!	
VO_GILA_BOSS_55h_Female_NightElf_EventKillsWisp_04	¡Mis niños!	
VO_GILA_BOSS_55h_Female_NightElf_EventPlayCartographer_01	¡Una cartógrafa! Seguro que sabe por dónde se sale.	
VO_GILA_BOSS_55h_Female_NightElf_EventPlayCompass_01	¡Puede que nos ayude a encontrar la salida!	
VO_GILA_BOSS_55h_Female_NightElf_HeroPower_01	Venid, niños.	
VO_GILA_BOSS_55h_Female_NightElf_HeroPower_02	Oh, ahí estáis.	
VO_GILA_BOSS_55h_Female_NightElf_HeroPower_03	Venid a mí.	
VO_GILA_BOSS_55h_Female_NightElf_Intro_01	La maldición de Hagatha es voraz. ¡Debo salvar a mis niños!	
VO_GILA_BOSS_56h_Male_Elemental_DefeatPlayer_01	¿Por qué tienes una cara tan triste?	
VO_GILA_BOSS_56h_Male_Elemental_EmoteResponse_01	No podría haberlo dicho mejor.	
VO_GILA_BOSS_56h_Male_Elemental_EventTransformFace_02	La máscara perfecta.	
VO_GILA_BOSS_56h_Male_Elemental_HeroPower_01	Nueva máscara, nueva cara.	
VO_GILA_BOSS_56h_Male_Elemental_HeroPower_02	Nueva cara, nueva persona.	
VO_GILA_BOSS_56h_Male_Elemental_HeroPower_03	Nueva persona, nueva vida.	
VO_GILA_BOSS_56h_Male_Elemental_HeroPower_05	Siempre cambiante. Siempre en transformación.	
VO_GILA_BOSS_56h_Male_Elemental_HeroPower_07	Somos uno y somos todos.	
VO_GILA_BOSS_56h_Male_Elemental_HeroPower_09	¿Aún recuerdas quién eras?	
VO_GILA_BOSS_56h_Male_Elemental_HeroPower_10	Una máscara es todo lo que necesitas.	
VO_GILA_BOSS_56h_Male_Elemental_IntroALT_02	Tú y yo no somos tan diferentes.	
VO_GILA_BOSS_57h_Male_Undead_DefeatPlayer_01	Volverás, tarde o temprano.	
VO_GILA_BOSS_57h_Male_Undead_EmoteResponse_01	Le daré recuerdos de tu parte a la Dama Oscura.	
VO_GILA_BOSS_57h_Male_Undead_EventDesecrate_01	Deja que la enfermedad te invada.	
VO_GILA_BOSS_57h_Male_Undead_EventDesecrate_02	Cavemos otra tumba.	
VO_GILA_BOSS_57h_Male_Undead_EventDesecrate_03	Es contagioso.	
VO_GILA_BOSS_57h_Male_Undead_EventDesecrate_04	Te unirás a ellos muy pronto.	
VO_GILA_BOSS_57h_Male_Undead_EventPlayHolyBook_01	Tus escrituras no te salvarán.	
VO_GILA_BOSS_57h_Male_Undead_EventShallowGraves_01	¡Alzaos!	
VO_GILA_BOSS_57h_Male_Undead_EventShallowGraves_02	¡Volved!	
VO_GILA_BOSS_57h_Male_Undead_EventShallowGraves_03	¡Os llama la Dama Oscura!	
VO_GILA_BOSS_57h_Male_Undead_HeroPower_01	Profanación.	
VO_GILA_BOSS_57h_Male_Undead_HeroPower_02	Carne de cañón.	
VO_GILA_BOSS_57h_Male_Undead_HeroPower_03	Respira los vapores.	
VO_GILA_BOSS_57h_Male_Undead_HeroPower_04	La corrupción se extiende.	
VO_GILA_BOSS_57h_Male_Undead_Intro_01	¡Te doy la bienvenida! Ven a ver lo que he desenterrado.	
VO_GILA_BOSS_58h_Male_Giant_Death_01	<Muerte.>	
VO_GILA_BOSS_58h_Male_Giant_DefeatPlayer_01	¡Esta ser bonita ciudad PARA PISOTEAR!	
VO_GILA_BOSS_58h_Male_Giant_DefeatPlayer_02	¡Estar listo para noche SOBRE ciudad!	
VO_GILA_BOSS_58h_Male_Giant_EmoteResponse_01	¡Te voy a pisar!	
VO_GILA_BOSS_58h_Male_Giant_EventBigWeapon_01	¡¿Tú también aplastar?!	
VO_GILA_BOSS_58h_Male_Giant_EventMinionReturn_01	¡Ahí estar!	
VO_GILA_BOSS_58h_Male_Giant_EventMinionReturn_02	¡Haber vuelto!	
VO_GILA_BOSS_58h_Male_Giant_EventMinionReturn_03	Hola otra vez.	
VO_GILA_BOSS_58h_Male_Giant_HeroPower_01	¡Correeeer!	
VO_GILA_BOSS_58h_Male_Giant_HeroPower_02	Ah... ¡BU!	
VO_GILA_BOSS_58h_Male_Giant_HeroPower_03	¡¿Dónde esconderte?!	
VO_GILA_BOSS_58h_Male_Giant_HeroPower_04	Fi, fa, fo, GRUM.	
VO_GILA_BOSS_58h_Male_Giant_HeroPower_05	Tú poder correr pero... ¿PODER ESCONDERTE?	
VO_GILA_BOSS_58h_Male_Giant_Intro_01	¡Síiiiii! ¡Aplastar!	
VO_GILA_BOSS_59h_Male_Undead_DefeatPlayer_01	Eres despreciable.	
VO_GILA_BOSS_59h_Male_Undead_DefeatPlayer_02	Adiós, te echaré de menos.	
VO_GILA_BOSS_59h_Male_Undead_DefeatPlayer_03	¿Eres tú a quien han enviado a matarme? Me parto de risa.	
VO_GILA_BOSS_59h_Male_Undead_EmoteResponse_01	¿Te has traído un cañón a un tiroteo? Cobarde...	
VO_GILA_BOSS_59h_Male_Undead_EventDeadlyShot_01	¡En el blanco!	
VO_GILA_BOSS_59h_Male_Undead_EventDeadlyShot_02	¿Qué? Ha sido una muerte piadosa.	
VO_GILA_BOSS_59h_Male_Undead_EventQuickShot_01	Tengo unos cuantos ases en la manga.	
VO_GILA_BOSS_59h_Male_Undead_EventQuickShot_02	¡Desenfunda!	
VO_GILA_BOSS_59h_Male_Undead_EventTurn02_01	Le dije a Cringrís que te dejara pudrirte en prisión.	
VO_GILA_BOSS_59h_Male_Undead_HeroPowerKills_01	Esto me trae tantos recuerdos...	
VO_GILA_BOSS_59h_Male_Undead_HeroPowerKills_02	¡Había olvidado cuánto disfrutaba con esto!	
VO_GILA_BOSS_59h_Male_Undead_HeroPowerKills_03	Ja, ja, ja, ja.	
VO_GILA_BOSS_59h_Male_Undead_HeroPowerKills_04	¡Ja, ja! Ver arder el mundo...	
VO_GILA_BOSS_59h_Male_Undead_HeroPowerKills_05	Ojalá pudiera hacerles esto a todos los huargen.	
VO_GILA_BOSS_59h_Male_Undead_Intro_01	¡Tu viaje termina en agonía!	
VO_GILA_BOSS_59h_Male_Undead_IntroCrowley_01	¿Traidor? Tú no eres quién para hablar, Crowley.	
VO_GILA_BOSS_60h_Male_HumanGhost_Death_02	Me... ahogo...	
VO_GILA_BOSS_60h_Male_HumanGhost_DefeatPlayer_01	Ya eres de la tripulación. ¡Para siempre!	
VO_GILA_BOSS_60h_Male_HumanGhost_EmoteResponseTess_01	Será mejor que empieces a creer en los fantasmas, señorita.	
VO_GILA_BOSS_60h_Male_HumanGhost_EventBigWeapon_01	Afilada y lista.	
VO_GILA_BOSS_60h_Male_HumanGhost_EventBigWeapon_02	Qué belleza.	
VO_GILA_BOSS_60h_Male_HumanGhost_EventBigWeapon_03	¿Alguna vez has visto un arma así?	
VO_GILA_BOSS_60h_Male_HumanGhost_EventPlayerKingsblade_01	Eh... ¿hay más de una?	
VO_GILA_BOSS_60h_Male_HumanGhost_EventPlayKingsblade_01	Recorrí el mundo buscando esta belleza.	
VO_GILA_BOSS_60h_Male_HumanGhost_EventPlayKingsblade_02	Siempre volverá a mí.	
VO_GILA_BOSS_60h_Male_HumanGhost_EventPlayKragg_02	¿Has abandonado el mar por el cielo? Vaya bufón.	
VO_GILA_BOSS_60h_Male_HumanGhost_EventPlayPatches_02	¡Parches! Has perdido unos cuantos ojos, amigo.	
VO_GILA_BOSS_60h_Male_HumanGhost_EventPlayTuskarrRaider_01	Hoy en día dejan a cualquiera hacerse pirata.	
VO_GILA_BOSS_60h_Male_HumanGhost_EventTurn2_01	¿Qué mejor venganza que reclamarte para mi tripulación?	
VO_GILA_BOSS_60h_Male_HumanGhost_HeroPower_01	¡Mi espada me canta y yo le hago los coros!	
VO_GILA_BOSS_60h_Male_HumanGhost_HeroPower_07	¡Que las olas os arrastren!	
VO_GILA_BOSS_60h_Male_HumanGhost_IntroTess_01	¡Arr! La hija del Rey es la que nos ha traído la ruina.	
VO_GILA_BOSS_61h_Female_Orc_DefeatPlayer_01	Soy una con este bosque, y nunca moriré.	
VO_GILA_BOSS_61h_Female_Orc_EmoteResponse_01	Contempla tu reflejo y verás al responsable de tu fin.	
VO_GILA_BOSS_61h_Female_Orc_EmoteResponseCrowley_01	¿Tienes algo que compensar, Crowley? ¿Mmm?	
VO_GILA_BOSS_61h_Female_Orc_EmoteResponseShaw_01	Deja de ladrar... ¡Eres tan cansino como tus perros!	
VO_GILA_BOSS_61h_Female_Orc_EmoteResponseTess_01	¿Tus padres querían a alguno de sus hijos?	
VO_GILA_BOSS_61h_Female_Orc_EmoteResponseToki_01	¿Cómo lograste escapar del Secuestragnomos?	
VO_GILA_BOSS_61h_Female_Orc_EventCannonKill_01	¡Maldito sea ese cañón!	
VO_GILA_BOSS_61h_Female_Orc_EventCannonKill_02	Haces mucho ruido, pero te falta seso.	
VO_GILA_BOSS_61h_Female_Orc_EventCannonKill_03	El hierro se oxida como la carne se corrompe.	
VO_GILA_BOSS_61h_Female_Orc_EventCannonKill_04	Ladras mucho, chucho.	
VO_GILA_BOSS_61h_Female_Orc_EventCrowleyHagathaLow_01	Mientras el bosque viva, yo no moriré...	
VO_GILA_BOSS_61h_Female_Orc_EventCrowleyLow_01	Os enterraré a ti y a tu cañón.	
VO_GILA_BOSS_61h_Female_Orc_EventCrowleyTurn2_01	¡Pero la abandonasteis! ¡Ahora es mía!	
VO_GILA_BOSS_61h_Female_Orc_EventCrowleyTurn4_01	Eres un paria, incluso entre los tuyos.	
VO_GILA_BOSS_61h_Female_Orc_EventShawHoundKill_01	Perro malo.	
VO_GILA_BOSS_61h_Female_Orc_EventShawHoundKill_02	Malditos chuchos.	
VO_GILA_BOSS_61h_Female_Orc_EventShawLow_01	La maldición del bosque te reclama.	
VO_GILA_BOSS_61h_Female_Orc_EventShawTurn2_01	Todas las criaturas sucumben ante mí...	
VO_GILA_BOSS_61h_Female_Orc_EventShawTurn2_02	Al sentir mi presencia.	
VO_GILA_BOSS_61h_Female_Orc_EventShawTurn4_01	Tengo una hueste de mil espíritus oscuros.	
VO_GILA_BOSS_61h_Female_Orc_EventSummonCrowskin_01	Mi culto nunca morirá.	
VO_GILA_BOSS_61h_Female_Orc_EventSummonGodfrey_01	Godfrey, los espíritus de este bosque te reclaman...	
VO_GILA_BOSS_61h_Female_Orc_EventTessHagathaLow_01	Yo soy el bosque.	
VO_GILA_BOSS_61h_Female_Orc_EventTessLow_01	Tus restos nutrirán el bosque.	
VO_GILA_BOSS_61h_Female_Orc_EventTessScavenges_01	Nada te salvará.	
VO_GILA_BOSS_61h_Female_Orc_EventTessScavenges_02	Sigue rebuscando, princesa.	
VO_GILA_BOSS_61h_Female_Orc_EventTessScavenges_03	¿Andas revolviendo en la basura?	
VO_GILA_BOSS_61h_Female_Orc_EventTessScavenges_04	No encontrarás consuelo entre los juncos.	
VO_GILA_BOSS_61h_Female_Orc_EventTessTurn2_01	El bosque invadirá tu ciudad.	
VO_GILA_BOSS_61h_Female_Orc_EventTessTurn4_01	¡Esta tierra estaba MUERTA! Yo la reviví. ¡Es MÍA!	
VO_GILA_BOSS_61h_Female_Orc_EventTokiHagathaLow_01	Los espíritus del bosque me preservarán...	
VO_GILA_BOSS_61h_Female_Orc_EventTokiHeroPower_01	¿Qué acaba de pasar?	
VO_GILA_BOSS_61h_Female_Orc_EventTokiHeroPower_03	Tientas a la suerte.	
VO_GILA_BOSS_61h_Female_Orc_EventTokiHeroPower_04	Los espíritus te están viendo.	
VO_GILA_BOSS_61h_Female_Orc_EventTokiHeroPower_05	Algún día pagarás por tus trucos.	
VO_GILA_BOSS_61h_Female_Orc_EventTokiLow_01	Se te han acabado los trucos.	
VO_GILA_BOSS_61h_Female_Orc_EventTokiTurn2_01	Tú también eres un monstruo, gnoma.	
VO_GILA_BOSS_61h_Female_Orc_EventTokiTurn4_01	¿Crees que no me doy cuenta de tus argucias? Yo lo veo todo.	
VO_GILA_BOSS_61h_Female_Orc_Intro_01	Soy el latido del corazón de este bosque.	
VO_GILA_BOSS_61h_Female_Orc_IntroCrowley_01	Qué tranquilo estará todo cuando silencie ese cañón.	
VO_GILA_BOSS_61h_Female_Orc_IntroShaw_01	Volveré a tus perros contra su dueño.	
VO_GILA_BOSS_61h_Female_Orc_IntroTess_01	Vete, «princesa». Dile a tu padre que no hay esperanza.	
VO_GILA_BOSS_61h_Female_Orc_IntroToki_01	Manipulas tu destino, pero los árboles y las estrellas recuerdan.	
VO_GILA_BOSS_62h_GustaveTheGutRipper_Emote	Uuuzzzzz.	
VO_GILA_BOSS_62h_GustaveTheGutRipper_Intro	¡Grreooo!	
VO_GILA_BOSS_62h_GustaveTheGutRipper_PlayerDefeat	¡Mragrararu!	
VO_GILA_BOSS_63h_Female_Harpy_Death_01	Mis... huevos...	
VO_GILA_BOSS_63h_Female_Harpy_DefeatPlayer_01	¡Hermanas! Llevad sus restos a mi nido.	
VO_GILA_BOSS_63h_Female_Harpy_EmoteResponse_01	Creo que seguir conversando en este momento rompe la dinámica de nuestra relación.	
VO_GILA_BOSS_63h_Female_Harpy_HeroPower_01	¡Te tengo!	
VO_GILA_BOSS_63h_Female_Harpy_HeroPower_02	Tu magia solo oscurece este bosque.	
VO_GILA_BOSS_63h_Female_Harpy_HeroPower_03	Solo me hago más fuerte, idiota.	
VO_GILA_BOSS_63h_Female_Harpy_Intro_01	No pasarás de aquí. ¡Órdenes de Hagatha!	
VO_GILA_BOSS_64h_Male_Goblin_Death_01	¡E-espera!	
VO_GILA_BOSS_64h_Male_Goblin_DefeatPlayer_01	¡Gracias, gracias! En cuanto al pago...	
VO_GILA_BOSS_64h_Male_Goblin_EmoteResponse_01	Me encanta que participe el público.	
VO_GILA_BOSS_64h_Male_Goblin_EvenPlayCursedCurio_01	¡Qué bonito! ¿Dónde puedo conseguir uno?	
VO_GILA_BOSS_64h_Male_Goblin_EventMCTech_01	Eh, eh. ¡Eso es mío!	
VO_GILA_BOSS_64h_Male_Goblin_EventMindControl_01	Intentas sacarme ventaja, ¿eh?	
VO_GILA_BOSS_64h_Male_Goblin_HeroPowerHandBig_01	Te estás durmiendo.	
VO_GILA_BOSS_64h_Male_Goblin_HeroPowerHandBig_03	¡Te pesan tanto los párpados que no puedes abrirlos!	
VO_GILA_BOSS_64h_Male_Goblin_HeroPowerHandEmpty_01	Zzzz... Zzzz...	
VO_GILA_BOSS_64h_Male_Goblin_HeroPowerHandMedium_01	Mírame a los ojos.	
VO_GILA_BOSS_64h_Male_Goblin_HeroPowerHandMedium_02	Sigue mi reloj... Espera... ¿Qué venía a continuación?	
VO_GILA_BOSS_64h_Male_Goblin_HeroPowerHandMedium_03	De un lado a otro. ¡Observa el balanceo!	
VO_GILA_BOSS_64h_Male_Goblin_HeroPowerHandSmall_01	¿Por dónde iba?	
VO_GILA_BOSS_64h_Male_Goblin_HeroPowerHandSmall_02	Tienes mucho... sueño.	
VO_GILA_BOSS_64h_Male_Goblin_Intro_01	¡Oh! ¿Algún voluntario?	
VO_GILA_BOSS_66h_Female_Undead_DefeatPlayer_01	…	
VO_GILA_BOSS_66h_Female_Undead_EmoteResponse_02	…	
VO_GILA_BOSS_66h_Female_Undead_EventPlayHorn_02	…	
VO_GILA_BOSS_66h_Female_Undead_HeroPower_01	…	
VO_GILA_BOSS_66h_Female_Undead_HeroPower_02	…	
VO_GILA_BOSS_66h_Female_Undead_HeroPower_03	…	
VO_GILA_BOSS_66h_Female_Undead_Intro_01	…	
VO_GILA_BOSS_67h_Male_Undead_DefeatPlayer_01	No somos más que ratas a la carrera.	
VO_GILA_BOSS_67h_Male_Undead_EmoteResponse_01	¡No te quiero oír otro chillido!	
VO_GILA_BOSS_67h_Male_Undead_EventPlayRat_01	Son muy buenas como mascotas, ¿verdad? Y en estofado ya ni te digo.	
VO_GILA_BOSS_67h_Male_Undead_EventPlayRat_02	Son unas criaturillas simples. Como tú.	
VO_GILA_BOSS_67h_Male_Undead_EventPlayRat_03	Cuidado, cuando se te acercan no es para darte besitos.	
VO_GILA_BOSS_67h_Male_Undead_EventPlayRatTrap_01	¿Una caja? ¿Un palo? ¡Te falta sutileza!	
VO_GILA_BOSS_67h_Male_Undead_Intro_01	¡Te pillé! Siempre se me dio bien cazar ratas.	
VO_GILA_BOSS_68h_Male_Undead_DefeatPlayer_01	¡Has durado mucho! Serás un sujeto interesante para mis estudios.	
VO_GILA_BOSS_68h_Male_Undead_EmoteResponse_01	¿Sabes lo difícil que es crear una plaga?	
VO_GILA_BOSS_68h_Male_Undead_EventPlayPoison_01	Un paso por delante de mí.	
VO_GILA_BOSS_68h_Male_Undead_EventPlayPoison_02	¡Oh, veneno!	
VO_GILA_BOSS_68h_Male_Undead_EventPlayPoison_03	Me gusta cómo piensas.	
VO_GILA_BOSS_68h_Male_Undead_EventPlayPoison_04	¿Me lo prestas un segundo?	
VO_GILA_BOSS_68h_Male_Undead_Intro_01	¡Sacad a los muertos! Los necesito.	
VO_HeadlessHorseman_Male_Human_HallowsEve_01	¡Estoy aquí, estúpido cuerpo!	
VO_HeadlessHorseman_Male_Human_HallowsEve_02	¡Escucha, necio! ¡Yo te desprecio! ¡Ahora, enfréntate al incendio!	
VO_HeadlessHorseman_Male_Human_HallowsEve_04	El cielo está oscuro. El fuego arde. El destino está sellado y ya es tarde.	
VO_HeadlessHorseman_Male_Human_HallowsEve_07	Mis llamas han muerto, no queda ya chispa. Ahora seré yo quien os rompa la crisma.	
VO_HeadlessHorseman_Male_Human_HallowsEve_08	Veo que tenéis ganas de mi sangre derramar, pero para vencerme mi cabeza habéis de matar.	
VO_HeadlessHorseman_Male_Human_HallowsEve_10	¡JA, JA, JA, JA, JA, JA, JA, JA!	
VO_HeadlessHorseman_Male_Human_HallowsEve_11	¡AHHH, JA, JA, JA, JA, JA, JA, JA!	
VO_HeadlessHorseman_Male_Human_HallowsEve_12	¡Preparaos, las campanas han repicado! ¡Proteged a cada niño, débil y anciano!	
VO_HeadlessHorseman_Male_Human_HallowsEve_13	¡Saldaremos las cuentas! ¡Suplicad piedad, pagaréis vuestras afrentas!	
VO_HeadlessHorseman_Male_Human_HallowsEve_17	JA, JA, JA, JA, ja, ja, ja...	
VO_HRW_DEBUG_01	1	
VO_HRW_DEBUG_02	2	
VO_HRW_DEBUG_03	3	
VO_HRW_DEBUG_04	4	
VO_HRW_DEBUG_05	5	
VO_HRW_TEST_00	¡Os purificaré a ambos de la maldición de la carne!	
VO_HRW_TEST_01	¡Bien hecho! Habéis derrotado al jefe juntos.\n\n¡Ganan ambos jugadores!	
VO_HRW_TEST_02	¡Derrotad al maestro de palancas Mecazod para ganar!	
VO_HRW_TEST_ABILITY_00	Dañando a un héroe.	
VO_HRW_TEST_ABILITY_01	Destruyendo al esbirro con mayor ataque.	
VO_HRW_TEST_ABILITY_02	Lanzando 3 bombas.	
VO_HRW_TEST_ABILITY_03	Dañando a todos los demás personajes.	
VO_HRW_TEST_ABILITY_04	Obteniendo 2 de ataque.	
VO_HRW_TEST_ABILITY_05	Infligiendo daño a ambos héroes.	
VO_HRW_TEST_ABILITY_06	Silenciando al eremita Cho permanentemente.	
VO_HRW_TEST_ABILITY_98	Diana llena. Limpiando diana.	
VO_ICC_841_Female_Sanlayn_Death_02	Pero si nos caíamos tan bien...	
VO_ICC01_Jaina_Female_Human_DrawsRager_01	¿Esto va en serio?	
VO_ICC01_Jaina_Female_Human_JainaDKIntro_05	Oigo susurros... de los muertos...	
VO_ICC01_Jaina_Female_Human_PostDeath_02	Debemos... resistir...	
VO_ICC01_LichKing_Male_Human_EmoteResponse_01	Tus súplicas caen en saco roto.	
VO_ICC01_LichKing_Male_Human_EndOfTurn2_01	¡Ja, ja, ja! ¡ESA es mi apertura!	
VO_ICC01_LichKing_Male_Human_EndOfTurn2_02	Este ni siquiera es mi mazo agresivo.	
VO_ICC01_LichKing_Male_Human_Idle_01	Venga. ¡Termina tu turno para que pueda acabar contigo!	
VO_ICC01_LichKing_Male_Human_Intro_01	Escoge bien las cartas: serán las últimas que te repartan.	
VO_ICC01_LichKing_Male_Human_JainaDKIntro_01	Álzate, maga. Aún te queda trabajo por hacer.	
VO_ICC01_LichKing_Male_Human_JainaDKIntro_02	Únete a mí. Los vivos temblarán y los muertos te obedecerán.	
VO_ICC01_LichKing_Male_Human_JainaDKIntro_03	Tus enemigos te temerán más que a la propia muerte...	
VO_ICC01_LichKing_Male_Human_JainaDKintro_06	Ahora, campeona, deshazte de este despojo humano.	
VO_ICC01_LichKing_Male_Human_PlaysFrostmourne_01	Tu puesto en la clasificación SUFRIRÁ.	
VO_ICC01_LichKing_Male_Human_Turn1_01	Menuda mano tengo...	
VO_ICC01_LichKing_Male_Human_Turn11_01	Mis hordas de\nno-muertos están a tus órdenes.	
VO_ICC01_LichKing_Male_Human_Turn13_01	Haz que sufran.	
VO_ICC01_LichKing_Male_Human_Turn15_01	La clemencia es para los débiles.	
VO_ICC01_LichKing_Male_Human_Turn2_02	¡Contempla mi poder!	
VO_ICC01_LichKing_Male_Human_Turn4_01	Nadie puede salvarte.	
VO_ICC01_LichKing_Male_Human_Turn4_02	Mi poder es ilimitado.	
VO_ICC01_LichKing_Male_Human_Turn5_01	Nadie puede resistirme.	
VO_ICC01_LichKing_Male_Human_Turn5_02	Tú también me servirás.	
VO_ICC01_Tirion_Male_Human_AFKay_01	¡Atención!	
VO_ICC01_Tirion_Male_Human_EmoteResponse_02	¡Ya ni siquiera te conozco!	
VO_ICC01_Tirion_Male_Human_EndOfTurn4_01	¡Resiste!	
VO_ICC01_Tirion_Male_Human_EndOfTurn4_02	Tengo fe en que la providencia te otorgará gran poder cuando más lo necesites.	
VO_ICC01_Tirion_Male_Human_EndOfTurn4_03	Tengo fe en que la providencia te ayudará en los momentos de necesidad.	
VO_ICC01_Tirion_Male_Human_Flavor01_01	Voy a necesitar mejores aventureros...	
VO_ICC01_Tirion_Male_Human_Flavor02_01	¡Jaina, te has convertido en un monstruo!	
VO_ICC01_Tirion_Male_Human_Flavor03_01	¡El Rey Exánime pagará por esta atrocidad!	
VO_ICC01_Tirion_Male_Human_JainaDKintro_05	¿Qué es esto? ¿En qué te has convertido?	
VO_ICC01_Tirion_Male_Human_PauseDeath_02	¡Detente!	
VO_ICC01_Tirion_Male_Human_PostDeath_01	Tu voluntad es solo tuya. ¡Resiste la llamada del Rey Exánime!	
VO_ICC01_Tirion_Male_Human_TerribleTank_01	¿Por qué no usas la provocación?	
VO_ICC01_Tirion_Male_Human_Turn2_01	¡No temas! Estamos en camino.	
VO_ICC01_Tirion_Male_Human_Turn3_01	¡Casi hemos llegado! ¿Cómo va todo? ¿Bien?	
VO_ICC01_Tirion_Male_Human_Turn6_01	¡Adalid! Ya casi hemos...	
VO_ICC01_Tirion_Male_Human_Turn6_02	¡¿Cómo?!	
VO_ICC01_Tirion_Male_Human_Turn8_01	¡Te enfrentas a los mejores aventureros de Azeroth!	
VO_ICC04_LichKing_Male_Human_BreathNoMinion_01	¿Sindragosa no tiene enemigos a los que congelar? Cuánta frialdad.	
VO_ICC04_LichKing_Male_Human_Lose_01	Tus restos helados servirán de advertencia al resto...	
VO_ICC04_LichKing_Male_Human_Turn5_01	Te preguntarás: «¿Y cómo me libro de esos bloques de hielo?».	
VO_ICC04_LichKing_Male_Human_Turn5_02	Respuesta corta: ¡no puedes!	
VO_ICC04_LichKing_Male_Human_Win_02	¡HAY QUE PURGAR TODO EL MAZO!	
VO_ICC04_Sindragosa_Female_Dragon_Bounce_01	¡Devuélvemelo!	
VO_ICC04_Sindragosa_Female_Dragon_BreathNoRoomLeft_01	No te quedan esbirros tras los que esconderte.	
VO_ICC04_Sindragosa_Female_Dragon_Death_01	¡Roaaaaarr!	
VO_ICC04_Sindragosa_Female_Dragon_EmoteResponse_01	¡Estos juegos me cansan!	
VO_ICC04_Sindragosa_Female_Dragon_Intro_01	¡Qué locura, venir hasta aquí!	
VO_ICC04_Sindragosa_Female_Dragon_LichKing_01	¡Me han traicionado!	
VO_ICC04_Sindragosa_Female_Dragon_Malygos_01	¡Malygos... mi antiguo amor!	
VO_ICC04_Sindragosa_Female_Dragon_PlayerPlaysMinion_02	Elige a tus víctimas con cuidado. El toque helado de la muerte os reclamará a todos.	
VO_ICC04_Sindragosa_Female_Dragon_SecondBreath_01	¡Sentid el poder sin fin de mi maestro y desesperad!	
VO_ICC04_Sindragosa_Female_Dragon_Sindragosa_01	¡Nuestra patética magia nos traiciona!	
VO_ICC04_Sindragosa_Female_Dragon_Sindragosa_02	¡Nuestra patética magia nos traiciona!	
VO_ICC04_Sindragosa_Female_Dragon_TransformDK_01	¡Solo sirvo a un maestro!	
VO_ICC04_Sindragosa_Female_Dragon_UnchainedMagic_02	¡Tu patética magia te traiciona!	
VO_ICC04_Sindragosa_Female_Dragon_UnchainedMagic_04	¡Sufre!	
VO_ICC05_Lanathel_Female_Sanlayn_BiteOoze_01	¿Has tocado eso con la BOCA?	
VO_ICC05_Lanathel_Female_Sanlayn_BitePoisonous_01	No olvides escupir el veneno al acabar.	
VO_ICC05_Lanathel_Female_Sanlayn_BiteReminder_01	¿No te olvidas de algo? ¡La sed corre por tus venas!	
VO_ICC05_Lanathel_Female_Sanlayn_BiteReminderAcolyte_01	No lo dudes. ¡Aliméntate de los durmientes!	
VO_ICC05_Lanathel_Female_Sanlayn_BiteShell_01	No te rompas los dientes.	
VO_ICC05_Lanathel_Female_Sanlayn_BiteSpikes_01	Morder eso HA TENIDO que doler.	
VO_ICC05_Lanathel_Female_Sanlayn_BloodEssence_01	Esto empieza a estar abarrotado.	
VO_ICC05_Lanathel_Female_Sanlayn_BloodEssence_02	No tenías planes para esos, ¿verdad?	
VO_ICC05_Lanathel_Female_Sanlayn_BloodEssence_03	Animemos un poco las cosas.	
VO_ICC05_Lanathel_Female_Sanlayn_BloodPrince_01	¡Traidor! ¡Entrega tus colmillos!	
VO_ICC05_Lanathel_Female_Sanlayn_BossBite_01	¡Conoced mi hambre!	
VO_ICC05_Lanathel_Female_Sanlayn_EmoteResponse_01	¿Estás... coqueteando conmigo?	
VO_ICC05_Lanathel_Female_Sanlayn_Intro_01	Has tomado una decisión incorrecta.	
VO_ICC05_Lanathel_Female_Sanlayn_LichKing_01	¡Tú...!	
VO_ICC05_Lanathel_Female_Sanlayn_PlayerBiteAcolyte_01	¡Qué deliciosa ironía!	
VO_ICC05_Lanathel_Female_Sanlayn_PlayerBloodBite_01	Llegas tarde. ¡Yo ya estoy perdida!	
VO_ICC05_Lanathel_Female_Sanlayn_TransformDK_01	Sabía que me gustabas por algo.	
VO_ICC05_Lanathel_Female_Sanlayn_Turn3_01	¿Por qué no te alimentas de uno de MIS esbirros?	
VO_ICC05_Lanathel_Female_Sanlayn_Turn3_02	Duermen... son una delicia... ¡y están bañados en salsa!	
VO_ICC05_Lanathel_Female_Sanlayn_Wounded_01	¿En serio...? ¿Eso es todo?	
VO_ICC05_LichKing_Male_Human_BossBite_02	Ah, sí, el mordisco de los San'layn.	
VO_ICC05_LichKing_Male_Human_BossBite_03	Cuidado con el hambre voraz. ¡Debes alimentarte en cada turno!	
VO_ICC05_LichKing_Male_Human_LichKing_02	Este jefe muerde.	
VO_ICC05_LichKing_Male_Human_Lose_01	¿Te da cosa morder a tus esbirros? Esto es la Ciudadela de Hielo, ¡no la Ciudadela de las Piruletas!	
VO_ICC05_LichKing_Male_Human_Win_01	Lana'thel... Por fortuna, en tu rango no se pierden estrellas.	
VO_ICC06_LichKing_Male_Human_LichKing_02	No es nada personal, Tuétano.	
VO_ICC06_LichKing_Male_Human_Win_01	Tengo que crear una amalgama de huesos nueva. Igual una dorada.	
VO_ICC06_Marrowgar_Male_BoneWraith_Alexstraza_01	Me ha lamido. ¡Esa dragona me ha lamido!	
VO_ICC06_Marrowgar_Male_BoneWraith_AncientOne_01	¡No me arrepiento DE NADA!	
VO_ICC06_Marrowgar_Male_BoneWraith_AuchenaiSoulpriest_01	Ja, ja, ahora tengo a tu sacerdotisa. Espera. No. ¡Fuera, largo!	
VO_ICC06_Marrowgar_Male_BoneWraith_BigHeal_01	La muerte es eterna e inexorable...	
VO_ICC06_Marrowgar_Male_BoneWraith_Bonespike_01	¡La única salida es la muerte!	
VO_ICC06_Marrowgar_Male_BoneWraith_Bonespike_02	El maestro se ocupará de ti.	
VO_ICC06_Marrowgar_Male_BoneWraith_Bonespike_03	La carne y los tendones se desprenden ante mi mera presencia.	
VO_ICC06_Marrowgar_Male_BoneWraith_Bonespike_04	Es la hora de la siega.	
VO_ICC06_Marrowgar_Male_BoneWraith_Bonespike_05	Qué peligro. ¡Qué deleite!	
VO_ICC06_Marrowgar_Male_BoneWraith_BonespikePlayerHit_01	¡La rabia del maestro fluye dentro de mí!	
VO_ICC06_Marrowgar_Male_BoneWraith_BonespikeStolen_01	¡Eh! ¡No robes huesos!	
VO_ICC06_Marrowgar_Male_BoneWraith_Bonestorm_01	¡Tormenta de huesos!	
VO_ICC06_Marrowgar_Male_BoneWraith_Bonestorm_02	¡Tormenta de huesos!	
VO_ICC06_Marrowgar_Male_BoneWraith_Bonestorm_03	¡Toooormenta de huesoooos!	
VO_ICC06_Marrowgar_Male_BoneWraith_Bonestorm_04	¡Tooooormenta de huesooooooos!	
VO_ICC06_Marrowgar_Male_BoneWraith_Bonestorm_05	¡TOORRMEEENTAA DE HUEESOOOS!	
VO_ICC06_Marrowgar_Male_BoneWraith_BonestormFast_01	Tormenta de huesos.	
VO_ICC06_Marrowgar_Male_BoneWraith_Death_01	Polvo al polvo.	
VO_ICC06_Marrowgar_Male_BoneWraith_DKTransform_01	Sí. Acepta tu destino. ¡Escucha la llamada del maestro!	
VO_ICC06_Marrowgar_Male_BoneWraith_EmoteResponse_01	¡Ignorante, no tengo orejas!	
VO_ICC06_Marrowgar_Male_BoneWraith_Idle_01	Mmm...	
VO_ICC06_Marrowgar_Male_BoneWraith_Intro_01	¡Nadie puede entrar en el sagrario del maestro!	
VO_ICC06_Marrowgar_Male_BoneWraith_LichKing_01	¿Maestro?	
VO_ICC06_Marrowgar_Male_BoneWraith_Skeleton_01	¿Qué pasa, huesitos?	
VO_ICC07_LichKing_Male_Human_LichKing_02	Mis esbirros siempre me tienen a mano.	
VO_ICC07_LichKing_Male_Human_Lose_01	Putricidio, tu mazo da asco. Te había subestimado.	
VO_ICC07_LichKing_Male_Human_Win_02	Putricidio, eso ha sido patético. Deberías estar en un mazo de cazador y no en mi ciudadela.	
VO_ICC07_Putricide_Male_Undead_Aviana_01	¡Tu ciencia es mejor que la mía!	
VO_ICC07_Putricide_Male_Undead_CloakedHuntress_01	Eso parece bastante superfluo.	
VO_ICC07_Putricide_Male_Undead_Death_01	Traigo malas noticias...	
VO_ICC07_Putricide_Male_Undead_EaglehornBow_01	¿Me das uno de esos?	
VO_ICC07_Putricide_Male_Undead_EaterOfSecrets_01	¡No! ¡Mis secretos! ¡La obra de mi vida!	
VO_ICC07_Putricide_Male_Undead_EmoteResponse_01	Eso no es muy amable.	
VO_ICC07_Putricide_Male_Undead_EquipWeapon_01	Oh, no.	
VO_ICC07_Putricide_Male_Undead_EquipWeapon_02	Anda, no recordaba tener esto.	
VO_ICC07_Putricide_Male_Undead_EquipWeapon_03	Sí, esto servirá.	
VO_ICC07_Putricide_Male_Undead_EquipWeapon_04	¿De dónde ha salido esto?	
VO_ICC07_Putricide_Male_Undead_EquipWeapon_05	Qué peligro. ¡Qué deleite!	
VO_ICC07_Putricide_Male_Undead_EtherealArcanist_01	Esos etéreos y sus rostros ocultos no son nada de fiar.	
VO_ICC07_Putricide_Male_Undead_FestergutDeath_01	Oh, Panzachancro, eras mi preferido... junto a Carapútrea.	
VO_ICC07_Putricide_Male_Undead_Intro_02	¡Traigo buenas noticias! He arreglado las tuberías de baba venenosa.	
VO_ICC07_Putricide_Male_Undead_LichKing_01	Vaya, no esperaba verte por aquí.	
VO_ICC07_Putricide_Male_Undead_MysteriousChallenger_01	¡Nadie es más misterioso que yo!	
VO_ICC07_Putricide_Male_Undead_Ooze_01	¡Uh, moco!	
VO_ICC07_Putricide_Male_Undead_PhaseTransition_01	¡Tentáculos! Tienen voluntad propia, ¿verdad?	
VO_ICC07_Putricide_Male_Undead_PhaseTransition_03	Mmm, interesante.	
VO_ICC07_Putricide_Male_Undead_Putricide_02	¿Cómo? ¡Ese que está ahí soy yo!	
VO_ICC07_Putricide_Male_Undead_Putricide_03	Traigo buenas noticias... ¡para mí!	
VO_ICC07_Putricide_Male_Undead_Putricide_04	¡Eso no son buenas noticias precisamente, mi querido doble tentaculado!	
VO_ICC07_Putricide_Male_Undead_Rotface_01	¡Carapútrea! ¿Cómo has podido?	
VO_ICC07_Putricide_Male_Undead_RotfaceDeath_01	¡No, Carapútrea! ¿Pero qué te he hecho yo?	
VO_ICC07_Putricide_Male_Undead_Scientist_01	¿Has estado robándome material?	
VO_ICC07_Putricide_Male_Undead_Slime_01	¡Traigo grandes noticias! La baba vuelve a fluir.	
VO_ICC07_Putricide_Male_Undead_TentaclesForArms_01	Esa arma te da mucho caché.	
VO_ICC07_Putricide_Male_Undead_TransformDK_01	¿Cómo? ¿Te has cortado el pelo?	
VO_ICC07_Rotface_Male_Abomination_Rotface_02	Carapútrea tiene NECESIDADES.	
VO_ICC08_Anduin_Male_Human_Muted_02	¡Mpf!	
VO_ICC08_Anduin_Male_Human_Muted_03	Mpf.	
VO_ICC08_Anduin_Male_Human_Muted_06	¡¡Mpf...!!	
VO_ICC08_Anduin_Male_Human_Muted_07	¡¡Mpf!!	
VO_ICC08_Anduin_Male_Human_Muted_11	¿Mpf?	
VO_ICC08_Anduin_Male_Human_Muted_13	Mpf...	
VO_ICC08_Anduin_Male_Human_WinA_01	Siempre debe haber...	
VO_ICC08_Anduin_Male_Human_WinB_01	... un Rey Exánime.	
VO_ICC08_Garrosh_Male_Orc_WinA_01	Siempre debe haber...	
VO_ICC08_Garrosh_Male_Orc_WinB_01	... un Rey Exánime.	
VO_ICC08_Guldan_Male_Orc_WinA_01	Siempre debe haber...	
VO_ICC08_Guldan_Male_Orc_WinB_01	... un Rey Exánime.	
VO_ICC08_Jaina_Female_Human_WinA_01	Siempre debe haber...	
VO_ICC08_Jaina_Female_Human_WinB_01	... un Rey Exánime.	
VO_ICC08_LichKing_Male_Human_Archmage Antonidas_01	Ya acabé contigo una vez, viejo. Volveré a hacerlo.	
VO_ICC08_LichKing_Male_Human_Arfas_01	¡Perro malo!	
VO_ICC08_LichKing_Male_Human_Bolvar_01	El adiestramiento ha sido agotador.	
VO_ICC08_LichKing_Male_Human_Death_01	Solo veo... oscuridad ante mí...	
VO_ICC08_LichKing_Male_Human_DeathPunisher_01	Eso no ha sido nada justo.	
VO_ICC08_LichKing_Male_Human_EmoteResponse_01	¡Nadie me da órdenes!	
VO_ICC08_LichKing_Male_Human_EndOfTurn4_01	No hay carta que pueda frenar mi inevitable victoria.	
VO_ICC08_LichKing_Male_Human_Frostmourne_01	La Agonía de Escarcha está hambrienta...	
VO_ICC08_LichKing_Male_Human_Frostmourne_02	La Agonía de Escarcha está hambrienta... ¿Querías algo?	
VO_ICC08_LichKing_Male_Human_Frostmourne_07	Contempla el poder de la Agonía de Escarcha.	
VO_ICC08_LichKing_Male_Human_GenericStart_03	Primero, desharé tu mazo; y luego... TU ALMA.	
VO_ICC08_LichKing_Male_Human_Horsemen_01	Si consigo a los cuatro, vas a quedar fatal...	
VO_ICC08_LichKing_Male_Human_Hunter_01	Cazador... Si te quitasen a tus alimañas, ¿qué te quedaría para hacerme frente?	
VO_ICC08_LichKing_Male_Human_Illidan_01	El Trono Helado es mío, demonio. Hazte a un lado.	
VO_ICC08_LichKing_Male_Human_IndestructableWeapon_01	Un intento patético.	
VO_ICC08_LichKing_Male_Human_Intro_01	Tu sufrimiento será legendario. Tu rango, no.	
VO_ICC08_LichKing_Male_Human_Intro_02	Al final, todos me servirán.	
VO_ICC08_LichKing_Male_Human_Intro_03	¿A esa miserable pila de cartas la llamas mazo?	
VO_ICC08_LichKing_Male_Human_Intro_04	Soy el comienzo y el final... SOY EL NUEVO META.	
VO_ICC08_LichKing_Male_Human_Intro_06	¿Crees que seré clemente con los de tu calaña?	
VO_ICC08_LichKing_Male_Human_Intro_07	¿Eso es tu mazo? Parece un grito de socorro.	
VO_ICC08_LichKing_Male_Human_Intro_08	Tus lastimeros gritos serán la banda sonora de mis jugadas legendarias.	
VO_ICC08_LichKing_Male_Human_Intro_09	Me pregunto si de verdad te mueve la... rectitud.	
VO_ICC08_LichKing_Male_Human_Kelthuzad_01	¡Kel'Thuzad! ¡Te has confundido de aventura!	
VO_ICC08_LichKing_Male_Human_Lanathel_01	Tu traición no me sorprende, Lana’thel.	
VO_ICC08_LichKing_Male_Human_LichKing_01	Ey, guapetón.	
VO_ICC08_LichKing_Male_Human_LichKing_02	Qué planta tengo.	
VO_ICC08_LichKing_Male_Human_LichKingMuted_01	Espera, no puedes...	
VO_ICC08_LichKing_Male_Human_LichKingMutedResponse_01	Pff.	
VO_ICC08_LichKing_Male_Human_LichKingMutedResponse_02	¡Mppmf Mmmfm!	
VO_ICC08_LichKing_Male_Human_LichKingMutedResponse_03	¡MphMF!	
VO_ICC08_LichKing_Male_Human_LichKingMutedResponse_04	Mpphmmm…	
VO_ICC08_LichKing_Male_Human_LilLich_01	Pero... qué cosita.	
VO_ICC08_LichKing_Male_Human_Lose_03	Únete a mí en la oscuridad...	
VO_ICC08_LichKing_Male_Human_Mage_01	¡Mago! ¡Solo yo controlo el amargo frío de la muerte!	
VO_ICC08_LichKing_Male_Human_MageSpellReflect_01	¡¿Cómo?! ¿Los testers no han pillado eso?	
VO_ICC08_LichKing_Male_Human_MageSpellReflect_02	¡Qué locura! ¡¿Quién testea estas aventuras?!	
VO_ICC08_LichKing_Male_Human_Mograine_01	¡Mograine! A estas alturas ya he perdido la cuenta de si eres bueno o malo.	
VO_ICC08_LichKing_Male_Human_MutedResponse_01	¡Silencio!	
VO_ICC08_LichKing_Male_Human_MutedResponse_02	¡Shhh!	
VO_ICC08_LichKing_Male_Human_MutedResponse_03	¡Shhhhh!!	
VO_ICC08_LichKing_Male_Human_MutedResponse_04	Calla.	
VO_ICC08_LichKing_Male_Human_MutedResponse_05	Cállate.	
VO_ICC08_LichKing_Male_Human_MutedResponse_06	Caaalla.	
VO_ICC08_LichKing_Male_Human_Paladin_01	La Luz no te protegerá aquí, paladín. Nada te protegerá…	
VO_ICC08_LichKing_Male_Human_Phase03_01	Enfréntate a tu trágico final.	
VO_ICC08_LichKing_Male_Human_PhaseTransition_02	¿Alguien ha nerfeado mi arma?	
VO_ICC08_LichKing_Male_Human_PowerReplace_01	No es tan fácil eclipsar mi poder.	
VO_ICC08_LichKing_Male_Human_Priest_01	Sacerdote, la Luz hará oídos sordos a tus súplicas de clemencia.	
VO_ICC08_LichKing_Male_Human_Putricide_01	Sabía que no me caías bien.	
VO_ICC08_LichKing_Male_Human_Rogue_01	Pícaro, sal de las sombras. ¿Qué sería de ti sin tus secretos?	
VO_ICC08_LichKing_Male_Human_Shaman_01	Chamán, ¡tus esbirros se estremecen ante mi poder!	
VO_ICC08_LichKing_Male_Human_Sindragosa_01	¡Eh! ¡Esa la uso para rematar las partidas! ¡Devuélvemela!	
VO_ICC08_LichKing_Male_Human_Sylvanas_01	Con todo lo que me has hecho pasar, la última cosa que te daré será la paz de la muerte.	
VO_ICC08_LichKing_Male_Human_Tirion_01	Te mantendré vivo para presenciar el final, Vadín.	
VO_ICC08_LichKing_Male_Human_TransformDK_01	Sí... Acepta tu nuevo poder... Ya he vencido...	
VO_ICC08_LichKing_Male_Human_Turn6_01	Ese ha sido tu turno más patético, y mira que los has tenido malos...	
VO_ICC08_LichKing_Male_Human_Turn6_03	Tus jugadas son como el reinado de mi padre: deficientes.	
VO_ICC08_LichKing_Male_Human_Turn6_04	¿No te da vergüenza ir por ahí con esas cartas?	
VO_ICC08_LichKing_Male_Human_Turn6_05	Cada carta que juegas te acerca más a la destrucción.	
VO_ICC08_LichKing_Male_Human_Turn6_06	Tu fin es inevitable y no hay frase que pueda expresar tu humillación.	
VO_ICC08_LichKing_Male_Human_Turn6_07	¿Quién te ayudó a crear ese mazo?	
VO_ICC08_LichKing_Male_Human_Turn6_08	¿Creían que te enfrentarías a Hogger?	
VO_ICC08_LichKing_Male_Human_Warlock_01	Brujo, descarta tu patética mano. Los horrores que ahora controlas pronto estarán a MI merced.	
VO_ICC08_LichKing_Male_Human_Warrior_01	Una vez doblegados, los guerreros sois unos magníficos caballeros de la Muerte.	
VO_ICC08_LichKing_Male_Human_Wounded_01	Adiós esperanza...	
VO_ICC08_LichKing_Male_Human_Wounded_02	Imposible... ¡IMPOSIBLE!	
VO_ICC08_LichKing_Male_Human_YoungArthas_01	¿Qué es esto? ¿Una puesta en escena de mi conflicto interior?	
VO_ICC08_Malfurion_Male_NightElf_WinA_01	Siempre debe haber...	
VO_ICC08_Malfurion_Male_NightElf_WinB_01	... un Rey Exánime.	
VO_ICC08_Rexxar_Male_Orc_WinA_01	Siempre debe haber...	
VO_ICC08_Rexxar_Male_Orc_WinB_01	... un Rey Exánime.	
VO_ICC08_Thrall_Male_Orc_WinA_01	Siempre debe haber...	
VO_ICC08_Thrall_Male_Orc_WinB_01	... un Rey Exánime.	
VO_ICC08_Tirion_Male_Human_Win_01	¡Lo has logrado!	
VO_ICC08_Tirion_Male_Human_Win_02	Pero sin el dominio de su maestro, la Plaga se convertirá en una amenaza incluso mayor para este mundo.	
VO_ICC08_Uther_Male_Human_WinA_01	Siempre debe haber...	
VO_ICC08_Uther_Male_Human_WinB_01	... un Rey Exánime.	
VO_ICC08_Valeera_Female_Human_WinA_01	Siempre debe haber...	
VO_ICC08_Valeera_Female_Human_WinB_01	... un Rey Exánime.	
VO_ICC09_LichKing_Male_Human_LichKing_02	Tranquilo, no puedo atacarte.	
VO_ICC09_LichKing_Male_Human_Lose_01	Has traído el arma incorrecta a una pelea de cuchillos.	
VO_ICC09_LichKing_Male_Human_Win_01	¡Esa era mi legendaria favorita! Ahora tendré que desencantarla para crear algo mejor.	
VO_ICC09_Saurfang_Male_Orc_AttackedByPlayer_01	¡A ver qué sabes hacer!	
VO_ICC09_Saurfang_Male_Orc_AttacksPlayer_01	¡Enfréntate al poder de la Plaga!	
VO_ICC09_Saurfang_Male_Orc_AttacksPlayer_02	¡Yo soy la MUERTE!	
VO_ICC09_Saurfang_Male_Orc_AttacksPlayer_03	El Rey Exánime lo reclama todo.	
VO_ICC09_Saurfang_Male_Orc_AttacksPlayer_04	¡Lucha! ¡Muere! Tu destino está sellado.	
VO_ICC09_Saurfang_Male_Orc_BloodBeast_01	¡Comed, mis esbirros!	
VO_ICC09_Saurfang_Male_Orc_BloodBeast_02	Devóralos a todos...	
VO_ICC09_Saurfang_Male_Orc_BloodBeast_03	¡Mi poder es imparable!	
VO_ICC09_Saurfang_Male_Orc_BloodBeast_04	¡La ira hecha carne!	
VO_ICC09_Saurfang_Male_Orc_BloodBeastStolen_01	Toma. Nunca te quitarás el olor de la ropa.	
VO_ICC09_Saurfang_Male_Orc_CursedBlade_01	¿De quién ha sido la idea?	
VO_ICC09_Saurfang_Male_Orc_Death_01	Me... he... liberado...	
VO_ICC09_Saurfang_Male_Orc_DKTransform_01	¡Al fin, alguien a la altura!	
VO_ICC09_Saurfang_Male_Orc_Doomerang_01	Mmm... Tengo que conseguir uno de esos.	
VO_ICC09_Saurfang_Male_Orc_EmoteResponse_01	Cobarde llorica.	
VO_ICC09_Saurfang_Male_Orc_EquipWeapon_01	¡Por el poder del Rey Exánime!	
VO_ICC09_Saurfang_Male_Orc_EquipWeapon_02	Impresionante.	
VO_ICC09_Saurfang_Male_Orc_Intro_01	¡Venid y enfrentaos al poder de la Plaga!	
VO_ICC09_Saurfang_Male_Orc_LichKing_01	¿Qué haces TÚ aquí?	
VO_ICC09_Saurfang_Male_Orc_WeaponDestroyed_01	¡Raarggh!	
VO_ICC10_Deathwhisper_Female_Lich_DamageByValithria_01	Argh...	
VO_ICC10_Deathwhisper_Female_Lich_Death_01	¡Imposible!	
VO_ICC10_Deathwhisper_Female_Lich_DKTransform_01	¡Ah! Tú también has probado el poder del maestro...	
VO_ICC10_Deathwhisper_Female_Lich_EmoteResponse_01	¿Eso ha sido una amenaza?	
VO_ICC10_Deathwhisper_Female_Lich_Equality_01	Eso no es tan buena idea como piensas.	
VO_ICC10_Deathwhisper_Female_Lich_HeroPower_01	Los vivos son tan débiles...	
VO_ICC10_Deathwhisper_Female_Lich_HeroPower_02	La carne es una maldición...	
VO_ICC10_Deathwhisper_Female_Lich_HeroPower_03	¿Entiendes la insignificancia de tus acciones?	
VO_ICC10_Deathwhisper_Female_Lich_HeroPower_04	La oscuridad te abraza...	
VO_ICC10_Deathwhisper_Female_Lich_HeroPowerInitial_01	La muerte te llama...	
VO_ICC10_Deathwhisper_Female_Lich_Intro_01	¿Qué es este alboroto? Mi labor aquí no ha acabado.	
VO_ICC10_Deathwhisper_Female_Lich_LichKing_01	¡Maestro, por favor, los mato tan rápido como puedo!	
VO_ICC10_Deathwhisper_Female_Lich_PlayerPlaysEnrage_01	¡Tus esbirros ansían ser castigados!	
VO_ICC10_Deathwhisper_Female_Lich_StoneskinGargoyle_01	¿Qué? ¡No sabía que aquí se podían jugar cartas del modo salvaje!	
VO_ICC10_Deathwhisper_Female_Lich_ValithriaBlessedChampion_01	¡Paladín, aparta tus manos de ahí!	
VO_ICC10_Deathwhisper_Female_Lich_ValithriaDivineShield_01	¡Aparta las manos de la dragona!	
VO_ICC10_Deathwhisper_Female_Lich_ValithriaResurrect_01	Este juego ya no me gusta.	
VO_ICC10_Deathwhisper_Female_Lich_ValithriaTaunt_01	Como si no odiase ya bastante a esa dragona.	
VO_ICC10_Deathwhisper_Female_Lich_ValithriaWindfury_01	Repugnante.	
VO_ICC10_LichKing_Male_Human_DamageByValithria_02	¡Esa dragona arruinará nuestra gran obra! ¡Destrúyela, Susurramuerte!	
VO_ICC10_LichKing_Male_Human_Lose_01	Una vez más. ¡Con sanación!	
VO_ICC10_LichKing_Male_Human_Turn2_01	¡Susurramuerte! Te he dicho que acabes con esa dragona.	
VO_ICC10_LichKing_Male_Human_Turn2_02	Para ser la líder de un culto a la muerte te lo tomas con bastante calma.	
VO_ICC10_LichKing_Male_Human_Win_01	Tu mazo me ha fallado, Susurramuerte. Da gracias de que tu derrota haya sido rápida.	
VO_ICC10_LichKing_Male_Human_Wounded_01	Deja de jugar y acaba de una vez, Susurramuerte. 	
VO_ICC10_LichKing_Male_Human_Wounded_02	¿Por qué no tienes Deflagración Arcana en el mazo?	
VO_ICCA08_033_Male_HumanGhost_Flavor_01	Ayúdanos...	
VO_ICCA08_033_Male_HumanGhost_Flavor_02	Sálvanos...	
VO_ICCA08_033_Male_HumanGhost_Flavor_03	... no hay escapatoria...	
VO_ICCA08_033_Male_HumanGhost_Flavor_04	... puede que haya alguna escapatoria...	
VO_ICCA08_033_Male_HumanGhost_Flavor_05	¡Shh!	
VO_ICCA10_001_Female_GreenDragon_Healed_01	¡Me siento... renovada!	
VO_ICCA10_001_Female_GreenDragon_Start_01	Ayúdame... No puedo... rendirme...	
VO_Illhoof_Male_Demon_IlhoofKilrek_01	Ven, Kil'rek, ¡hay que completar la invocación!	
VO_Illhoof_Male_Demon_IllhoofDeath_02	¡No! ¡Casi lo consigo! Sar... ge...	
VO_Illhoof_Male_Demon_IllhoofEmoteResponse_01	¡Tu esencia alimenta el ritual!	
VO_Illhoof_Male_Demon_IllhoofOpen_01	¡Ah, justo a tiempo!	
VO_Illhoof_Male_Demon_IllhoofSummonImps_01	¡A mí, habitantes de la oscuridad! ¡Acudid a mi llamada!	
VO_Illhoof_Male_Demon_IllhoofSummoningPortal_01	¿Un portal sin un ritual? Parece mucho más fácil...	
VO_Illhoof_Male_Demon_IllhoofTurn1_01	¡El ritual empieza ya!	
VO_Illhoof_Male_Demon_IllhoofWounded_01	Venid, mascotas mías. ¡Hay que completar el ritual!	
VO_INNKEEPER_Male_Dwarf_HSNewYearBrawl_02	El Año del Cuervo da un poco más de... miedo que el resto.	
VO_INNKEEPER_Male_Dwarf_HSNewYearBrawl_03	Mira, parece que ha llegado un representante del Año del Cuervo.	
VO_INNKEEPER_Male_Dwarf_HSNewYearBrawl_05	El Año del Cuervo da paso a algunas oscuras transformaciones...	
VO_INNKEEPER_Male_Dwarf_HSNewYearBrawl_08	Las bestias ocultas se vuelven más audaces.	
VO_INNKEEPER_Male_Dwarf_HSNewYearBrawl_09	Las criaturas de las tinieblas salen a jugar.	
VO_INNKEEPER_Male_Dwarf_HSNewYearBrawl_10	Los monstruos de las ciénagas se acercan arrastrándose.	
VO_Jaraxxus_Male_Demon_FinalMalchezaarJaraxxus_01	Pobre principito... ¡Practica en el karaoke como Jaraxxus!	
VO_Jaraxxus_Male_Demon_FinalMalchezaarJaraxxus_02	Estamos aquí... Llegamos al fin... Hay sitio en nuestras filas...	
VO_Julianne_Female_Human_JulianneDeath_01	¡Romulo! Bebo en tu honor...	
VO_Julianne_Female_Human_JulianneEmoteResponse_01	¿Nos hacéis burla?	
VO_Julianne_Female_Human_JulianneFeignDeath_03	Para despertar como de un grato sueño.	
VO_Julianne_Female_Human_JulianneHeroPower_01	Ven a mí, gentil noche, ¡y devuélveme a mi Romulo!	
VO_Julianne_Female_Human_JulianneOpen_01	¿Qué demonio sois?	
VO_KAR03_MOROES_MALE_HUMAN_CHESS_TURN_1	Aquí, las piezas atacan automáticamente al final de tu turno.	
VO_KAR03_MOROES_MALE_HUMAN_CHESS_TURN_3	Si una pieza se encuentra entre dos enemigos, ¡atacará a los dos!	
VO_KAR03_MOROES_MALE_HUMAN_CHESS_TURN_5	Para ganar hay que saber posicionarse. ¡Aprovecha los ataques dobles!	
VO_KARA_04_01_Female_Human_CroneHuffer_01	Bufar, me parece que ya no estamos en Páramos de Poniente...	
VO_KARA_04_01_Female_Human_CroneLionTigerBear_02	¡Oh! ¡Leones, dragones y osos!	
VO_KARA_04_01_Female_Human_CroneTurn1_01	¡Oh, no! ¡No permitas que me haga daño!	
VO_KARA_04_01_Female_Human_CroneTurn3_01	¡Venga, cogeos del brazo! ¡La unión hace la fuerza!	
VO_KARA_06_01_Male_Human_JulianneDeadlyPoison_02	Ah, un frasco de veneno.	
VO_KARA_06_01_Male_Human_JulianneTurn1_01	¿Me provocáis? ¡Mi carga recibiréis, pues!	
VO_KT_ANTI_CHEESE1_65	Esta es la versión heroica de Naxxramas. No toleraré trucos baratos.	
VO_KT_ANTI_CHEESE2_66	¿Orador del Sino? Te lo tienes muy creído.	
VO_KT_ANTI_CHEESE3_67	¿Igualdad? De eso nada.	
VO_KT_ANUB2_43	¡Nooo! Quiero decir... Minucias. Nunca derrotarás a la Gran Viuda.	
VO_KT_BARON2_64	¡El Arrabal Militar me ha fallado! ¡Cómo está el servicio!	
VO_KT_FAERLINA2_45	Faerlina carecía de importancia. La reina de las arañas te despachará FÁCILMENTE.	
VO_KT_GLUTH2_73	Les pregunté a los zombis si querían devorar tus sesos y contestaron que no quieren comida basura. ¡Muajajajaaaaa!	
VO_KT_GLUTH2_ALT_74	Existe un logro por perder contra Gluth. Estoy seguro.	
VO_KT_GLUTH3_75	¡JAJAJA, NO HAY LOGRO POR PERDER CONTRA GLUTH!	
VO_KT_GLUTH4_76	¡No! ¿Y ahora quién se va a comer a todos estos zombis?	
VO_KT_GLUTH5_77	Diezmar es lo que más me gusta. No, espera, prefiero lo de congelar la sangre en tus venas.	
VO_KT_GLUTH6_78	¡Buen perro! ¡Perrito guapo!	
VO_KT_GOTHIK2_62	¿Cómo es que Gothik no vuelve como espectro? ¡Venga ya!	
VO_KT_GROBBULUS2_71	Vuelta al punto de partida...	
VO_KT_HEIGAN2_55	Estoy hirviendo de ira. HIRVIENDO.	
VO_KT_LOATHEB2_57	No dejas de MATAR A MIS ESBIRROS. ¡Para! ¡Para ahora mismo!	
VO_KT_MAEXXNA2_47	Su veneno hará que tu muerte sea "casi" indolora.	
VO_KT_MAEXXNA3_48	¿Gigante de mar? ¡Maexxna, esa carta no está en mi lista de cartas aprobadas!	
VO_KT_MAEXXNA4_49	¡Imposible! ¡Esto no ha terminado, insignificante mortal!	
VO_KT_MAEXXNA6_51	¿Cómo llamas a un esbirro atrapado en una telaraña? ¡BOCADILLO!	
VO_KT_NOTH2_53	Pobre Noth. ¡Hoy Noth da una!	
VO_KT_PATCHWERK2_69	¡Mi avatar de guerra! Debí fabricarlo con mejores jugadores...	
VO_KT_RAZUVIOUS2_59	¡¿Y ahora quién entrenará a mis caballeros de la Muerte?! Yo no puedo, estoy superocupado.	
VO_KT_SAPPHIRON2_84	Mira a ese pequeño gnomo. Era un insolente, COMO TÚ.	
VO_KT_SAPPHIRON3_85	¡Deja de esconderte tras ese bloque de hielo!	
VO_KT_SAPPHIRON4_ALT_87	Sapphiron, pon en marcha el plan "CONGELAR LA SANGRE EN TUS VENAS".	
VO_KT_SAPPHIRON5_88	¡Mi dragón! NO ME GUSTAS.	
VO_KT_THADDIUS2_81	¡Insolente! ¡Esta es la gota que colma el vaso!	
VO_LichKing_Male_Human_Brawl_01	¡Hay que purgar la taberna entera!	
VO_LichKing_Male_Human_Brawl_03	Que vengan tantos incautos como quieran. Yo prevaleceré.	
VO_LichKing_Male_Human_Brawl_05	¡Contemplad mis puntos de salud! A llorar al rincón, mortales.	
VO_LichKing_Male_Human_ExpansionIntro_02	¡Corona de Hielo! Venid en busca de mi funesto poder. Acabaréis muertos.	
VO_LichKing_Male_Human_FinaleFirstVictory_01	Imposible... Imposible... ¿Y si jugamos al mejor de nueve?	
VO_LichKing_Male_Human_FinaleLock_01	¡NUNCA me derrotaréis! Al menos, no mientras esta ala esté bloqueada.	
VO_LichKing_Male_Human_FinaleUnlock_03	¿Debería deponer la Agonía de Escarcha y confiar en tu piedad? Un adelanto: va a ser que NO.	
VO_LichKing_Male_Human_LowerCitadelUnlock_01	¡Ciudadela de Corona de Hielo! Una colección de mis esbirros más abominables... creados con ODIO en vez de polvo.	
VO_LichKing_Male_Human_PrologueBossCoin_01	¡Adelante! ¡Te aniquilaré y te desencantaré a cambio de polvo Arcano!	
VO_LichKing_Male_Human_PrologueBossCoin_02	Construí esta amalgama de huesos con los macabros restos de mis cartas duplicadas.	
VO_LichKing_Male_Human_PrologueBossCoin_03	El Libramorte Colmillosauro fue mi primer esbirro legendario. Fue la base para crear esta aventura.	
VO_LichKing_Male_Human_PrologueBossCoin_04	Aquí está lady Susurramuerte. ¡Antes del nerfeo!	
VO_LichKing_Male_Human_PrologueBossCoin_05	El profesor Putricidio es mi motor de robo de cartas. Pero solo roba «gas». Argh, odio a ese tío.	
VO_LichKing_Male_Human_PrologueBossCoin_07	¡Lana’thel! ¡Tengo MARCAS DE DIENTES en las CARTAS! ¡Te dije que las metieses en fundas!	
VO_LichKing_Male_Human_PrologueBossCoin_08	¡Sindragosa es mi rematadora! ¡No te acerques, es mía!	
VO_LichKing_Male_Human_PrologueBossCoin_09	Le darás al botón «Rendirse»... Suplicarás clemencia... y te la negaré.	
VO_LichKing_Male_Human_PrologueBossCoin_11	Observa tu mano. Mira en qué te has convertido. ¿Somos tan diferentes, tú y yo?	
VO_LichKing_Male_Human_PrologueBossCoin_12	Aquí me hallo, como el lobo ante los corderos... y no me temen.	
VO_LichKing_Male_Human_ResponseAnubaArak_01	¡Sírveme, Anub'arak!	
VO_LichKing_Male_Human_ResponseMalganis_01	¿Cuántas veces tengo que derrotarte, Mal'Ganis?	
VO_LichKing_Male_Human_UpperReachesLock_01	¿Quieres usar mi poder contra mí? Espera, voy a copiar un mazo ganador que hunda este mundo en las tinieblas.	
VO_LichKing_Male_Human_UpperReachesUnlock_01	¿Quieres usar mi poder contra mí? ¿Sabes cuántas veces he alcanzado el rango de Leyenda?	
VO_LOE_01_DEATH_2	¡Orsis! ¡Véngame!	
VO_LOE_01_RESPONSE	¡Teme la cólera del Sol!	
VO_LOE_01_STAFF	¡Ja, ja! ¡Mía!	
VO_LOE_01_STAFF_2	¡Arderás!	
VO_LOE_01_STAFF_2_RENO	Intenta no perder la vara. Es valiosa, ¿sabes?	
VO_LOE_01_START	¡Soy INVENCIBLE!	
VO_LOE_01_WIN	¡Ja, ja! ¡La vara es mía! ¡Ojalá Harrison pudiera verme ahora!	
VO_LOE_01_WIN_2	¡Cógela!	
VO_LOE_01_WIN_2_ALT_2	Eh… ¿Es normal que el suelo tiemble tanto?	
VO_LOE_01_WOUNDED	¡Está contra las cuerdas! ¡Acaba con él!	
VO_LOE_02_DEATH	Otra vez a la lámpara: ¡nooooo!	
VO_LOE_02_INTRO	¡La Vara del Sol es MÍA!	
VO_LOE_02_MORE_WISHES	Vaya, no me creo que haya funcionado.	
VO_LOE_02_PHAERIX_STAFF_RECOVER	¡No comprendes los poderes de la vara!	
VO_LOE_02_RESPONSE	¡Fenomenales poderes cósmicos!	
VO_LOE_02_START	¡Libre, al fin! ¡Tu recompensa será una muerte rápida!	
VO_LOE_02_START2	¡Hola! Soy Reno Jackson: arqueólogo, expedicionario y cazatesoros famoso en el mundo entero.	
VO_LOE_02_START3	Y con el autocontrol de una urraca.	
VO_LOE_02_TURN_10	Imagina... ¡La Vara del Sol! ¡Vale una fortuna!	
VO_LOE_02_TURN_6	¿Alguna vez os he contado cuando me infiltré entre los ogros de La Masacre disfrazado?	
VO_LOE_02_TURN_6_2	¿Y cuando me colé en el Lyceum Roca Negra para hacerme con…?	
VO_LOE_02_WIN	¡Adelante! ¡La vara está en esa sala!	
VO_LOE_02_WISH	Está bien que conceda deseos mientras intenta matarnos.	
VO_LOE_03_RESPONSE	¡Date prisa!	
VO_LOE_03_TURN_1	¡El techo se derrumba y hay monstruos por doquier! ¡Aprisa!	
VO_LOE_03_TURN_10	¡Casi estamos! ¡Veo el sol!	
VO_LOE_03_TURN_2	Vaya, una poza brillante. ¿Quieres echar un vistazo?	
VO_LOE_03_TURN_2_2	¡No hay tiempo para eso!	
VO_LOE_03_TURN_3	Mmm… Vale… ¿Derecha o izquierda?	
VO_LOE_03_TURN_3_BOULDER	¡Esa roca es enorme! ¡Apártate!	
VO_LOE_03_TURN_3_WARNING	Los temblores empeoran. ¡Apuesto a que el techo se desploma en el siguiente turno!	
VO_LOE_03_TURN_4	¡Eh, una fosa de pinchos!	
VO_LOE_03_TURN_4_BAD	¡Ay, ay, ay! Eso ha tenido que doler.	
VO_LOE_03_TURN_4_GOOD	¡Bien! Casi tan hábil como yo.	
VO_LOE_03_TURN_4_NEITHER	Vale. ¿Estás pasando entre los pinchos? ¡Date prisa!	
VO_LOE_03_TURN_5	Eh, bonita estatua. Y qué rubí tan brillante…	
VO_LOE_03_TURN_5_4	Oh, oh, no parece muy contento. Creo que quiere recuperar su gema.	
VO_LOE_03_TURN_6	¡Cuidado! ¡El techo se viene abajo!	
VO_LOE_03_TURN_6_2	¡Ha faltado poco! ¡Me alegro de haber podido salvarte! De nada.	
VO_LOE_03_TURN_7	Mmm. Por aquí está bastante oscuro, pero seguro que saldremos más rápido. ¡Vamos!	
VO_LOE_03_TURN_7_2	En mi mapa pone "NO ENTRAR".	
VO_LOE_03_TURN_8	¡Uh! Se está caldeando la cosa. ¡Démonos prisa!	
VO_LOE_03_TURN_9	Puaj. ¿Por qué siempre son bichos?	
VO_LOE_03_WIN	¡Lo logramos! Nunca pensé que me alegraría de ver este desierto... desierto. Creo que necesito agua.	
VO_LOE_04_RESPONSE	¡Trogg aplastar a tonto!	
VO_LOE_04_SCARVASH_TURN_2	¡Trogg no tonto! ¡Trogg dejarte tonto!	
VO_LOE_04_START	¡Uldaman ser solo para troggs!	
VO_LOE_04_WIN	¡Aún quedan más! ¡Por aquí, héroe, salta a la vagoneta!	
VO_LOE_07_RESPONSE	¿De verdad tienes tiempo para eso?	
VO_LOE_07_START	¡Cuidado, nos persiguen!	
VO_LOE_07_WIN	¡Ja, ja! ¡En vagoneta y tirando bombas! ¡Esto es la caña!	
VO_LOE_08_ANIMATE_STONE	¡Tierra y piedra, despertad!	
VO_LOE_08_LANDSLIDE	¡Te enterraré!	
VO_LOE_08_RESPONSE	Te haré polvo.	
VO_LOE_08_START	¡Quién desafía la cólera de los creadores!	
VO_LOE_08_WIN	¡La cabeza es nuestra! ¡Solo falta una pieza!	
VO_LOE_092_Attack_02	¡Abrid bien los ojos!	
VO_LOE_10_NYAH	¡Mrrrglmrrrgl ña!	
VO_LOE_10_RESPONSE	Mrglmrrglrmrrgl.	
VO_LOE_10_RESPONSE_ALT_read	Menudo cansino estás hecho, Aletete.	
VO_LOE_10_START	Mrglmrglmrgl 	
VO_LOE_10_START_2	¿En serio? Qué falta de respeto.	
VO_LOE_10_TURN_2_GIANTFIN	¡MRRRGL! ¡MRRRGLMRGL!	
VO_LOE_10_TURN1	¡Mrrrgl! Mrrglrrglmrgl.	
VO_LOE_10_WIN	Una pena. Con una educación adecuada, podría haber sido alguien de bien.	
VO_LOE_12_NAZJAR_PEARL	Extraordinario. La Perla de las Mareas supera todas mis expectativas.	
VO_LOE_12_NAZJAR_TURN_1	Soy la hoja de Azshara. ¿Quién eres tú para desafiarme?	
VO_LOE_12_NAZJAR_TURN_1_FINLEY	Soy Sir Finley Mrrgglton. El placer es mío.	
VO_LOE_12_NAZJAR_TURN_3_FINLEY	Elise, ¿cómo les va a los demás?	
VO_LOE_12_NAZJAR_TURN_5	¡Ejércitos de las profundidades, barred a los enemigos con una marea de muerte!	
VO_LOE_12_NAZJAR_TURN_5_FINLEY	Eso suena un poco excesivo.	
VO_LOE_12_NAZJAR_TURN_7_FINLEY	¡Mrgggl! ¡MRRGLMRRGL!	
VO_LOE_12_NAZJAR_TURN_7_FINLEY_2	Lo siento, a veces me olvido hasta de quién soy.	
VO_LOE_12_RESPONSE	¡Tengo el poder de la perla!	
VO_LOE_12_START	¡El poder de las mareas te consumirá!	
VO_LOE_12_WIN	¡Bravo! ¡La perla es nuestra! ¡Acompáñame a la Sala de los Expedicionarios y ensamblaremos el artefacto juntos!	
VO_LOE_13_RESPONSE	RAAAAARR	
VO_LOE_13_START_2	¡Roar!	
VO_LOE_13_TURN_1	¡El bastón estaba maldito! Invocó al etéreo. ¡Lo está robando todo!	
VO_LOE_13_TURN_1_2	No todo. Solo lo bueno.	
VO_LOE_13_TURN_5	Oooh, ¿eso es el sello de Arthas? Y en perfecto estado.	
VO_LOE_13_TURN_5_2	¡Reno, Brann, esconded los artefactos!	
VO_LOE_13_TURN_9	¡Está dando vida a un ejército! ¡Elise, detenlo!	
VO_LOE_13_TURN_9_2	¡Tel'zaxus Nalore! ¡El bastón es demasiado fuerte, pero puedo ralentizarlo!	
VO_LOE_13_WIN	Ayudaremos con las piezas de la exposición. ¡Vamos, ve a por Rafaam!	
VO_LOE_14_RESPONSE	CLACK	
VO_LOE_14_START	¡Oh! ¡Esa es la armadura de Lothar! ¡Me pasé meses buscando entre caca de dragón en Roca Negra!	
VO_LOE_14_TURN_13	¡Brann, está dando vida a los libros! Yo me ocupo de los martillos voladores de la exposición de Lordaeron.	
VO_LOE_14_TURN_5	He despachado a las espadas animadas de la sala este. Elise, ¿a quién puedo ayudar?	
VO_LOE_14_TURN_5_2	¡Reno está en el almacén principal! ¡Varios robots bum lo tienen rodeado!	
VO_LOE_14_TURN_9	Parecéis muy ocupados. Me entretendré cogiendo este broche.	
VO_LOE_14_WIN	El museo está controlado. ¡Ve a por Rafaam!	
VO_LOE_15_RESPONSE	¡Qué cartas tan buenas!	
VO_LOE_15_SPARE	¡Mira! Tenemos un mazo de sobra: ¡úsalo!	
VO_LOE_16_BOOM_BOT	Tenemos un montón de estos de sobra. ¡Acaba con él!	
VO_LOE_16_CROWN	Las artes de un mago loco en estado puro.	
VO_LOE_16_EYE	Qué gracia, aún tenía esto en el bolsillo. Te lo presto.	
VO_LOE_16_FIRST_ITEM	Vamos a buscar artefactos útiles por el museo. ¡Avisa si necesitas alguno!	
VO_LOE_16_GOBLET	Odio las serpientes.	
VO_LOE_16_GREAVE	Una pieza de la armadura de Lothar permaneció intacta tras tu pelea.	
VO_LOE_16_LOCKET	Los fantamas de Karazhan poseen este guardapelo.	
VO_LOE_16_PIPE	¡Cógela! Pero no se lo digas a Brann; ¡le encanta esta pipa!	
VO_LOE_16_RAFAAM_DEATH2	¡NO! ¡No podéis derrotarme!	
VO_LOE_16_SHARD	Esto estaba en una caja que decía: "NO ABRIR". Así que… ¡Buena suerte!	
VO_LOE_16_SPLINTER	Encontré esto en Núcleo de Magma. El mayordomo lo usaba de mondadientes.	
VO_LOE_16_START_2	El bastón se está cargando. ¡Cuidado!	
VO_LOE_16_TEAR	Un artefacto sagrado de mi pueblo. ¡Rápido, bebe!	
VO_LOE_16_TURN_2	El bastón casi está al máximo. ¡Prepárate!	
VO_LOE_16_TURN_2_2	¡JA, JA, JA! ¡PODER ABRUMADOR!	
VO_LOE_16_TURN_2_3	¡El bastón se ha sobrecargado! ¡Es tu ocasión!	
VO_LOE_16_TURN_3	¡Soy invencible! ¡Nunca me derrotaréis!	
VO_LOE_16_TURN_3_2	El bastón vuelve a cargarse. Pronto tendremos otra oportunidad.	
VO_LOE_16_TURN_4	El bastón casi está listo. ¡Prepárate!	
VO_LOE_16_TURN_5	¡JA, JA, JA! ¡PODER ABRUMADOR!	
VO_LOE_16_TURN_5_2	¡Sus escudos han caído! ¡A por él!	
VO_LOE_16_TURN_6	Ha recuperado los escudos. ¡Cuidado!	
VO_LOE_16_VIAL	Dice "Bébeme", pero lo encontramos en Naxxramas, así que nadie ha querido probarlo.	
VO_LOE_ARCHAEDAS_TURN_1_CARTOGRAPHER	Si no estuviese demasiado ocupado sepultándote.	
VO_LOE_GIANTFIN_TIDEHUNTER_2	¡No, Finley! Ya entonces eras diferente.	
VO_LOE_NAZJAR_TURN_3_CARTOGRAPHER	Reno ha vuelto con la Vara del Sol y Brann está en camino.	
VO_LOE_SCARVASH_TURN_6_CARTOGRAPHER	¡Céntrate, Brann!	
VO_LOE_ZINAAR_TURN_10_CARTOGRAPHER_2	No vamos a venderla.	
VO_LOE_ZINAAR_TURN_6_CARTOGRAPHER_2	Sí.	
VO_LOE_ZINAAR_TURN_6_CARTOGRAPHER_2_ALT	Sí.	
VO_LOE10_DEAD_MURLOCS	Cuántos muertos. Qué desgracia.	
VO_LOE10_NYAH_FINLEY	Oh, no seas pueril.	
VO_LOE10_TIDEHUNTER	Yo me crié como un cazamareas hasta que Elise me encontró. ¿Podría haber sido este mi sino?	
VO_LOE10_TURN_2_FINLEY	¡Hermanos! ¿De verdad tenemos que luchar?	
VO_LOE10_TURN_2_FINLEY_2	Supongo que eso era de esperar.	
VO_LOEA04_BRANN_TURN_1	La última vez que lo vi, Scarvash era un trogg pequeñito. Ahora es más grande, tonto y feo.	
VO_LOEA04_BRANN_TURN_6	Fascinante. Estas runas de mitril contienen código de guardián. ¡Deben datar de la era de los titanes!	
VO_LOEA07_MINE_ALMOST_DONE	¡Casi estoy! Me pregunto qué hará este botón…	
VO_LOEA07_MINE_ARCHAEDAS	POR LAS BARBAS DE MAGNI… ¿ES ESE ARCHAEDAS?	
VO_LOEA07_MINE_BARREL_FORWARD	¡A toda máquina!	
VO_LOEA07_MINE_BOOM	¡Bombas que rebotan! ¡Así aprenderán!	
VO_LOEA07_MINE_BOOMZOOKA	¡BUM! ¡Voy a cargar otra ronda!	
VO_LOEA07_MINE_DETONATE	¿Vas a detonar la bocamina? ¿SE TE VA LA PINZA?	
VO_LOEA07_MINE_DYNAMITE	¡Eh! ¡Ten más cuidado! ¡Has arrancado un cacho de vía!	
VO_LOEA07_MINE_HUNKER_DOWN	¡Abajo!	
VO_LOEA07_MINE_PARROT	¡Vuela, Ginny!	
VO_LOEA07_MINE_RAMMING	¡Ja, ja! ¡Fuera de nuestro camino!	
VO_LOEA07_MINE_REPAIRS	¡Con un poco de resina de mollejas quedará como nuevo!	
VO_LOEA07_MINE_SPIKED_DECOY	¡Malditos troggs! ¡Venid a por mí!	
VO_LOEA08_TURN_1_BRANN	Un sirviente de los antiguos titanes. La de historias que podría contarnos.	
VO_LOEA09_1_RESPONSE	¡Más para cenar!	
VO_LOEA09_1_TURN1	¿Osas invadir la Ciudad en Ruinas?	
VO_LOEA09_FINLEY_DEATH	Me recuperaré en un instante. ¡Ajusticia al naga!	
VO_LOEA09_HERO_POWER	¡Hora de cenar! ¡Hoy hay sopa de múrloc!	
VO_LOEA09_HERO_POWER1	Saludos. Parece que tengo un contratiempo. ¿Serías tan amable de ayudarme?	
VO_LOEA09_HERO_POWER2	Debo decir que esto está terriblemente oscuro.	
VO_LOEA09_HERO_POWER3	Cáspita. ¿Está subiendo la temperatura?	
VO_LOEA09_HERO_POWER4	Debo señalar que esto es muy desagradable.	
VO_LOEA09_HERO_POWER5	Uh, me va a dar un sofoco.	
VO_LOEA09_HERO_POWER6	Agradecería mucho un poco de ayuda.	
VO_LOEA09_QUOTE1	¡Gracias! ¡Ha estado demasiado cerca!	
VO_LOEA09_UNSTABLE	¡Vuelve al caldero!	
VO_LOEA09_WIN	Tienes toda mi gratitud. ¿Vamos a por la última pieza?	
VO_LOEA10_1_MIDDLEFIN	¡¿Pero qué...?! ¿Qué haces tú aquí?	
VO_LOEA15_1_LOSS_11	Qué basura de mazo. Hora de usar el mío.	
VO_LOEA15_1_LOW_HEALTH_10	Igual me equivoqué robándote el mazo.	
VO_LOEA15_1_MAGMA_RAGER_09	¿Furibundo de magma? ¿Quién jugaría esa carta?	
VO_LOEA15_1_START_07	Me gusta tu mazo. Creo que ME LO QUEDO.	
VO_LOEA15_1_TURN1_08	Oooh, sí. Esta mano es INCREÍBLE.	
VO_LOEA15_1_WIN_12	Tu mazo es IMPRESIONANTE. ¡Ja, ja, ja!	
VO_LOEA15_GOLDEN	¿Este mazo es TODO DE CARTAS DORADAS? ¡Tu colección está al nivel de la mía!	
VO_LOEA16_1_CARD_04	¡He reunido artefactos de CIENTOS de mundos!	
VO_LOEA16_1_RESPONSE_03	¡Sí! ¡SÍ!	
VO_LOEA16_1_START_01	¡Contemplad el PODER ABSOLUTO del bastón!	
VO_LOEA16_1_TURN1_02	¡Soy invencible! ¡Blando el poder de los titanes!	
VO_LOOT_329_Male_Elemental_Attack_01	Marchítate.	
VO_LOOT_329_Male_Elemental_Death_01	<Death>	
VO_LOOT_329_Male_Elemental_Play_01	La vida se pudre. La putrefacción vive.	
VO_LOOT_541_Male_Kobold_BOSS_AFKay_01	¡A por ella! ¡Deber aplastar humana mientras no prestar atención!	
VO_LOOT_541_Male_Kobold_BOSS_Blackseed_01	Grananegra viajar a mucha, muuucha profundidad y regresar con partes onduladas.	
VO_LOOT_541_Male_Kobold_BOSS_Brimstone_01	¡Ssh! Estatuas tener ojos, como esos que abrir y cerrar. ¡No despertar!	
VO_LOOT_541_Male_Kobold_BOSS_Candlebeard_01	Barbacandela pensar que encontrar tesoro enterrado convertir kóbold en pirata.	
VO_LOOT_541_Male_Kobold_BOSS_Chronomancer_01	¡Bruja del tiempo! ¡Vernos de nuevo, por primera vez!	
VO_LOOT_541_Male_Kobold_BOSS_Everrot_01	¡Tú no tocar esporas! Mandar esbirros.	
VO_LOOT_541_Male_Kobold_BOSS_Flurgl_01	Kóbolds no entender múrlocs. ¡Ellos hablar con habla para no hablar bien!	
VO_LOOT_541_Male_Kobold_BOSS_GeorgeKarl_01	Estos dos llegar perdidos de selva un día.	
VO_LOOT_541_Male_Kobold_BOSS_Gnosh_01	¡Túnel no ser túnel de verdad! ¡Boca grande! ¡Muchos dientes!	
VO_LOOT_541_Male_Kobold_BOSS_Graves_01	Sanador perdido solo predicar. "Piedad, piedad". ¡Deber matarlo!	
VO_LOOT_541_Male_Kobold_BOSS_Gutmook_01	Troggs. BAH. Cerrar boca y dejar que esbirros hacer papilla.	
VO_LOOT_541_Male_Kobold_BOSS_Hamm_01	Hamm ser más mejor excavador de túneles. "Excavar" ser eufemismo.	
VO_LOOT_541_Male_Kobold_BOSS_Jeeru_01	¡Oh, no, no! ¡No frotar lámpara! Ser trampa astuta.	
VO_LOOT_541_Male_Kobold_BOSS_Lyris_01	¡Elfa loca tiradestellos! Tú tener cuidado con gentes-serpiente de fuego escurridizas.	
VO_LOOT_541_Male_Kobold_BOSS_MagmaRager_01	Kóbolds sellar tubo de lava, pero seguir abriéndose de alguna forma.	
VO_LOOT_541_Male_Kobold_BOSS_Mothergloop_01	¡Cuidado con mamá Pegote, pegote del que salir todos los demás pegotes!	
VO_LOOT_541_Male_Kobold_BOSS_Mushhuckster_01	Cuecepotingues Max venir de zona mala de mazmorra.	
VO_LOOT_541_Male_Kobold_BOSS_Russell_01	Bardo cantar canciones y gente querer pegar en la cara.	
VO_LOOT_541_Male_Kobold_BOSS_Seriona_01	¡Maldita dragona Crepuscular hacer kóbolds débiles! Eh... ¡más débiles!	
VO_LOOT_541_Male_Kobold_BOSS_Sturmi_01	¡Sturmi hacer amiguitos de cera! Ella ser muy divertida en fiestas kóbold.	
VO_LOOT_541_Male_Kobold_BOSS_TrappedRoom_01	Ssh... No... tocar... NADA...	
VO_LOOT_541_Male_Kobold_BOSS_TreasureVault_01	¡Tesoro! Tesoro aquí. ¡Aplastar y saquear!	
VO_LOOT_541_Male_Kobold_BOSS_Troll_01	Jefe trol obligatorio ser parte importante de dieta de mazmorra equilibrada.	
VO_LOOT_541_Male_Kobold_BOSS_Whopwhisker_01	Viejo Bigofusta ser kóbold más furioso.	
VO_LOOT_541_Male_Kobold_DefeatPlayer_01	¡Cuántos tesoros! Je, je... Míos, míos, míos, míos, míos.	
VO_LOOT_541_Male_Kobold_EmoteResponse_01	Parar de darle a la lengua.	
VO_LOOT_541_Male_Kobold_LOOT_Backpacks_01	¡Mochilas! Ya no ser solo para espalda.	
VO_LOOT_541_Male_Kobold_LOOT_Boombox_01	¡Caja bum! Mejor caja de bombas que venir en caja.	
VO_LOOT_541_Male_Kobold_LOOT_Candle1_01	¡No llevarte vela!	
VO_LOOT_541_Male_Kobold_LOOT_Candle2_01	¡Yo avisarte! ¡Yo decir que tú no llevarte y tú llevarte!	
VO_LOOT_541_Male_Kobold_LOOT_CapturedFlag_01	Alianza y Horda perder cabeza por banderas.	
VO_LOOT_541_Male_Kobold_LOOT_Cube_01	¡Oh, caja cubo loca! ¡Cuando ganar ya no ser opción!	
VO_LOOT_541_Male_Kobold_LOOT_Invisibility_01	¡Capa de invisibilidad! ¡Yo perder siempre! La capa ser invisible...	
VO_LOOT_541_Male_Kobold_LOOT_QuelDelar_01	¡Quel'Delar! Espada legendaria rota en mitad. No ser mi culpa.	
VO_LOOT_541_Male_Kobold_LOOT_QuelDelarForged_01	¡Ser bella! ¡Muy brillante! ¡Muy... espadosa!	
VO_LOOT_541_Male_Kobold_LOOT_Wand_01	Kóbolds usar Vara de Achicharro para poner a prueba habilidades.	
VO_LOOT_541_Male_Kobold_LOOT_WaxRager_01	Furibundo de cera ser amigo poderoso. Tú no preguntar de dónde venir cera. De oídos.	
VO_LOOT_541_Male_Kobold_TUT_AdventureSelect_01	¿Qué ser este olor? ¿Cuero? ¿Acero? Antorchas... AVENTUREROS. ¡Bah! ¡Aventureros!	
VO_LOOT_541_Male_Kobold_TUT_BossHeroPower_01	Cada monstruo hacer cosas diferentes. Todas malas. ¡Hacer clic y ver!	
VO_LOOT_541_Male_Kobold_TUT_BountyBoard_01	¡Alto! ¡Atrás! Grandes montones de botín para MÍ, no para TI.	
VO_LOOT_541_Male_Kobold_TUT_CharacterSelect_01	¿Quién osar venir a por tesoros kóbold? ¿Espadachín? ¿Lanzadestellos?	
VO_LOOT_541_Male_Kobold_TUT_Final_Boss_Azari_01	¡Devorador liberarse! ¡Tú correr!	
VO_LOOT_541_Male_Kobold_TUT_Final_Boss_Darkness_01	¡Tú tener cuidadisísimo con oscuridad! Por eso kóbolds guardar velas.	
VO_LOOT_541_Male_Kobold_TUT_Final_Boss_KoboldKing_01	¡Mi turno, ji, ji! ¡Yo llevarme todos los tesoros y tú caerte con todo equipo!	
VO_LOOT_541_Male_Kobold_TUT_Final_Boss_Vustrasz_01	¿Tú querer llevarte tesoros de dragón? Oh, cabrearse MUCHO seguro...	
VO_LOOT_541_Male_Kobold_TUT_Final_Boss_Xol_01	¡Tú no mirar a ojos de Xol! Ella tener ojos por toda su gran cara.	
VO_LOOT_541_Male_Kobold_TUT_Game1Begin1_01	Primeros monstruos que tú encontrar ser pequeños y débiles. ¡Como tú!	
VO_LOOT_541_Male_Kobold_TUT_Game1Begin2_01	¡Tú aplastarlos y quitarles cosas para hacerte más fuerte!	
VO_LOOT_541_Male_Kobold_TUT_Game1Defeat_01	Estar bien. Mejor morir joven que nunca morir.	
VO_LOOT_541_Male_Kobold_TUT_Game1Victory_01	¡Tú ganar! Ahora llevarte botín. Ji, ji. Una aventura clásica.	
VO_LOOT_541_Male_Kobold_TUT_Game2Begin1_01	Tú volverte más fuerte, pero monstruos también.	
VO_LOOT_541_Male_Kobold_TUT_Game2Begin2_01	Elasticidad pecuniaria ser parte importante de doctrina económica para mercado mixto de imperio kóbold.	
VO_LOOT_541_Male_Kobold_TUT_GeneralDefeat1_01	Qué pena. Para ti. ¡Cuando aventurero morir, rey kóbold quedarse con botín!	
VO_LOOT_541_Male_Kobold_TUT_GeneralDefeat2_01	¡Enviar más aventureros! ¡Ji, ji! Más botín para mí. Más botín, más botín...	
VO_LOOT_541_Male_Kobold_TUT_MainBoss1_01	Tú encontrar muchos monstruos en imperio kóbold. ¡Cada combate hacerte más fuerte! O más cadáver.	
VO_LOOT_541_Male_Kobold_TUT_MainBoss3_01	¡En aventura de mazmorra deber luchar contra ocho monstruos! Uno por cada dedo.	
VO_LOOT_541_Male_Kobold_TUT_TreasureSelect1_01	¡OH! ¡Gran tesoro! Tú elegir uno, solo uno. Tú deber elegir bien.	
VO_LOOT_541_Male_Kobold_TUT_TreasureSelect2_01	Las cartas que tú elegir ahora, ser cartas para mazo de mazmorra.	
VO_LOOT_541_Male_Kobold_TUT_TreasureSelect3_01	Tú construir mazo para aplastar monstruos. Ese ser tu mazo hasta morir.	
VO_LOOT_541_Male_Kobold_TUT_TreasureSelect4_01	¡Si ganar más peleas, conseguir más botín! ¡Ser costumbre kóbold!	
VO_LOOT_541_Male_Kobold_TUT_Victory1_01	¿Cómo? ¡Nadie marcharse con tesoros kóbold!	
VO_LOOT_541_Male_Kobold_TUT_Victory2_01	¡Y nunca nueve veces distintas!	
VO_LOOT_541_Male_Kobold_TUT_VictoryComplete_01	¡Tú lograrlo! ¡Tú dominar estilo de mazmorra nivel furia suprema!	
VO_LOOT_541_Male_Kobold_TUT_VictoryComplete_02	¡Victoria! ¡Tú dominar todas mazmorras!	
VO_LOOTA_829_Male_Human_Event_01	¡Yo maldigo mi repentina pero inevitable traición!	
VO_LOOTA_BOSS_04h_Female_Kobold_Death_01	<Muerte.>	
VO_LOOTA_BOSS_04h_Female_Kobold_DefeatPlayer_01	¡No moverte! Que cera se enfríe... Muy bonito, bonito, bonito...	
VO_LOOTA_BOSS_04h_Female_Kobold_EmoteResponse_01	Yo ser ceramante, no ceramiente.	
VO_LOOTA_BOSS_04h_Female_Kobold_EventWaxOff_01	Pulir cera...	
VO_LOOTA_BOSS_04h_Female_Kobold_EventWaxOn_01	¡Dar cera!	
VO_LOOTA_BOSS_04h_Female_Kobold_EventWaxRagerPlay_01	Ohh... ¡precioso!	
VO_LOOTA_BOSS_04h_Female_Kobold_EventWaxRagerRespawn_01	Oh, volver todo el rato.	
VO_LOOTA_BOSS_04h_Female_Kobold_Intro1_01	Oh, sí, mmm, la cera tener ojos...	
VO_LOOTA_BOSS_04h_Female_Kobold_Intro2_01	Yo hacer cosas bonitas muy bonitas, como ceras bonitas.	
VO_LOOTA_BOSS_05h_Male_Kobold_Death_01	<Muerte.>	
VO_LOOTA_BOSS_05h_Male_Kobold_DefeatPlayer_01	¡Hamm hacer pam!	
VO_LOOTA_BOSS_05h_Male_Kobold_EmoteResponse_01	Tú no llevarte bum bum.	
VO_LOOTA_BOSS_05h_Male_Kobold_EventBoomBots_01	Bien. ¡BIEN! ¡Bien, bien, bien!	
VO_LOOTA_BOSS_05h_Male_Kobold_EventMadBomberDeath_01	Así no...	
VO_LOOTA_BOSS_05h_Male_Kobold_HeroPower1_01	Bum, ¡BUM!	
VO_LOOTA_BOSS_05h_Male_Kobold_HeroPower2_01	Ja, ja, ja.	
VO_LOOTA_BOSS_05h_Male_Kobold_HeroPower3_01	Ja, ja, ja, ja.	
VO_LOOTA_BOSS_05h_Male_Kobold_Intro_01	¡Hora de demolición!	
VO_LOOTA_BOSS_06h_Male_Furbolg_Death_01	Hay otro, en las profundidades...	
VO_LOOTA_BOSS_06h_Male_Furbolg_DefeatPlayer_01	Está... ¿Ha muerto a mi mano? ¿Qué he hecho?	
VO_LOOTA_BOSS_06h_Male_Furbolg_EmoteResponse_01	Solo eres otra... de las voces...	
VO_LOOTA_BOSS_06h_Male_Furbolg_EventPlayerEvolves_01	Te ha bendecido la oscuridad.	
VO_LOOTA_BOSS_06h_Male_Furbolg_HeroPower1_01	Llama...	
VO_LOOTA_BOSS_06h_Male_Furbolg_HeroPower2_01	Estas cavernas son profundas.	
VO_LOOTA_BOSS_06h_Male_Furbolg_HeroPower3_01	Las cosas no son lo que parecen...	
VO_LOOTA_BOSS_06h_Male_Furbolg_HeroPower4_01	¿Quién de nosotros es el monstruo?	
VO_LOOTA_BOSS_06h_Male_Furbolg_HeroPower5_01	Tú no ves las sombras... pero ellas te ven a ti.	
VO_LOOTA_BOSS_06h_Male_Furbolg_Intro_01	Algo maligno está enterrado aquí.	
VO_LOOTA_BOSS_09h_Female_Furbolg_Death_01	<Muerte.>	
VO_LOOTA_BOSS_09h_Female_Furbolg_DefeatPlayer_01	Así se hacía en Cuna del Invierno.	
VO_LOOTA_BOSS_09h_Female_Furbolg_EmoteResponse_01	Cuánta frialdad.	
VO_LOOTA_BOSS_09h_Female_Furbolg_EventFrostMagic1_01	Abraza el frío.	
VO_LOOTA_BOSS_09h_Female_Furbolg_EventFrostMagic2_01	Brrr.	
VO_LOOTA_BOSS_09h_Female_Furbolg_EventFrostMagic3_01	¡Refrescante!	
VO_LOOTA_BOSS_09h_Female_Furbolg_HeroPower1_01	Quédate ahí.	
VO_LOOTA_BOSS_09h_Female_Furbolg_HeroPower2_01	Oh, no, de eso nada.	
VO_LOOTA_BOSS_09h_Female_Furbolg_HeroPower3_01	No te muevas.	
VO_LOOTA_BOSS_09h_Female_Furbolg_Intro_01	Kóbolds, ya os dije que... Oh, ¿qué tenemos aquí?	
VO_LOOTA_BOSS_10h_Male_Human_Death_01	Era inevitable...	
VO_LOOTA_BOSS_10h_Male_Human_DefeatPlayer_02	¡Reclamo estos tesoros para la Luz! Y para mí.	
VO_LOOTA_BOSS_10h_Male_Human_EmoteResponse_01	Suplicar clemencia no te salvará.	
VO_LOOTA_BOSS_10h_Male_Human_EventOverdraw_01	¡Nunca vayas de Villanorte total!	
VO_LOOTA_BOSS_10h_Male_Human_HeroPower1_01	¡Cree!	
VO_LOOTA_BOSS_10h_Male_Human_HeroPower2_01	¡Te has sanado!	
VO_LOOTA_BOSS_10h_Male_Human_HeroPower3_01	¡Reniega de la oscuridad!	
VO_LOOTA_BOSS_10h_Male_Human_HeroPower4_01	La Luz concede el perdón.	
VO_LOOTA_BOSS_10h_Male_Human_HeroPower5_01	¡Glorioso!	
VO_LOOTA_BOSS_10h_Male_Human_Intro_01	¡Alto! ¡Reclamo estos tesoros en nombre de la Luz!	
VO_LOOTA_BOSS_11h_Male_Trogg_Death_01	<Muerte.>	
VO_LOOTA_BOSS_11h_Male_Trogg_DefeatPlayer_01	Buen líder conocer camino, recorrer camino y sacar látigo.	
VO_LOOTA_BOSS_11h_Male_Trogg_EmoteResponse_01	No hablar como listo. ¡Solo hablar con LÁTIGO!	
VO_LOOTA_BOSS_11h_Male_Trogg_EventEquality_01	¡Esbirros ya llevarse latigazos antes!	
VO_LOOTA_BOSS_11h_Male_Trogg_HeroPower1_01	¡Moverte!	
VO_LOOTA_BOSS_11h_Male_Trogg_HeroPower2_01	¡Adelante!	
VO_LOOTA_BOSS_11h_Male_Trogg_HeroPower3_01	¡Más rápido!	
VO_LOOTA_BOSS_11h_Male_Trogg_HeroPower4_01	¡Darte prisa!	
VO_LOOTA_BOSS_11h_Male_Trogg_HeroPower5_01	¡Látigo para ti!	
VO_LOOTA_BOSS_11h_Male_Trogg_Intro_01	¡Hora de látigo!	
VO_LOOTA_BOSS_12h_Male_Kobold_CandleAttack1_01	¡Tú enfadar mucho a vela!	
VO_LOOTA_BOSS_12h_Male_Kobold_CandleAttack2_01	¡No provocar a vela!	
VO_LOOTA_BOSS_12h_Male_Kobold_CandleAttack3_01	¡Rakanishu!	
VO_LOOTA_BOSS_12h_Male_Kobold_CandleAttack4_01	¡Hora de vela!	
VO_LOOTA_BOSS_12h_Male_Kobold_CandleAttack5_01	¡No poder controlar vela!	
VO_LOOTA_BOSS_12h_Male_Kobold_Death_01	No... llevarte...	
VO_LOOTA_BOSS_12h_Male_Kobold_Death1_01	¡Pasado por la quilla!	
VO_LOOTA_BOSS_12h_Male_Kobold_Death2_01	Yo, jo... no...	
VO_LOOTA_BOSS_12h_Male_Kobold_Death3_01	¡Tirarme por la borda!	
VO_LOOTA_BOSS_12h_Male_Kobold_DefeatPlayer_01	¡Ja, jar! ¡Salirte tiro por la culata!	
VO_LOOTA_BOSS_12h_Male_Kobold_DefeatPlayer_02	¡Cuántos tesoros! Ja, ja. Ahora enseñar a Rafaam...	
VO_LOOTA_BOSS_12h_Male_Kobold_EmoteResponse_01	¡Cerrar pico, rascatúneles de pacotilla!	
VO_LOOTA_BOSS_12h_Male_Kobold_EventCandleStolen_01	¿Cómo? ¡Legislación sobre llevarse vela ser MUY clara!	
VO_LOOTA_BOSS_12h_Male_Kobold_EventChargeBigMinion_01	¡Jo, jo, jo!	
VO_LOOTA_BOSS_12h_Male_Kobold_EventFindCandle_01	¡Oh, vela bonita! Sssh, pequeña. Yo llevarme, yo llevarme.	
VO_LOOTA_BOSS_12h_Male_Kobold_EventPlayCandle_01	¡Yo HABER DICHO que tú NO LLEVARTE!	
VO_LOOTA_BOSS_12h_Male_Kobold_EventPlayerPlaysCrab_01	¡Apartar de mí! ¡No!	
VO_LOOTA_BOSS_12h_Male_Kobold_EventPlayerPlaysPatches_01	¡No! ¡Yo estar al mando! ¡Yo!	
VO_LOOTA_BOSS_12h_Male_Kobold_EventPlayKoboldKing_01	¡Regicidio!	
VO_LOOTA_BOSS_12h_Male_Kobold_GetTreasure1_01	¡Yo también conseguir tesoro!	
VO_LOOTA_BOSS_12h_Male_Kobold_GetTreasure2_01	Cosas brillantes para kóbolds reinantes...	
VO_LOOTA_BOSS_12h_Male_Kobold_GetTreasure3_01	¿Qué conseguir? ¡Oh, qué bien!	
VO_LOOTA_BOSS_12h_Male_Kobold_GetTreasure4_01	Mmm... ¡Tesoro!	
VO_LOOTA_BOSS_12h_Male_Kobold_GetTreasure5_01	¡Mi mazmorra! ¡Mi tesoro!	
VO_LOOTA_BOSS_12h_Male_Kobold_Intro_01	¡Tú soltar tesoros! ¡Yo llevármelos! ¡Míos!	
VO_LOOTA_BOSS_12h_Male_Kobold_Intro1_01	¡Velas y mechas!	
VO_LOOTA_BOSS_12h_Male_Kobold_Intro2_01	¡Por barbas de Neptulon!	
VO_LOOTA_BOSS_12h_Male_Kobold_Intro3_01	¡Ojo al parche!	
VO_LOOTA_BOSS_13h_Female_Undead_Death_01	<Muerte.>	
VO_LOOTA_BOSS_13h_Female_Undead_DefeatPlayer_01	Bueno, veamos que tenías... ¿Mmm? ¿De veras has escogido estas cartas?	
VO_LOOTA_BOSS_13h_Female_Undead_EmoteResponse_01	¿Es tu primera vez en esta mazmorra? Por aquí no nos gusta mucho charlar.	
VO_LOOTA_BOSS_13h_Female_Undead_EventBagOfCoins_01	Oh, no te faltan los recursos.	
VO_LOOTA_BOSS_13h_Female_Undead_EventStealQuest_01	¡Alto! ¡Al ladrón!	
VO_LOOTA_BOSS_13h_Female_Undead_HeroPower_01	¡Detrás de mí!	
VO_LOOTA_BOSS_13h_Female_Undead_HeroPower1_01	Un paso atrás.	
VO_LOOTA_BOSS_13h_Female_Undead_HeroPower2_01	Rápido.	
VO_LOOTA_BOSS_13h_Female_Undead_HeroPower3_01	Dentro y fuera de las sombras.	
VO_LOOTA_BOSS_13h_Female_Undead_HeroPower4_01	No dejéis que os ataquen.	
VO_LOOTA_BOSS_13h_Female_Undead_Intro_01	Entrega el tesoro y te daré una muerte rápida.	
VO_LOOTA_BOSS_15h_Male_Human_Death_01	<Muerte.>	
VO_LOOTA_BOSS_15h_Male_Human_DefeatPlayer_01	A lo mejor si vamos por aquí, encontraremos el camino de vuelta a Un'Goro.	
VO_LOOTA_BOSS_15h_Male_Human_EmoteResponse_01	¿No te he visto en Un'Goro?	
VO_LOOTA_BOSS_15h_Male_Human_Intro_01	¡Por la Luz, Karl! ¡Mira dónde estamos!	
VO_LOOTA_BOSS_15h_Male_Human_PartnerDeath_01	¡Oh, Luz mía, has matado a Karl!	
VO_LOOTA_BOSS_15h_Male_Human_TaggedIn1_01	A un lado, yo tomaré el mando.	
VO_LOOTA_BOSS_15h_Male_Human_TaggedIn2_01	Esto es ridículo, ya cojo yo las cartas.	
VO_LOOTA_BOSS_15h_Male_Human_TaggedIn3_01	¡Atrás, es mi turno!	
VO_LOOTA_BOSS_16h_Male_Troll_Death_01	¡Ahor'ablaré conmigo mihmo!	
VO_LOOTA_BOSS_16h_Male_Troll_DefeatPlayer_01	Eh, no te preocupeh, persona muerta. Ahora Azun te hará compañía.	
VO_LOOTA_BOSS_16h_Male_Troll_EmoteResponse_01	Yo hablo con loh muertoh. Tú habla con la mano.	
VO_LOOTA_BOSS_16h_Male_Troll_EventPlayerDeathrattle1_01	Ja. Eh, esa eh buena.	
VO_LOOTA_BOSS_16h_Male_Troll_EventPlayerDeathrattle2_01	Aquí nadie dehcansa en paz.	
VO_LOOTA_BOSS_16h_Male_Troll_EventPlayerDeathrattle3_01	Me guhtaría echar mano a esa.	
VO_LOOTA_BOSS_16h_Male_Troll_EventPlayerDeathrattle4_01	Esa ehtá mejor muerta.	
VO_LOOTA_BOSS_16h_Male_Troll_EventPlayerDeathrattle5_01	Solo se muere doh veceh.	
VO_LOOTA_BOSS_16h_Male_Troll_Intro_01	¡Hablo con loh muertoh! ¿Te parece bien? Todo bien.	
VO_LOOTA_BOSS_17h_Male_Troll_Death_01	<Muerte.>	
VO_LOOTA_BOSS_17h_Male_Troll_DefeatPlayer_01	¿Le buhcah lah cohquillah a Jin'zo? Poh Jin'zo se ríe de ti.	
VO_LOOTA_BOSS_17h_Male_Troll_EmoteResponse_01	No eh hora de hablar. ¡Eh hora de LLORAR!	
VO_LOOTA_BOSS_17h_Male_Troll_EventPlayerBattlecry1_01	Oooh... Me guhta su ehpíritu.	
VO_LOOTA_BOSS_17h_Male_Troll_EventPlayerBattlecry2_01	¡A Jin'zo le guhta!	
VO_LOOTA_BOSS_17h_Male_Troll_EventPlayerBattlecry3_01	¡Sí, ehta habla el idioma de Jin'zo!	
VO_LOOTA_BOSS_17h_Male_Troll_EventPlayerBrann_01	¿El enanito cree que puede gritar máh que Jin'zo? ¡POH NO!	
VO_LOOTA_BOSS_17h_Male_Troll_Intro_01	¡Jin'zo tiene GRANDEH planeh pa ti!	
VO_LOOTA_BOSS_19h_Male_Trogg_Death_01	<Muerte.>	
VO_LOOTA_BOSS_19h_Male_Trogg_DefeatPlayer_01	Tú usar trucos, yo aplastarte.	
VO_LOOTA_BOSS_19h_Male_Trogg_EmoteResponse_01	¿Tú gustar troggs? Yo darte troggs.	
VO_LOOTA_BOSS_19h_Male_Trogg_EventHandFull_01	Silencio, yo... eh... ¡Demasiadas!	
VO_LOOTA_BOSS_19h_Male_Trogg_HeroPower1_01	¡Venir, trogg!	
VO_LOOTA_BOSS_19h_Male_Trogg_HeroPower2_01	Tú seguir hablando. Yo tener más.	
VO_LOOTA_BOSS_19h_Male_Trogg_HeroPower3_01	Ellos oler magia.	
VO_LOOTA_BOSS_19h_Male_Trogg_HeroPowerHard1_01	Mucho poder.	
VO_LOOTA_BOSS_19h_Male_Trogg_HeroPowerHard2_01	Tú seguir hablando.	
VO_LOOTA_BOSS_19h_Male_Trogg_HeroPowerHard3_01	Aaaah... Magia...	
VO_LOOTA_BOSS_19h_Male_Trogg_Intro_01	¡De rodillas ante TROGG!	
VO_LOOTA_BOSS_20h_Male_Earthen_Death_01	Dormiiiiiiir...	
VO_LOOTA_BOSS_20h_Male_Earthen_DefeatPlayer_01	El sagrario está a salvo.	
VO_LOOTA_BOSS_20h_Male_Earthen_EmoteResponse_01	Nada me detendrá.	
VO_LOOTA_BOSS_20h_Male_Earthen_EventPlayerSilence_01	Vaya... gracias.	
VO_LOOTA_BOSS_20h_Male_Earthen_EventStatueDestroyed1_01	Prolongas lo inevitable.	
VO_LOOTA_BOSS_20h_Male_Earthen_EventStatueDestroyed2_01	Es cuestión de tiempo.	
VO_LOOTA_BOSS_20h_Male_Earthen_EventStatueDestroyed3_01	Profanas este lugar.	
VO_LOOTA_BOSS_20h_Male_Earthen_EventStatueDestroyed4_01	Debo... proteger... el sagrario...	
VO_LOOTA_BOSS_20h_Male_Earthen_EventStatueDestroyed5_01	Mi voluntad es de piedra.	
VO_LOOTA_BOSS_20h_Male_Earthen_HeroPower_01	¡DESPERTAD!	
VO_LOOTA_BOSS_20h_Male_Earthen_HeroPowerNoStatues_01	¡DESPERTAD! Oh...	
VO_LOOTA_BOSS_20h_Male_Earthen_Intro_01	Márchate. Aquí no hay nada para ti.	
VO_LOOTA_BOSS_22h_Male_Murloc_Death_01	<Muerte.>	
VO_LOOTA_BOSS_22h_Male_Murloc_DeathSpecial_01	¡¡...!!	
VO_LOOTA_BOSS_22h_Male_Murloc_DefeatPlayer_01	¡...! ¿...?	
VO_LOOTA_BOSS_22h_Male_Murloc_EmoteResponse_01	¡¿...?!	
VO_LOOTA_BOSS_22h_Male_Murloc_EventFishUpChest_01	...	
VO_LOOTA_BOSS_22h_Male_Murloc_EventSummonCrab_01	¡¡...!!	
VO_LOOTA_BOSS_22h_Male_Murloc_FishLarge_02	¡...!	
VO_LOOTA_BOSS_22h_Male_Murloc_FishMedium_01	¿...?	
VO_LOOTA_BOSS_22h_Male_Murloc_FishSmall_01	...	
VO_LOOTA_BOSS_22h_Male_Murloc_Intro_01	¡...!	
VO_LOOTA_BOSS_23h_Male_Furbolg_Death_01	<Muerte.>	
VO_LOOTA_BOSS_23h_Male_Furbolg_DefeatPlayer_01	Tus huesos servirán de advertencia para los que vengan después.	
VO_LOOTA_BOSS_23h_Male_Furbolg_EmoteResponse_01	Sigue hablando para que mis bestias te encuentren...	
VO_LOOTA_BOSS_23h_Male_Furbolg_EventPlayBigMinion1_01	¡La caza... termina!	
VO_LOOTA_BOSS_23h_Male_Furbolg_EventPlayBigMinion2_01	No hay escapatoria.	
VO_LOOTA_BOSS_23h_Male_Furbolg_EventPlayBigMinion3_01	¡Huelen tu miedo!	
VO_LOOTA_BOSS_23h_Male_Furbolg_HeroPower1_01	Se acerca tu hora...	
VO_LOOTA_BOSS_23h_Male_Furbolg_HeroPower2_01	¡Mi poder es imparable!	
VO_LOOTA_BOSS_23h_Male_Furbolg_HeroPower3_01	Mis bestias te encontrarán.	
VO_LOOTA_BOSS_23h_Male_Furbolg_HeroPower4_01	Yo conozco estas cuevas. Tú no.	
VO_LOOTA_BOSS_23h_Male_Furbolg_HeroPower5_01	Este es mi terreno de caza.	
VO_LOOTA_BOSS_23h_Male_Furbolg_Intro_01	Aquí... ¡TÚ eres la presa!	
VO_LOOTA_BOSS_25h_Male_Dragon_Death_01	<Muerte.>	
VO_LOOTA_BOSS_25h_Male_Dragon_DefeatPlayer_01	Estos tesoros son ancestrales y venerables. Y aquí se quedan.	
VO_LOOTA_BOSS_25h_Male_Dragon_EmoteResponse_01	Tendré eso en cuenta.	
VO_LOOTA_BOSS_25h_Male_Dragon_EventMarinTheFox_01	¡Marin el Zorro! ¿Osas volver a este lugar?	
VO_LOOTA_BOSS_25h_Male_Dragon_HeroPower1_01	Arde por tu intrusión.	
VO_LOOTA_BOSS_25h_Male_Dragon_HeroPower2_01	¡Criminal despreciable!	
VO_LOOTA_BOSS_25h_Male_Dragon_HeroPower3_01	¡Sufre!	
VO_LOOTA_BOSS_25h_Male_Dragon_HeroPower4_01	¡Desaparece!	
VO_LOOTA_BOSS_25h_Male_Dragon_HeroPower5_01	Ya no puedes esconderte.	
VO_LOOTA_BOSS_25h_Male_Dragon_Intro_01	Muéstrate, criminal.	
VO_LOOTA_BOSS_25h_Male_Dragon_TreasureDestroy1_01	¡Eso no es tuyo!	
VO_LOOTA_BOSS_25h_Male_Dragon_TreasureDestroy2_01	¡Al ladrón!	
VO_LOOTA_BOSS_25h_Male_Dragon_TreasureDestroy3_01	¡Devuélvelo!	
VO_LOOTA_BOSS_25h_Male_Dragon_TreasureDestroy4_02	¡La avaricia te puede!	
VO_LOOTA_BOSS_25h_Male_Dragon_TreasureDestroy5_01	Pagarás cara tu codicia.	
VO_LOOTA_BOSS_26h_Female_Demon_Death_01	<Muerte.>	
VO_LOOTA_BOSS_26h_Female_Demon_DefeatPlayer_01	Infeliz, ¿creías que podías colarte aquí? Yo lo veo todo.	
VO_LOOTA_BOSS_26h_Female_Demon_EmoteResponse_01	Mis ojos... fulgen al verte.	
VO_LOOTA_BOSS_26h_Female_Demon_EyeStalkConfuse_01	Furor.	
VO_LOOTA_BOSS_26h_Female_Demon_EyeStalkDeath_01	Fatalidad.	
VO_LOOTA_BOSS_26h_Female_Demon_EyeStalkDevitalize_01	Fatiga.	
VO_LOOTA_BOSS_26h_Female_Demon_EyeStalkFear_01	Fobia.	
VO_LOOTA_BOSS_26h_Female_Demon_EyeStalkFire_01	Fuego.	
VO_LOOTA_BOSS_26h_Female_Demon_EyeStalkFrost_01	Frío.	
VO_LOOTA_BOSS_26h_Female_Demon_Intro_01	Fabuloso. Has conseguido llegar hasta aquí. Deja que te vea...	
VO_LOOTA_BOSS_32h_Male_Human_Death_01	<Muerte.>	
VO_LOOTA_BOSS_32h_Male_Human_EmoteResponse_01	No hablo con desconocidos.	
VO_LOOTA_BOSS_32h_Male_Human_PartnerDeath_01	¿George? ¡Oh, no, George no!	
VO_LOOTA_BOSS_32h_Male_Human_TaggedIn1_01	¡Déjame intentarlo!	
VO_LOOTA_BOSS_32h_Male_Human_TaggedIn2_01	¡Déjame ayudar, George!	
VO_LOOTA_BOSS_32h_Male_Human_TaggedIn3_01	¿Me dejas ir, George? ¿Puedo?	
VO_LOOTA_BOSS_34h_Male_Demon_Death_01	<Muerte.>	
VO_LOOTA_BOSS_34h_Male_Demon_DefeatPlayer_01	Necesito más... ¡MÁS!	
VO_LOOTA_BOSS_34h_Male_Demon_EmoteResponse_01	Tu miedo y tus remordimientos aplacan mi apetito insaciable.	
VO_LOOTA_BOSS_34h_Male_Demon_HeroPower1_01	Me alimento.	
VO_LOOTA_BOSS_34h_Male_Demon_HeroPower2_01	Más...	
VO_LOOTA_BOSS_34h_Male_Demon_HeroPower3_01	Quiero más...	
VO_LOOTA_BOSS_34h_Male_Demon_HeroPower4_01	Devoraré este mundo.	
VO_LOOTA_BOSS_34h_Male_Demon_HeroPower5_01	Este es tu fin.	
VO_LOOTA_BOSS_34h_Male_Demon_Intro_01	TENGO HAMBRE.	
VO_LOOTA_BOSS_35h_Male_Furbolg_Death_01	Abandona... ¡Abajo solo te espera la muerte!	
VO_LOOTA_BOSS_35h_Male_Furbolg_DefeatPlayer_01	Tu cuerpo permanece aquí, pero tu alma se libera al fin.	
VO_LOOTA_BOSS_35h_Male_Furbolg_EmoteResponse_01	Si buscas la paz, deja tus tesoros y márchate.	
VO_LOOTA_BOSS_35h_Male_Furbolg_Intro_01	¡Fuera! ¡Tu magia no sirve de nada aquí!	
VO_LOOTA_BOSS_35h_Male_Furbolg_SpellCountered1_01	Tu magia solo alimenta esta madriguera.	
VO_LOOTA_BOSS_35h_Male_Furbolg_SpellCountered2_01	¡Silencio!	
VO_LOOTA_BOSS_35h_Male_Furbolg_SpellCountered3_01	Tu fuerza mengua.	
VO_LOOTA_BOSS_35h_Male_Furbolg_SpellCountered4_01	Mi magia es más poderosa que la tuya...	
VO_LOOTA_BOSS_35h_Male_Furbolg_SpellCountered5_01	Nada supera los viejos métodos.	
VO_LOOTA_BOSS_37h_Female_BloodElf_Death_01	¡Me quemo!	
VO_LOOTA_BOSS_37h_Female_BloodElf_DefeatPlayer_01	Si bailas en mi mazmorra, te vas a quemar...	
VO_LOOTA_BOSS_37h_Female_BloodElf_EmoteResponse_01	¡Ardo en deseos de responderte! Ja, ja. ¿Lo pillas?	
VO_LOOTA_BOSS_37h_Female_BloodElf_EventFireball_01	Fuego... ¡FUEGO!	
VO_LOOTA_BOSS_37h_Female_BloodElf_EventPyroblast_01	¡La cosa está que ARDE!	
VO_LOOTA_BOSS_37h_Female_BloodElf_EventRagnaros_01	¡ESTAS son las peleas que me gustan!	
VO_LOOTA_BOSS_37h_Female_BloodElf_EventTheCandle_01	Entonces... ¿TÚ te llevaste la vela?	
VO_LOOTA_BOSS_37h_Female_BloodElf_Flamewakers_01	¡Ahí van los fuegos artificiales!	
VO_LOOTA_BOSS_37h_Female_BloodElf_HeroPower1_01	Necesito más poder...	
VO_LOOTA_BOSS_37h_Female_BloodElf_HeroPower2_01	Más... ¡más!	
VO_LOOTA_BOSS_37h_Female_BloodElf_HeroPower3_01	¡Los hechizos me divierten! ¡Mucho!	
VO_LOOTA_BOSS_37h_Female_BloodElf_Intro_01	¡Las llamas os harán bailar!	
VO_LOOTA_BOSS_38h_Male_Kobold_Death_01	¡Maldiciones!	
VO_LOOTA_BOSS_38h_Male_Kobold_DefeatPlayer_01	¡Yo saber que hacer mejor vudú que tú!	
VO_LOOTA_BOSS_38h_Male_Kobold_EmoteResponse_01	¡Yo maldecirte!	
VO_LOOTA_BOSS_38h_Male_Kobold_EventBrann_01	Vudú enano, vudú extraño.	
VO_LOOTA_BOSS_38h_Male_Kobold_EventPlayerBattlecries1_01	Esa ser muy gritona.	
VO_LOOTA_BOSS_38h_Male_Kobold_EventPlayerBattlecries2_01	Esa gritar mucho.	
VO_LOOTA_BOSS_38h_Male_Kobold_EventPlayerBattlecries3_01	Todas gritar mucho.	
VO_LOOTA_BOSS_38h_Male_Kobold_EventPlayerDeathrattles1_01	¡Esa tener mal aliento!	
VO_LOOTA_BOSS_38h_Male_Kobold_EventPlayerDeathrattles3_01	Tú dejarme sin aliento.	
VO_LOOTA_BOSS_38h_Male_Kobold_EventRivendare_01	Vudú muerto ser peor de todos.	
VO_LOOTA_BOSS_38h_Male_Kobold_Intro_01	¡Yo también hacer vudú!	
VO_LOOTA_BOSS_39h_Male_Golem_Death_01	Me... desmorono...	
VO_LOOTA_BOSS_39h_Male_Golem_DefeatPlayer_01	El tesoro está seguro.	
VO_LOOTA_BOSS_39h_Male_Golem_EmoteResponse_01	No eres el maestro.	
VO_LOOTA_BOSS_39h_Male_Golem_HeroPower1_01	Aplastar.	
VO_LOOTA_BOSS_39h_Male_Golem_HeroPower2_01	Pisotear.	
VO_LOOTA_BOSS_39h_Male_Golem_HeroPower3_01	¡Nadie pasará!	
VO_LOOTA_BOSS_39h_Male_Golem_HeroPower4_01	Qué... diminutos...	
VO_LOOTA_BOSS_39h_Male_Golem_HeroPower5_01	¡Fuera!	
VO_LOOTA_BOSS_39h_Male_Golem_Intro_01	Defender... el tesoro...	
VO_LOOTA_BOSS_40h_Female_Dragon_Death_01	<Muerte.>	
VO_LOOTA_BOSS_40h_Female_Dragon_DefeatPlayer_01	¡El Vuelo Crepuscular se alzará una vez más!	
VO_LOOTA_BOSS_40h_Female_Dragon_EmoteResponse_01	No nos pondremos de acuerdo.	
VO_LOOTA_BOSS_40h_Female_Dragon_EventPlayTwilightDrake_01	Hermano pequeño, no nos traiciones.	
VO_LOOTA_BOSS_40h_Female_Dragon_EventPlayTwilightWhelp_01	¡Vuelve al redil, pequeño!	
VO_LOOTA_BOSS_40h_Female_Dragon_HeroPower1_01	¡Alimentadme!	
VO_LOOTA_BOSS_40h_Female_Dragon_HeroPower2_01	Vuestra fuerza me alimenta.	
VO_LOOTA_BOSS_40h_Female_Dragon_HeroPower3_01	Mi raza prevalecerá.	
VO_LOOTA_BOSS_40h_Female_Dragon_HeroPower4_01	Abrazad la oscuridad.	
VO_LOOTA_BOSS_40h_Female_Dragon_Intro_01	Siento un gran poder. Acércate...	
VO_LOOTA_BOSS_41h_Male_Kobold_Death_01	<Muerte.>	
VO_LOOTA_BOSS_41h_Male_Kobold_DefeatPlayer_01	YO llevarme vela. ¡Tú no llevarte NADA!	
VO_LOOTA_BOSS_41h_Male_Kobold_EmoteResponse_01	¡Cerrar pico y luchar!	
VO_LOOTA_BOSS_41h_Male_Kobold_EventHornOfCenarius_01	¿Qué, QUÉ? ¡Tú pelear sucio!	
VO_LOOTA_BOSS_41h_Male_Kobold_HeroPower1_01	Todos... ¡Luchar!	
VO_LOOTA_BOSS_41h_Male_Kobold_HeroPower2_01	¡Guerra!	
VO_LOOTA_BOSS_41h_Male_Kobold_HeroPower3_01	¡A la carga!	
VO_LOOTA_BOSS_41h_Male_Kobold_Intro_01	¡Tú devolver vela!	
VO_LOOTA_BOSS_42h_Female_Furbolg_Armor10_01	Doy las gracias a los que me precedieron.	
VO_LOOTA_BOSS_42h_Female_Furbolg_Armor15_01	¡Los ancestros son poderosos!	
VO_LOOTA_BOSS_42h_Female_Furbolg_Armor20_01	Entrégame tus tesoros, ¡tu empeño es vano!	
VO_LOOTA_BOSS_42h_Female_Furbolg_Armor5_01	Lucho sin miedo.	
VO_LOOTA_BOSS_42h_Female_Furbolg_Death_01	Me uno... a mis ancestros...	
VO_LOOTA_BOSS_42h_Female_Furbolg_DefeatPlayer_01	¡Gloria a los espíritus de antaño! Mi escudo y mi salvación.	
VO_LOOTA_BOSS_42h_Female_Furbolg_EmoteResponse_01	A los espíritus de antaño... no les gustas nada de nada.	
VO_LOOTA_BOSS_42h_Female_Furbolg_Intro_01	¡Espíritus de antaño, os invoco!	
VO_LOOTA_BOSS_43h_Female_Djinn_Death_01	<Muerte.>	
VO_LOOTA_BOSS_43h_Female_Djinn_DefeatPlayer_01	¿No era eso lo que habías deseado?	
VO_LOOTA_BOSS_43h_Female_Djinn_EmoteResponse_01	¿Vas a desperdiciar un deseo para eso?	
VO_LOOTA_BOSS_43h_Female_Djinn_HeroAbility1_01	¿Qué deseas?	
VO_LOOTA_BOSS_43h_Female_Djinn_HeroAbility2_01	Uno... Dos... Tres...	
VO_LOOTA_BOSS_43h_Female_Djinn_HeroAbility3_01	¡Deseo concedido!	
VO_LOOTA_BOSS_43h_Female_Djinn_HeroAbilityHandFull1_01	Je, je, je.	
VO_LOOTA_BOSS_43h_Female_Djinn_HeroAbilityHandFull2_01	¿Demasiado para ti?	
VO_LOOTA_BOSS_43h_Female_Djinn_HeroAbilityHandFull3_01	Ten cuidado con lo que deseas.	
VO_LOOTA_BOSS_43h_Female_Djinn_Intro_01	Tus deseos son órdenes... Por un precio...	
VO_LOOTA_BOSS_44h_Female_Dragon_Death_01	<Muerte.>	
VO_LOOTA_BOSS_44h_Female_Dragon_DefeatPlayer_01	¡Ya se han ido! ¡Adiós!	
VO_LOOTA_BOSS_44h_Female_Dragon_EmoteResponse_01	¡Tú no mami!	
VO_LOOTA_BOSS_44h_Female_Dragon_Intro_01	¿Hora de comer?	
VO_LOOTA_BOSS_45h_Male_Gnome_Death_01	<Muerte.>	
VO_LOOTA_BOSS_45h_Male_Gnome_DefeatPlayer_01	Es un juego de dar y tomar. Yo me quedo con lo de tomar.	
VO_LOOTA_BOSS_45h_Male_Gnome_EmoteResponse_01	Este lugar... es como un laberinto de pasadizos serpenteantes. ¡Todos parecidos!	
VO_LOOTA_BOSS_45h_Male_Gnome_HeroPower1_01	Ah, brillante.	
VO_LOOTA_BOSS_45h_Male_Gnome_HeroPower2_01	Je, je.	
VO_LOOTA_BOSS_45h_Male_Gnome_HeroPower3_01	¡Cara! Gano yo.	
VO_LOOTA_BOSS_45h_Male_Gnome_HeroPower4_01	¡Cruz! Pierdes.	
VO_LOOTA_BOSS_45h_Male_Gnome_Intro_01	Tus bolsillos parecen pesar un quintal.	
VO_LOOTA_BOSS_46h_Male_Murloc_Death_01	<Muerte.>	
VO_LOOTA_BOSS_46h_Male_Murloc_DefeatPlayer_01	... ¿...? ¡...!	
VO_LOOTA_BOSS_46h_Male_Murloc_EmoteResponse_01	<Vomita.>	
VO_LOOTA_BOSS_46h_Male_Murloc_HeroPower1_01	...	
VO_LOOTA_BOSS_46h_Male_Murloc_HeroPower2_01	¿...?	
VO_LOOTA_BOSS_46h_Male_Murloc_HeroPower3_01	...	
VO_LOOTA_BOSS_46h_Male_Murloc_Intro_01	¡¡...!!	
VO_LOOTA_BOSS_49h_Male_Elemental_Death_01	<Muerte.>	
VO_LOOTA_BOSS_49h_Male_Elemental_DefeatPlayer_01	¡Muajaja!	
VO_LOOTA_BOSS_49h_Male_Elemental_EmoteResponse_01	Yo llevarme vela. Eso hago. A eso me dedico.	
VO_LOOTA_BOSS_49h_Male_Elemental_HeroPower1_01	Oscuridad...	
VO_LOOTA_BOSS_49h_Male_Elemental_HeroPower2_01	Huye...	
VO_LOOTA_BOSS_49h_Male_Elemental_HeroPower3_01	Muajajaja.	
VO_LOOTA_BOSS_49h_Male_Elemental_Intro_01	Tu luz está muriendo.	
VO_LOOTA_BOSS_50h_Male_Kobold_Death_01	<Muerte.>	
VO_LOOTA_BOSS_50h_Male_Kobold_DefeatPlayer_01	¡Oh, eh, esto ser potente!	
VO_LOOTA_BOSS_50h_Male_Kobold_EmoteResponse_01	NO. No admitir devoluciones.	
VO_LOOTA_BOSS_50h_Male_Kobold_EventKazakus_01	Kazakus, volver a por más, ¿eh?	
VO_LOOTA_BOSS_50h_Male_Kobold_EventMakePotion1_01	Oh, eso... saber mal.	
VO_LOOTA_BOSS_50h_Male_Kobold_EventMakePotion2_01	Sí, esto mal, muuucho mal.	
VO_LOOTA_BOSS_50h_Male_Kobold_EventMakePotion3_01	Sí, ja. ¿Tú querer un poco? Je. Pues no.	
VO_LOOTA_BOSS_50h_Male_Kobold_EventUsePotion1_01	¡Oh! Esto estar malo. ¡Tú probar!	
VO_LOOTA_BOSS_50h_Male_Kobold_EventUsePotion2_01	¡Sí! ¡Sí! ¡Ja! ¡Sí!	
VO_LOOTA_BOSS_50h_Male_Kobold_EventUsePotion3_01	¡Uy! Eso saber mal, pero mal bien.	
VO_LOOTA_BOSS_50h_Male_Kobold_Intro_01	Eh... eh... ¿Tú querer comprar hongos?	
VO_LOOTA_BOSS_51h_Male_Dwarf_Death_01	¡Buenas noches, Azeroth!	
VO_LOOTA_BOSS_51h_Male_Dwarf_DefeatPlayer_02	¡Gracias por los esbirros, colega!	
VO_LOOTA_BOSS_51h_Male_Dwarf_EmoteResponse_01	¿Te gusta interrumpir, eh?	
VO_LOOTA_BOSS_51h_Male_Dwarf_EventBoombox_01	¡Eh! ¡Que eso hace ruido!	
VO_LOOTA_BOSS_51h_Male_Dwarf_Intro_01	¡Quédate un rato y escucha!	
VO_LOOTA_BOSS_51h_Male_Dwarf_KillingBlowReady_01	¡Kóbolds y catacumbas!	
VO_LOOTA_BOSS_51h_Male_Dwarf_Song1A_01	Tu expedición tiene una misión:	
VO_LOOTA_BOSS_51h_Male_Dwarf_Song1B_01	Hallar riquezas sin igual.	
VO_LOOTA_BOSS_51h_Male_Dwarf_Song1C_01	Tesoros hay mil, la tierra es hostil...	
VO_LOOTA_BOSS_51h_Male_Dwarf_Song1D_01	... y los puentes no son de fiar.	
VO_LOOTA_BOSS_51h_Male_Dwarf_Song2A_01	Si les robas su luz, esa será tu cruz...	
VO_LOOTA_BOSS_51h_Male_Dwarf_Song2B_01	... mejor huye sin mirar atrás.	
VO_LOOTA_BOSS_51h_Male_Dwarf_Song2C_01	Ahora debes correr, trampas hay por doquier...	
VO_LOOTA_BOSS_51h_Male_Dwarf_Song2D_01	... y no tienes ni idea de dónde estás.	
VO_LOOTA_BOSS_51h_Male_Dwarf_Song3A_01	Se acercan a ti, ¡ya están aquí!	
VO_LOOTA_BOSS_51h_Male_Dwarf_Song3B_01	Y temes que esta sea tu tumba.	
VO_LOOTA_BOSS_51h_Male_Dwarf_Song3C_01	Buscabas botín, ¿será este tu fin?	
VO_LOOTA_BOSS_51h_Male_Dwarf_Song3D_01	¡Entre kóbolds y catacumbas!	
VO_LOOTA_BOSS_51h_Male_Dwarf_Steal_01	¡Vente pa'cá!	
VO_LOOTA_BOSS_51h_Male_Dwarf_Steal_02	Ven aquí.	
VO_LOOTA_BOSS_51h_Male_Dwarf_Steal_03	¡Es hora de festejar!	
VO_LOOTA_BOSS_51h_Male_Dwarf_StealDoomsayer_01	Peor. Empleado. De la historia.	
VO_LOOTA_BOSS_51h_Male_Dwarf_StealMinstrel_01	¡Hagamos un dueto!	
VO_LOOTA_BOSS_53h2_Female_Undead_Death_01	¡Qué paradoja!	
VO_LOOTA_BOSS_53h2_Female_Undead_DefeatPlayer_01	Sabía que ganaría. He visto mi futuro.	
VO_LOOTA_BOSS_53h2_Female_Undead_EmoteResponse_01	He dejado en ridículo a dragones Bronce. Tú no supones una amenaza.	
VO_LOOTA_BOSS_53h2_Female_Undead_EventManaDestroyed_01	¡Solo retrasas lo inevitable!	
VO_LOOTA_BOSS_53h2_Female_Undead_EventPlayerTimeWalk_01	¿Tú también has estado en la Isla Intemporal?	
VO_LOOTA_BOSS_53h2_Female_Undead_Intro_01	El tiempo puede deshacerse. Al igual que tú.	
VO_LOOTA_BOSS_53h2_Female_Undead_RitualPrep1_01	Llegará tu hora...	
VO_LOOTA_BOSS_53h2_Female_Undead_RitualPrep2_01	Mi poder se acumula.	
VO_LOOTA_BOSS_53h2_Female_Undead_RitualPrep3_01	Tic, tac...	
VO_LOOTA_BOSS_53h2_Female_Undead_TimeRewindPlayCard1_01	No dejo de superarme.	
VO_LOOTA_BOSS_53h2_Female_Undead_TimeRewindPlayCard2_01	He tenido un déjà vu.	
VO_LOOTA_BOSS_53h2_Female_Undead_TimeRewindPlayCard3_01	El tiempo está a mi favor.	
VO_LOOTA_BOSS_53h2_Female_Undead_TimeRewindPlayCard4_01	¡Quien controla el tiempo, controla el infinito!	
VO_LOOTA_BOSS_53h2_Female_Undead_TimeRewindPlayCard5_01	¡Ya es hora de acabar con esto!	
VO_LOOTA_BOSS_53h2_Female_Undead_TimeRewindStart1_01	¡Contempla mi descubrimiento!	
VO_LOOTA_BOSS_53h2_Female_Undead_TimeRewindStart2_01	¡Este es el momento!	
VO_LOOTA_BOSS_53h2_Female_Undead_TimeRewindStart3_01	¡Otra vez! ¡Otra vez!	
VO_LOOTA_BOSS_53h2_Female_Undead_TimeRewindStart4_01	¡Este es mi momento!	
VO_LOOTA_BOSS_54h_Female_Human_Death_01	¡No estaba preparada!	
VO_LOOTA_BOSS_54h_Female_Human_DefeatPlayer_01	¡Vale! Ya estoy lista.	
VO_LOOTA_BOSS_54h_Female_Human_EmoteResponse_01	Andaré por aquí. ¡Avisa cuando empiece la pelea!	
VO_LOOTA_BOSS_54h_Female_Human_Intro_01	<Canturrea de forma distraída.>	
VO_LOOTA_BOSS_54h_Female_Human_Intro_02	<Silba con satisfacción.>	
VO_LOOTA_BOSS_54h_Female_Human_Intro_03	<Silba con satisfacción.>	
VO_LOOTA_BOSS_54h_Female_Human_Intro_04	<Silba con satisfacción.>	
VO_LOOTA_BOSS_54h_Female_Human_Intro_07	<Silba con satisfacción.>	
VO_LOOTA_BOSS_54h_Female_Human_WakeUp_01	¡Oh! ¿Ya estamos luchando?	
VO_Maiden_Female_Titan_FinalMaidenEmoteResponse_01	No se tolerará tu comportamiento.	
VO_Maiden_Female_Titan_FinalMaidenEyeForAnEye_01	La justicia está servida.	
VO_Maiden_Female_Titan_FinalMaidenHeroPower_01	Expulsa tus pensamientos impuros.	
VO_Maiden_Female_Titan_FinalMaidenHumility_01	¡Eso es! ¡Arrodíllate y tal vez te perdone la vida!	
VO_Maiden_Female_Titan_FinalMaidenOpen_01	¿Has llamado a una agente de los titanes?	
VO_Maiden_Female_Titan_FinalMaidenTurn5_01	¡Somos eternos, ser abyecto!	
VO_Malchezaar_Male_Demon_Brawl_06	No habrás pensado que podías vencer.	
VO_Malchezaar_Male_Demon_EmoteParty_01	¡Malchezaar también quiere marcha!	
VO_Malchezaar_Male_Demon_FinalAltOpening_01	¡Ignorantes!	
VO_Malchezaar_Male_Demon_FinalMalchezaarDeath_01	¡No! ¡No! ¡Otra vez no!	
VO_Malchezaar_Male_Demon_FinalMalchezaarEmoteResponse_01	¡Yo seré tu fin!	
VO_Malchezaar_Male_Demon_FinalMalchezaarHeroPower_01	¡No solo os enfrentáis a Malchezaar, sino a todas las legiones bajo mi mando!	
VO_Malchezaar_Male_Demon_FinalMalchezaarJaraxxus_01	¡Eh, tú! ¡Dame mi invitación!	
VO_Malchezaar_Male_Demon_FinalMalchezaarMedivhSkin_01	¿Has venido disfrazado? Mmm... Yo también podría...	
VO_Malchezaar_Male_Demon_FinalMalchezaarSacrificialPact_03	¡Ja, ja, ja! ¡Eso no funciona contra un señor eredar auténtico!	
VO_Malchezaar_Male_Demon_FinalMalchezaarTurn1_01	El magus es poderoso, pero ¿cómo esperas hacer frente a un poder tan abrumador?	
VO_Malchezaar_Male_Demon_FinalMalchezaarTurn7_01	¡Oigo la música! ¡Las Medivas! ¡Y la fiesta! ¡Hoy es mi noche!	
VO_Malchezaar_Male_Demon_FinalThirdSequence_01	¿Otra vez en Karazhan? ¡Justo a tiempo para la fiesta!	
VO_Malchezaar_Male_Demon_FinalThirdSequence_04	¡Apártate, ignorante!	
VO_Malchezaar_Male_Demon_PrologueEmoteResponse_01	¡Qué ignorante!	
VO_Malchezaar_Male_Demon_PrologueHeroPower_01	¡Tengo acceso a todas las dimensiones y realidades!	
VO_Malchezaar_Male_Demon_PrologueOpen_01	¿Dónde está mi invitación?	
VO_Malchezaar_Male_Demon_PrologueTurn1_04	¿Has olvidado invitarme? ¡Soy un príncipe de los eredar!	
VO_Malchezaar_Male_Demon_PrologueTurn11_02	¿Has invitado a Jaraxxus? ¿A ese don nadie?	
VO_Malchezaar_Male_Demon_PrologueWin_01	¡Tú te vienes conmigo!	
VO_Mediva_01_Female_Blood Elf_AranSpell_04	Oh, brrr...	
VO_Mediva_01_Female_Blood Elf_ChessEmoteOops_06	Oh-oh...	
VO_Mediva_01_Female_Blood Elf_PrologueTurn5_06	¡Medivas!	
VO_Mediva_02_Female_Draenei_JulianneDeadlyPoison_02	Trágico...	
VO_Mediva_02_Female_Draenei_PrologueTurn5_05	¿Sí?	
VO_Mediva_03_Male_Night Elf_AranHeroPower_01	¡Arde, baby, arde!	
VO_Mediva_03_Male_Night Elf_CuratorBeasts_04	Salud, baby.	
VO_Mediva_03_Male_Night Elf_PrologueTurn5_01	¿Has llamado?	
VO_Medivas_Multiple_Multiple_CroneLionTigerBear_01	¡Cielos!	
VO_Medivas_Multiple_Multiple_IllhoofWounded_01	Mmm... Tengo miedito...	
VO_Medivas_Multiple_Multiple_NetherspiteTurn1_01	¡Rayos!	
VO_Medivh_Male_Human_EmoteGreetings_01	¿Qué haces tú aquí?	
VO_Medivh_Male_Human_EmoteOops_01	¿Ese era tu plan?	
VO_Medivh_Male_Human_EmoteSorry_01	Ah, no ha funcionado...	
VO_Medivh_Male_Human_EmoteThanks_01	Eres muy amable.	
VO_Medivh_Male_Human_EmoteThreaten_01	¡No tienes ninguna posibilidad!	
VO_Medivh_Male_Human_EmoteWellPlayed_01	Buen intento, demonio.	
VO_Medivh_Male_Human_EmoteWow_01	¡Ja, ja, ja, ja, ja! ¡Increíble!	
VO_Medivh_Male_Human_FinalMalchezaarTurn5_01	Un trabajo excelente, Moroes. ¡La fiesta va como la seda!	
VO_Medivh_Male_Human_FinalMalchezaarWin_01	¡Bien hecho! ¡Vamos! ¡Vamos a la fiesta!	
VO_Medivh_Male_Human_FinalMedivhMedivhSkin_01	¡Un momento! ¿Eres mi yo del futuro? ¿Qué tal estuvo esta fiesta? Increíble, ¿a que sí?	
VO_Medivh_Male_Human_FinalThirdSequence_01	¡Una visita! Ocúpate del demonio, ¡que a mí me esperan en la fiesta!	
VO_Medivh_Male_Human_FinalThirdSequence_02	¿Te ha dejado sin cartas? Si lo deseas, usa los portales.	
VO_Medivh_Male_Human_FinalThirdSequence_03	Toma mi báculo y controla los portales, ¡pero no me lo rayes!	
VO_Medivh_Male_Human_PrologueDeath_02	¿Cómo? Imposible...	
VO_Medivh_Male_Human_PrologueHeroPower_01	¡Pero no a esta fiesta!	
VO_Medivh_Male_Human_PrologueOpen_01	Oh... ¿Otra vez tú?	
VO_Medivh_Male_Human_PrologueTurn1_02	¿Después de la última vez? ¡Aún estamos arreglando los destrozos!	
VO_Medivh_Male_Human_PrologueTurn11_01	¿Lo has oído cantar? ¡Es el amo del karaoke!	
VO_Medivh_Male_Human_PrologueTurn3_02	Moroes, ve a comprobar el ajedrez. Los invitados de verdad están al caer.	
VO_Medivh_Male_Human_PrologueTurn9_01	¡Los globos! Moroes, ¡se nos han olvidado!	
VO_Medivh_Male_Human_PrologueWin_01	¡Y no vuelvas, demonio!	
VO_Medivh_Male_Human_Wing0Intro_01	Hemos dado vida a la vajilla, ensayado la obra y preparado la Sala de las Fieras. ¡Esta noche será memorable!	
VO_Medivh_Male_Human_Wing4Win_01	¡Ven conmigo! ¡Vamos a disfrutar de la fiesta!	
VO_Mirror_Male_Mirror_MirrorDeath_01	¡Eh, has hecho trampa! ¡Quiero revancha!	
VO_Mirror_Male_Mirror_MirrorEmoteResponse_01	¡Eso tú!	
VO_Mirror_Male_Mirror_MirrorFirstCard_01	Jo, jo... ¡Menudo mazo te ha tocado!	
VO_Mirror_Male_Mirror_MirrorMedivhSkin_01	¡Oh, señor Medivh! Tan elegante como... ¡¿Qué?! ¡Un momento! ¡Tú no eres Medivh!	
VO_Mirror_Male_Mirror_MirrorMirrorImage_01	¡Eh, esa es mi carta favorita! ¿Cuál es la tuya? ¿El Furibundo de magma?	
VO_Mirror_Male_Mirror_MirrorOpen_02	¡QUÉ PASSSSAAAAA!	
VO_Mirror_Male_Mirror_MirrorTurn1_01	¡Sois tan feos que voy a llorar!	
VO_Mirror_Male_Mirror_MirrorTurn3_01	Dime, espejo glorioso: en este reino, ¿quién es el más hermoso?	
VO_Mirror_Male_Mirror_MirrorTurn3_03	¡Tú no, carcamal!	
VO_Mirror_Male_Mirror_MirrorTurn5_02	¿Nefarius? Más bien "Ne-feo-rius", ¿no? ¡Ju, ju, juu!	
VO_Mirror_Male_Mirror_MirrorWellPlayedResponse_01	¡Ojalá pudiera decirte lo mismo! ¡BAM!	
VO_Moroes_Male_Human_AranTurn1_01	Te presento a Aran, el fantasma cascarrabias.	
VO_Moroes_Male_Human_AranTurn9_04	Los dragones han engullido el bufé. ¡Ahora están mirando de reojo a los múrlocs!	
VO_Moroes_Male_Human_AranWin_01	¡El portal está en la siguiente sala! ¡Llegamos a tiempo!	
VO_Moroes_Male_Human_ChessForfeit_02	Te has quedado sin piezas, así que la partida termina aquí.	
VO_Moroes_Male_Human_ChessTurn1_03	Aquí, las piezas atacan automáticamente al final de tu turno.	
VO_Moroes_Male_Human_ChessTurn3_01	Si una pieza se encuentra entre dos enemigos, ¡atacará a los dos!	
VO_Moroes_Male_Human_ChessTurn5_01	Para ganar hay que saber posicionarse. ¡Aprovecha los ataques dobles!	
VO_Moroes_Male_Human_ChessTurn7_01	¡Los demás invitados esperan en la cola! Ya casi estamos en el teatro, ¡pero hay que darse prisa!	
VO_Moroes_Male_Human_ChessTurn7_02	Te quedan pocas piezas. Si se te acaban, perderás la partida.	
VO_Moroes_Male_Human_ChessTurn7_03	Te quedan pocas piezas. Si se te acaban, perderás la partida.	
VO_Moroes_Male_Human_ChessWin_01	¡Excelente! ¡Vamos al teatro!	
VO_Moroes_Male_Human_CroneTurn5_02	El mayordomo Executus está abajo. ¿Le digo que ha venido antes de lo previsto?	
VO_Moroes_Male_Human_CroneWin_01	¡Por fin! ¡Vamos a liberar al mago!	
VO_Moroes_Male_Human_CuratorTurn3_01	¡El Curator está confuso! ¡Detenlo antes de que libere a todas las criaturas!	
VO_Moroes_Male_Human_CuratorWin_01	Muy bien, un retoque por aquí... ¡Y como nuevo!	
VO_Moroes_Male_Human_EndWing1_01	¡Maravilloso! ¡El teatro se encuentra ahí arriba! ¡Seguro que Barnes nos deja pasar un momento!	
VO_Moroes_Male_Human_FinalAltTurn5_01	Vaya... Cuántos portales... ¿Me pregunto qué habrá en este?	
VO_Moroes_Male_Human_FinalMaidenTurn1_01	Lo siento. Si te ocupas de ella, encontraré los controles adecuados.	
VO_Moroes_Male_Human_FinalMaidenTurn7_03	Ah, el mundo de los tentáculos. No es lo que buscamos.	
VO_Moroes_Male_Human_FinalNazraTurn7_02	¡Ocúpate de la orco para que podamos abrir otro portal!	
VO_Moroes_Male_Human_FinalSecondSequence_01	¡Excelente! Ahora, veamos si funciona...	
VO_Moroes_Male_Human_FInalStartSequence_01	Mmm... A ver... Tal vez... ¿este?	
VO_Moroes_Male_Human_FinalThirdSequence_01	¡Es este!	
VO_Moroes_Male_Human_FinalTurn1_02	¡Ups! Ese no era. Tú lucha y yo sigo buscando.	
VO_Moroes_Male_Human_IllhoofKilrekResponse_01	¿Qué están intentando invocar?	
VO_Moroes_Male_Human_JulianneTurn5_01	¡Barnes, déjanos pasar! ¡Hay que encontrar a Medivh antes de que la fiesta sea un fiasco!	
VO_Moroes_Male_Human_JulianneTurn9_02	¡Ha llegado Illidan! ¡No estamos preparados!	
VO_Moroes_Male_Human_MedivhSkinResponse_01	¿Un disfraz de Medivh? ¡Vaya, el parecido es asombroso!	
VO_Moroes_Male_Human_MirrorTurn3_01	Mmmm...	
VO_Moroes_Male_Human_MirrorTurn5_01	Lord Nefarius llegará pronto. Tiemblo solo de pensar en cómo reaccionará...	
VO_Moroes_Male_Human_MirrorWin_02	¡Magnífico! ¡Las escaleras del teatro están muy cerca!	
VO_Moroes_Male_Human_NetherspiteTurn1_01	Esos haces potencian al dragón. ¡Usa esbirros para bloquearlos!	
VO_Moroes_Male_Human_NetherspiteTurn5_01	¡Dinos dónde está Medivh!	
VO_Moroes_Male_Human_NetherspiteTurn7_01	¡Los necesitamos! ¡Los invitados están lanzando libros a la piscina de maná!	
VO_Moroes_Male_Human_NetherspiteWin_01	¡Genial! Ahora, a ver si recuerdo cómo funciona esto...	
VO_Moroes_Male_Human_NightbaneTurn3_01	Curator, ¡debemos rescatar a Medivh!	
VO_Moroes_Male_Human_NightbaneTurn7_01	La Liga de Expedicionarios ha llegado. ¡RENO, NO TOQUES LA VAJILLA!	
VO_Moroes_Male_Human_PrologueTurn11_01	Ejem... Y no incendió la biblioteca...	
VO_Moroes_Male_Human_PrologueTurn5_03	Señor, las Medivas están listas. Barnes está supervisando sus ensayos.	
VO_Moroes_Male_Human_PrologueTurn7_01	Yo echaría un vistazo fuera, señor. Hay jefes de banda matándose por una invitación.	
VO_Moroes_Male_Human_PrologueTurn9_02	Señor, horrorizan a los múrlocs. Aún recuerdo la semana pasada...	
VO_Moroes_Male_Human_PrologueWin_02	Esto no me gusta. No me gusta nada.	
VO_Moroes_Male_Human_SilverwareResponse_01	Oh, ese era una reliquia.	
VO_Moroes_Male_Human_SilverwareTurn3_02	¡La vajilla se ha unido contra nosotros! ¡Nos ha acorralado!	
VO_Moroes_Male_Human_SilverwareWin_01	Ay, menudo desastre.	
VO_Moroes_Male_Human_Wing1Intro_02	Soy Moroes, el administrador de Karazhan. Te necesito, ¡Medivh ha desaparecido! ¡Los portales de lo alto de la torre servirán para salvarlo a él y a la fiesta!	
VO_Moroes_Male_Human_Wing1Win_01	¡Buen trabajo! ¡A este paso, llegaremos arriba a tiempo para salvar la fiesta!	
VO_Moroes_Male_Human_Wing2Win_01	¡Adelante! Arriba, el Curator custodia la Sala de las Fieras. Espero que no se haya averiado...	
VO_Moroes_Male_Human_Wing3Open_02	El Curator custodia la Sala de las Fieras, donde verás las criaturas más exóticas de Azeroth. ¡Más allá se encuentran los aposentos del amo y el portal para salvarlo!	
VO_Moroes_Male_Human_Wing3Win_02	¡Ya falta poco! ¡Salvemos a Medivh antes de que la fiesta se convierta en un campo de batalla!	
VO_Moroes_Male_Human_Wing4Intro_01	¡Por fin! ¡Ya hemos llegado! ¡Busca el portal apropiado y rescata a Medivh!	
VO_Moroes_Male_Human_Wing4Win_01	No me creo que la fiesta haya empezado a tiempo. ¿Haces algo la semana que viene? Es el cumpleaños de Medivh y me iría bien una ayuda.	
VO_Moroes_Male_Human_WolfClaws_03	Mmm... No sé yo...	
VO_NAX1_01_CARD_02	Solo un bocado...	
VO_NAX1_01_DEATH_05	¿Por qué? ¡Oh! ¿Por qué?	
VO_NAX1_01_EMOTE_04	¡Pero si habla!	
VO_NAX1_01_HP_03	Qué bocado tan sabroso.	
VO_NAX1_01_START_01	Te doy la bienvenida a mi sala.	
VO_NAX10_01_DEATH_LINE_03	¿Qué pasó con Remendejo?	
VO_NAX10_01_EMOTE1_04	¿Hora de jugar?	
VO_NAX10_01_EMOTE2_05	¡Sí! ¡Jugar! ¡Jugar!	
VO_NAX10_01_HP_02	¿Se acabó el juego?	
VO_NAX10_01_START_01	¡Remendejo quiere jugar!	
VO_NAX11_01_CARD_03	Moco.	
VO_NAX11_01_DEATH_05	*ugh uh ahoh gowr grrrlrrlrrlaaahhh*	
VO_NAX11_01_EMOTE_04	No hablar.	
VO_NAX11_01_HP_02	Peste.	
VO_NAX11_01_START_01	Carne.	
VO_NAX12_01_CARD_01	*Rugido*	
VO_NAX12_01_DEATH_01	*Gemido*	
VO_NAX12_01_EMOTE_01	*Gruñido*	
VO_NAX12_01_EMOTE_02	*Grrr*	
VO_NAX12_01_EMOTE_03	*Grrroooooo*	
VO_NAX12_01_HP_01	*Roooar CHOMP*	
VO_NAX12_01_START_01	*Gruñido*	
VO_NAX13_01_DEATH_LINE_03	Gracias...	
VO_NAX13_01_EMOTE_04	¡Matar!	
VO_NAX13_01_HP_02	¡Muere ahora!	
VO_NAX13_01_START_01	Debo... obedecer...	
VO_NAX14_01_CARD_01	*RrrrrAAAHH*	
VO_NAX14_01_DEATH_01	*Raaaaar*	
VO_NAX14_01_EMOTE_01	*Rrrr ¡Rrahhh!*	
VO_NAX14_01_EMOTE_02	*Grraaaaah*	
VO_NAX14_01_EMOTE_03	*Raaaaar*	
VO_NAX14_01_HP_01	*Raaarrr*	
VO_NAX14_01_START_01	*RAAAARRR*	
VO_NAX15_01_BIGGLES_32	¡No! ¡Yo te maldigo, insolente!	
VO_NAX15_01_DEATH_LINE_08	¡Este no es el fin! Aún queda el modo heroico...	
VO_NAX15_01_DEATH_LINE2_09	¡Noooooooooooooooooooooo!	
VO_NAX15_01_EMOTE_HELLO_26	¿Siempre saludas a los que quieren matarte?	
VO_NAX15_01_EMOTE_OOPS_29	Vaya.	
VO_NAX15_01_EMOTE_SORRY_28	No importa, todos cometemos errores.	
VO_NAX15_01_EMOTE_THANKS_27	De... ¿nada?	
VO_NAX15_01_EMOTE_THREATEN_30	¡Oh, me muero de miedo!	
VO_NAX15_01_EMOTE_WP_25	Claro que he jugado bien. ¡Soy el maldito Kel'Thuzad!	
VO_NAX15_01_HP_07	¡Congelaré la sangre que corre por tus venas!	
VO_NAX15_01_HP2_05	Ahora tu alma está ligada a mí.	
VO_NAX15_01_HP3_06	No habrá escapatoria.	
VO_NAX15_01_HURRY_31	Mi paciencia tiene un límite.	
VO_NAX15_01_PHASE2_10	¡Ignorante! ¡Has debilitado tus poderes! 	
VO_NAX15_01_PHASE2_ALT_11	¡No! Se acabó tu turno. Ahora es MI turno.	
VO_NAX15_01_RESPOND_ANDUIN_24	¡Qué ingenuo! ¿Acaso no recuerdas lo que le ocurrió a Uther?	
VO_NAX15_01_RESPOND_GARROSH_15	¿Ah, sí? Muerte, entonces.	
VO_NAX15_01_RESPOND_GARROSH_ALT_16	¿Es una pregunta trampa? ¡Solo hay muerte para ti!	
VO_NAX15_01_RESPOND_GULDAN_22	Bueno, las almas tienen que ser de alguien.	
VO_NAX15_01_RESPOND_JAINA_23	De eso nada. ¡Tú irrumpiste en mi ciudad flotante!	
VO_NAX15_01_RESPOND_MALFURION_ALT_21	¿Los bosques? ¿Y qué estás haciendo en Naxxramas?	
VO_NAX15_01_RESPOND_REXXAR_19	Pues empieza a correr.	
VO_NAX15_01_RESPOND_THRALL_17	¿Luchas por un martillo? Pues vale.	
VO_NAX15_01_RESPOND_UTHER_14	Y yo lucharé con esbirros enormes y hechizos devastadores. ¡Buena suerte!	
VO_NAX15_01_RESPOND_VALEERA_18	Así. Lo. Haré.	
VO_NAX15_01_START_13	Por fin nos encontramos.	
VO_NAX15_01_SUMMON_ADDS_12	¡Os devuelvo la libertad, esbirros!	
VO_NAX2_01_CARD_02	¡Matadlos en el nombre del maestro!	
VO_NAX2_01_CUSTOM_03	¡Has fallado!	
VO_NAX2_01_DEATH_LINE_05	¡El maestro me vengará!	
VO_NAX2_01_EMOTE_06	¡Ja, ja, ja!	
VO_NAX2_01_HP_04	¡Arrodíllate ante mí, sabandija!	
VO_NAX2_01_START_01	¡Mis acólitos me sirven sin hacer preguntas!	
VO_NAX3_01_CARD_01	*Grghhghgh*	
VO_NAX3_01_DEATH_01	*Hssss*	
VO_NAX3_01_EMOTE_01	*Hssss*	
VO_NAX3_01_EMOTE_02	*Hssss*	
VO_NAX3_01_EMOTE_03	*Hssss*	
VO_NAX3_01_EMOTE_04	*Hssss*	
VO_NAX3_01_EMOTE_05	*Hssss*	
VO_NAX3_01_HP_01	*Hssss*	
VO_NAX3_01_START_01	*Correteo*	
VO_NAX4_01_CARD_03	¡No respirarás más!	
VO_NAX4_01_DEATH_LINE_04	¡Serviré a mi maestro... en la muerte!	
VO_NAX4_01_EMOTE_06	¡Muere, intruso!	
VO_NAX4_01_HP_02	¡Levantaos, soldados míos! ¡Levantaos y luchad una vez más!	
VO_NAX4_01_START_01	Otra alma para la "colección".	
VO_NAX5_01_CARD_03	¡Te abriré la MENTE!	
VO_NAX5_01_DEATH_LINE_04	Tendría que haberme duchado...	
VO_NAX5_01_EMOTE_05	No tengo tiempo para tonterías.	
VO_NAX5_01_HP_02	¡Bailad, marionetas!	
VO_NAX5_01_START_01	¿Crees que aquí estás a salvo?	
VO_NAX6_01_CARD_03	El fin está cerca.	
VO_NAX6_01_DEATH_LINE_04	*Rruuuhhhh*	
VO_NAX6_01_EMOTE_05	Malgastas tu aliento.	
VO_NAX6_01_HP_02	Ahora me perteneces.	
VO_NAX6_01_START_01	Te veo.	
VO_NAX7_01_CARD_03	Deberías haberte quedado en casa.	
VO_NAX7_01_DEATH_LINE_04	Una muerte con honor...	
VO_NAX7_01_EMOTE_05	¡Ja! ¡Aún estoy calentando!	
VO_NAX7_01_HP_02	¡Yiiaaa!	
VO_NAX7_01_START_01	No... ¡No! ¡Mis estudiantes! ¡Devuélvemelos!	
VO_NAX8_01_CARD_02	Puedes matar a mis esbirros… pero sus almas te harán una visita.	
VO_NAX8_01_CUSTOM_03	¡Jajaja! ¡Pobre infeliz! ¡Soy el Cosechador de almas!	
VO_NAX8_01_CUSTOM2_04	¡Los muertos regresan!	
VO_NAX8_01_DEATH_LINE_05	Es... mi... fin...	
VO_NAX8_01_EMOTE1_06	Tu estupidez te ha llevado hasta la muerte.	
VO_NAX8_01_EMOTE2_07	Has hecho caso omiso de poderes más allá de tu entendimiento.	
VO_NAX8_01_EMOTE3_08	Has intentado invadir el reino del Cosechador con todas tus fuerzas.	
VO_NAX8_01_EMOTE4_09	Ahora solo te queda una salida...	
VO_NAX8_01_EMOTE5_10	Ir al menú de opciones y darle a "Rendirse".	
VO_NAX8_01_START_01	Mis esbirros nunca mueren de verdad.	
VO_NAX9_01_CUSTOM_02	Basta de palabrería. ¡Que vengan!	
VO_NAX9_01_DEATH_LINE_03	¡No! ¡Necesito más tiempo!	
VO_NAX9_01_EMOTE_04	¿Quieres morir?	
VO_NAX9_01_START_01	Haremos polvo tus huesos.	
VO_NAX9_02_CUSTOM_01	¡Invasor! ¡Huye, ahora que aún puedes!	
VO_NAX9_03_CUSTOM_01	Vamos, Zeliek. Nos divertiremos un rato.	
VO_NAX9_04_CUSTOM_01	¡Venga, miserable llorica!	
VO_Nazra_Female_Orc_FinalNazraChogall_02	¿Qué hace aquí el Martillo Crepuscular? 	
VO_Nazra_Female_Orc_FinalNazraDeath_01	Por la Horda...	
VO_Nazra_Female_Orc_FinalNazraEmoteResponse_01	¡Nazra te aplastará!	
VO_Nazra_Female_Orc_FinalNazraGrom_01	¡¿Grommash?! ¡Cuánto tiempo!	
VO_Nazra_Female_Orc_FinalNazraHeroPower_01	¡Nazra gobernará este insignificante mundo!	
VO_Nazra_Female_Orc_FinalStartSequence_01	¡Tiembla ante la Horda!	
VO_NEFARIAN_ATRAMEDES_DEATH_76	Has matado a un dragón ciego. ¡Qué vergüenza!	
VO_NEFARIAN_BARON_GEDDON_DEAD_40	Estamos cerca. Sí. ¡Sí!	
VO_NEFARIAN_CHROMAGGUS_DEAD_63	En realidad Chromaggus era mi esbirro más débil. ¿Te sentías indestructible?	
VO_NEFARIAN_CHROMAGGUS1_59	¡Le puse dos cabezas porque pensé que así podría morder el doble!	
VO_NEFARIAN_CHROMAGGUS2_60	¡Infundí en él los poderes de todos los Vuelos! Es perfecto.	
VO_NEFARIAN_CHROMAGGUS3_61	Buen trabajo, Chromaggus. Buen chico.	
VO_NEFARIAN_CHROMAGGUS4_62	¿Se empieza a llenar la mano? ¡Ja, ja, ja, ja! ¡Buen perro!	
VO_NEFARIAN_COREN_DEAD_28	El Tragapenas, vaya nombre.	
VO_NEFARIAN_DRAKKISATH_DEAD_50	Estoy empezando a cabrearme.	
VO_NEFARIAN_DRAKKISATH_RESPOND_48	Sí, Drakkisath. Mortal, ¡sigues en el lado equivocado de la montaña!	
VO_NEFARIAN_DRAKKISATH1_49	Ve a jugar en el modo con rango. Esta aventura no está hecha para ti.	
VO_NEFARIAN_GARR_DEAD1_38	Deberías llevarte un trozo de Garr y lanzarlo al charco de lava de Ragnaros. Eso lo haría feliz.	
VO_NEFARIAN_GARR2_35	Ten cuidado con esas cosas rocosas, ¿quieres?	
VO_NEFARIAN_GARR3_36	Procura no explotar. Aún tienes que deshacerte de un señor elemental.	
VO_NEFARIAN_GARR4_37	Me gusta ver cómo trabajas, ¿sabes?	
VO_NEFARIAN_GRIMSTONE_DEAD1_30	¡Sigue así y pronto expulsaremos a Ragnaros de esta montaña!	
VO_NEFARIAN_HEROIC_BLOCK_77	No en modo heroico.	
VO_NEFARIAN_MALORIAK_DEATH_PT1_72	¡Felicidades! ¡Menudo logro más increíble!	
VO_NEFARIAN_MALORIAK_DEATH_PT2_73	Creo que te buscaré un nuevo nombre para conmemorar este momento.	
VO_NEFARIAN_MALORIAK_DEATH_PT3_74	"Asesino de esbirros decepcionantes, incompetentes y estúpidos". Sí, suena bien.	
VO_NEFARIAN_MALORIAK_TURN2_71	Maloriak, intenta no perder, ¿está claro?	
VO_NEFARIAN_NEF_MISSION_66	¡Eso es trampa! ¡No lo toleraré!	
VO_NEFARIAN_NEF2_65	¡No! ¡No! ¡Te destruiré!	
VO_NEFARIAN_OMNOTRON_DEAD_69	Me has ahorrado importantes costes de reparación. Gracias.	
VO_NEFARIAN_OMOKK_DEAD_46	¡Esto no tiene sentido!	
VO_NEFARIAN_OMOKK1_44	¿Qué haces aquí? Ragnaros ha muerto. Deberías estar celebrándolo con tus amigos.	
VO_NEFARIAN_OMOKK2_45	Estoy confuso. Ragnaros ya está muerto. Tu misión ha terminado. Vete a casa.	
VO_NEFARIAN_RAZORGORE_DEAD_55	¡Esos huevos estaban destinados a grandes experimentos!	
VO_NEFARIAN_REND_DEAD_53	Te estás metiendo con el dragón equivocado, mortal.	
VO_NEFARIAN_REND1_52	¡Hasta este orco sabe que lo estás haciendo mal!	
VO_NEFARIAN_THAURISSAN_DEAD_32	¡Deberías haber acabado con el otro enano! ¡Mátalos a todos!	
VO_NEFARIAN_THAURISSAN_DEAD2_33	¿Has conseguido acabar con ambos enanos? Impresionante.	
VO_NEFARIAN_VAEL_DEAD_57	¡Ja! ¡Has matado a uno de los buenos! ¿¿Te vas a poner a llorar??	
VO_Netherspite_Male_Dragon_NetherspiteAngryChicken_01	¡¿Otra vez tú?! ¡¿Por qué siempre te metes en mis portales?!	
VO_Netherspite_Male_Dragon_NetherspiteDeath_01	Mi trabajo...	
VO_Netherspite_Male_Dragon_NetherspiteEmoteResponse_01	¿Osas retar a un dragón en su laboratorio?	
VO_Netherspite_Male_Dragon_NetherspiteEmpowerment_01	¡Hay tantos mundos!... ¡Y tanto que aprender!	
VO_Netherspite_Male_Dragon_NetherspiteOpen_01	¿Quién se atreve a molestarme?	
VO_Netherspite_Male_Dragon_NetherspiteShadowBreath_01	¡Fuera!	
VO_Netherspite_Male_Dragon_NetherspiteTurn12_01	Mmm... Si 12 múrlocs salen del portal rojo a las cuatro y C'Thun llega a las cinco... Mmm... Debo tener en cuenta...	
VO_Netherspite_Male_Dragon_NetherspiteTurn3_02	¡Dejad en paz mis experimentos!	
VO_Netherspite_Male_Dragon_NetherspiteTurn5_01	¡Los portales no se tocan! ¡Están modulados a la perfección!	
VO_Netherspite_Male_Dragon_NetherspiteTurn7_01	Esa fiesta parece divertida. ¿Por qué no vas y dejas mis portales en paz?	
VO_Netherspite_Male_Dragon_NetherspiteUnstablePortal_01	Interesante... Las fluctuaciones resonantes revelan inestabilidades.	
VO_Netherspite_Male_Dragon_NetherspiteUnstablePortal_02	Qué interesante... Detecto inestabilidades.	
VO_Nightbane_Roar	*RUGIDO*	
VO_PrinceKeleseth_Male_Vampire_ResponseLanaThel_01	¡Mi reina!	
VO_PrinceTaldaram_Male_Vampire_ResponseLanaThel_01	Mi reina... Tengo sed.	
VO_PrinceValanar_Male_Vampire_ResponseLanaThel_01	¡Reina Lana’thel!	
VO_RAGNAROS_GRIMSTONE_DEAD2_66	¡YO SÍ QUE TE EXPULSARÉ A TI, LAGARTIJA!	
VO_RAGNAROS_NEF1_71	PARECE QUE NECESITAS UN POCO DE AYUDA.	
VO_RAGNAROS_NEF3_72	¡LA VENGANZA SERÁ MÍA! ¡QUE EL FUEGO TE PURIFIQUE!	
VO_RAGNAROS_NEF4_73	ENVIARÉ A MIS ESBIRROS PARA QUE TE DESTRUYAN, ALANEGRA.	
VO_RAGNAROS_NEF5_74	¡HACED CENIZAS A ESE DRAGÓN PRESUNTUOSO!	
VO_RAGNAROS_NEF6_75	¡UN REGALO DE LAS TIERRAS DE FUEGO!	
VO_RAGNAROS_NEF7_76	¡NO PUEDES APAGAR LAS LLAMAS DEL SEÑOR DEL FUEGO!	
VO_RAGNAROS_NEF8_77	¡TENDRÉ MI VENGANZA, DRAGÓN!	
VO_Rakanishu_Male_Elemental_CastSpell1_01	No llevarte... ¡a MÍ!	
VO_Rakanishu_Male_Elemental_CastSpell2_01	¡Que el fuego os purifique!	
VO_Rakanishu_Male_Elemental_CastSpell3_01	¡Muere!	
VO_Rakanishu_Male_Elemental_CastSpell4_01	¡Por Rafaam!	
VO_Rakanishu_Male_Elemental_CastSpell5_01	¡Todos arderéis!	
VO_Rakanishu_Male_Elemental_EventRagnaros_02	¡Mi héroe!	
VO_Rakanishu_Male_Elemental_Intro_01	¡Destrucción! ¡Consigue el tesoro!	
VO_SilverwareGolem_Male_SilverwareGolem_SilverwareDeath_02	Pagarás los platos rotos...	
VO_SilverwareGolem_Male_SilverwareGolem_SilverwareEmoteResponse_01	¡A fregar!	
VO_SilverwareGolem_Male_SilverwareGolem_SilverwareForkedLightning_01	¿Te gustan los tenedores? ¡Porque tengo tenedores!	
VO_SilverwareGolem_Male_SilverwareGolem_SilverwareHeroPower_01	¡A poner la mesa!	
VO_SilverwareGolem_Male_SilverwareGolem_SilverwareKnifeJuggler_01	¡Oh, juego de cuchillos!	
VO_SilverwareGolem_Male_SilverwareGolem_SilverwareOpen_01	¡Me gusta bailar!	
VO_SilverwareGolem_Male_SilverwareGolem_SilverwarePlateTossing_01	¡Plato para ti! ¡Plato para mí! ¡Plato para todos!	
VO_TB_MEDIVA1_001	¡Arde!	
VO_TB_MEDIVA1_002	¡Cuidado!	
VO_TB_MEDIVA1_003	¡Oh, Tito!	
VO_TB_MEDIVA1_004	Salud.	
VO_TB_MEDIVA1_005	¡Bestial!	
VO_TB_MEDIVA1_006	Cuchi-cuchi.	
VO_TB_MEDIVA1_007	¡No! Veneno no.	
VO_TB_MEDIVA1_008	¡Brillante!	
VO_TB_MEDIVA1_009	¿Querías algo?	
VO_TB_MEDIVA2_001	¡Qué poder!	
VO_TB_MEDIVA2_002	Oscura.	
VO_TB_MEDIVA2_003	Uh, qué frío...	
VO_TB_MEDIVA2_004	¡Oh, no! ¡Una trampa!	
VO_TB_MEDIVA2_005	¡No, no, no puedo mirar!	
VO_TB_MEDIVA2_006	Qué... cuqui.	
VO_TB_MEDIVA2_007	Me encantan los diablillos.	
VO_TB_MEDIVA2_008	¡Cuánta luz!	
VO_TB_MEDIVA2_009	¡Achís! ¡Ajjj!	
VO_TB_MEDIVA2_010	¿Has llamado?	
VO_TB_MEDIVA3_001	¡Caliente!	
VO_TB_MEDIVA3_002	Puuuro hielo.	
VO_TB_MEDIVA3_003	¡A la oscura oscuridad!	
VO_TB_MEDIVA3_004	¡Una trampa!	
VO_TB_MEDIVA3_005	¡Y vaya bestias!	
VO_TB_MEDIVA3_006	¡Le sobran mascotas!	
VO_TB_MEDIVA3_007	Oh, no, pupita.	
VO_TB_MEDIVA3_008	Es veneno, pero huele a canela.	
VO_TB_MEDIVA3_009	¡Y, ahora, las Medivas!	
VO_TB_MEDIVA3_010	¡Sí!	
VO_Terenas_Male_Human_ICCDruidVictory_01	Antes fomentaba la vida cuidando de la naturaleza de Azeroth. Ahora, Malfurion el Pestilente preserva el equilibrio natural protegiendo un jardín yerto.	
VO_Terenas_Male_Human_ICCHunterVictory_01	Rexxar liberó las almas atrapadas por el Rey Exánime. Tomó una flecha negra del carcaj. «¡Vamos, Misha!», ordenó. «Comienza la caza...».	
VO_Terenas_Male_Human_ICCMageVictory_01	La recién coronada Exánime de Escarcha contempló sus dominios. Legiones de no-muertos se adhirieron a su poder. Ni siquiera notó cómo se le helaba la sangre.	
VO_Terenas_Male_Human_ICCPaladinVictory_01	El paladín, tan noble en otro tiempo, aceptó su nuevo destino. Aquellos que hubiesen vivido una vida de virtud, no tendrían nada que temer. Sin embargo, los viles no escaparían a su juicio...	
VO_Terenas_Male_Human_ICCPriestVictory_01	El joven príncipe se fundió con las sombras. «Ahora lo veo todo», dijo con llamas azules en los ojos. «Qué ingenuo he sido».	
VO_Terenas_Male_Human_ICCRogueVictory_01	Valeera la Lúgubre desapareció en la noche. Sus sombras lo ven todo y nadie está a salvo de su hoja helada...	
VO_Terenas_Male_Human_ICCShamanVictory_01	La mente del chamán se ahogaba entre voces, una cacofonía de muertos que inundaba su cabeza. El Agorero cerró los ojos y pronunció una sola palabra: «Dormid...".	
VO_Terenas_Male_Human_ICCWarlockVictory_01	Al fin Gul'dan se sentó en el Trono Helado. El Portal Oscuro volvió a abrirse e incontables mundos temblaron ante él...	
VO_Terenas_Male_Human_ICCWarriorVictory_01	El que una vez fuera Jefe de Guerra de la Horda aceptó su nuevo poder. Las víctimas heladas de su ejército se alzaban para servir, hasta que se convirtió en maestro de todo lo que alcanzaba a ver.	
VO_TIRION_INTRO_03	¿Quién de vosotros será nombrado campeón?	
VO_WhiteKing_Male_ChessPiece_ChessDeath_01	Jaque mate...	
VO_WhiteKing_Male_ChessPiece_ChessEmoteGreetings_01	¿Te apetece una partida?	
VO_WhiteKing_Male_ChessPiece_ChessEmoteOops_01	Uy, vaya error...	
VO_WhiteKing_Male_ChessPiece_ChessEmoteSorry_01	Un suceso desafortunado.	
VO_WhiteKing_Male_ChessPiece_ChessEmoteThanks_01	Muy amable.	
VO_WhiteKing_Male_ChessPiece_ChessEmoteThinking_01	Mmm... Torre a A-3...	
VO_WhiteKing_Male_ChessPiece_ChessEmoteThinking_02	Caballo a F-6...	
VO_WhiteKing_Male_ChessPiece_ChessEmoteThinking_03	Reina a E-5... Eh... No, no, no...	
VO_WhiteKing_Male_ChessPiece_ChessEmoteThreaten_01	Mate en cuatro turnos.	
VO_WhiteKing_Male_ChessPiece_ChessEmoteWellPlayed_01	Jaque mate.	
VO_WhiteKing_Male_ChessPiece_ChessEmoteWow_01	¡Ah, excepcional!	
VO_WhiteKing_Male_ChessPiece_ChessOpen_02	¡En guardia!	
VOX_Nightbane_Start_01	¡Grrr!	
