TAG	TEXT	COMMENT
ChromaggusBoss_Death_1	Grauuuurr!	
ChromaggusBoss_EmoteResponse_1	*Rosnado*	
ChromaggusBoss_Start_1	Raaargh!	
GiantRat_LOOTA_BOSS_18h_DefeatPlayer	<Guinchado>	
GiantRat_LOOTA_BOSS_18h_EmoteResponse	<Guinchado>	
GILA_BOSS_65h_Gobbles_DefeatPlayer	Reeeaaaooo!	
GILA_BOSS_65h_Gobbles_EmoteResponse	Bahauaoowr!	
GILA_BOSS_65h_Gobbles_Intro	Uwaauuoooo!	
LOE_07_MINE_CART_EMOTES	CLANQUE	
LOOTA_BOSS_21h_GnoshTheGreatWorm_EmoteResponse	<Rugido>	
LOOTA_BOSS_47h_Lava_FilledRoom_Emote	<Raiva>	
LOOTA_BOSS_52h_TreasureVault_Emote	<Bufunfa>	
OnyxiaBoss_Death_1	Grauuuurr!	
OnyxiaBoss_EmoteResponse_1	*Rosnado*	
OnyxiaBoss_Start_1	Raaargh!	
POPUP_FROST_BRAWL	Fadiga! Quem tiver mais vida no final do próximo turno vai vencer o jogo.	
POPUP_FROST_BRAWL_ARMOR	Nesta contenda ninguém se esconde em armadura!	
TheMothergloop_LOOTA_BOSS_24h_EmoteResponse	<Arroto>	
TrappedRoom_LOOTA_BOSS_48h_EmoteResponse	<Rabugice>	
VO_Ahune_Male_Elemental_Brawl_01	SIM! ESMAGUE RAGNAROS!	
VO_Ahune_Male_Elemental_Brawl_02	QUEM DETÉM O PODER AGORA, TOLO DO FOGO!?	
VO_Ahune_Male_Elemental_Brawl_03	SERÁ MINHA VINGANÇA!	
VO_Ahune_Male_Elemental_Brawl_04	QUEM VIROU "O PRINCIPAL ALVO DOS AVENTUREIROS DE AZEROTH" AGORA?!	
VO_Ahune_Male_Elemental_Brawl_05	E AGORA... QUEM É O INSETO!?	
VO_Ahune_Male_Elemental_Brawl_07	A PEDRA DE GELO DERRETEU!	
VO_Ahune_Male_Elemental_Brawl_08	QUEM DESTRUIRÁ MAIS TOLOS!?	
VO_Ahune_Male_Elemental_Brawl_11	EXCELENTE!	
VO_Ahune_Male_Elemental_Brawl_15	TEM QUE DESTRUIR RAGNAROS AINDA MAIS!	
VO_Ahune_Male_Elemental_Brawl_16	NOSSA! VOCÊ ODEIA MESMO RAGNAROS?	
VO_Aran_Male_Shade_AranCrackle_01	Hunf. No meu tempo, Estalar sempre causava seis de dano.	
VO_Aran_Male_Shade_AranDeath_02	De novo não...	
VO_Aran_Male_Shade_AranEmoteResponse_01	Saiam! Saiam!	
VO_Aran_Male_Shade_AranHeroPower_01	Queimem, seus vândalos!	
VO_Aran_Male_Shade_AranMedivhSkin_01	Medivh? Não, não... eu não incomodei os convidados...	
VO_Aran_Male_Shade_AranOpen_01	Vão aprender a não interferir!	
VO_Aran_Male_Shade_AranSpell_03	Volte para a fria escuridão!	
VO_Aran_Male_Shade_AranSpell_04	O mestre é poderoso, mas também tenho meus poderes!	
VO_Aran_Male_Shade_AranTrons_02	NÃO! NÃO! Que algazarra terrível! Que horrendos "olás"!	
VO_Aran_Male_Shade_AranTurn1_01	Nada de música alta na minha torre!	
VO_Aran_Male_Shade_AranTurn5_01	Eu não sou um reles bufão! Eu sou Nielas Aran!	
VO_Barnes_Male_Human_FinalNazraTurn5_02	Socorro! Acabaram as bananas! Mukla está destroçando a despensa!	
VO_Barnes_Male_Human_JulianneTurn5_01	Onde já se viu uma festa sem atrações? E onde já se viu atrações sem plateia?	
VO_Barnes_Male_Human_JulianneWin_01	Terminado um ato! Restam dois!	
VO_Barnes_Male_Human_Wing2Intro_02	Boas-vindas ao teatro! Meu nome é Barnes, sou o Produtor. Os portais para salvar Medivh ficam lá em cima, mas antes você tem que assistir ao show!	
VO_Barnes_Male_Human_WolfBigMinion_01	Ai, vovó, que lacaios grandes você tem!	
VO_Barnes_Male_Human_WolfClaws_01	Não se preocupe! Essas garras enormes são decorativas!	
VO_Barnes_Male_Human_WolfTurn5_01	Eu adoro quando a plateia participa! Corram, convidados, corram!	
VO_Barnes_Male_Human_WolfTurn9_01	Haha! Um grande espetáculo! Bem melhor do que o ogro que perseguimos semana passada!	
VO_Barnes_Male_Human_WolfWin_01	A-há! O final está perto!	
VO_BigBadWolf_Male_Worgen_WolfBigMinion_01	É para te esmagar melhor!	
VO_BigBadWolf_Male_Worgen_WolfDeath_01	Virei caça? Não...	
VO_BigBadWolf_Male_Worgen_WolfDireWolfAlpha_01	*Rosnado*	
VO_BigBadWolf_Male_Worgen_WolfDireWolfAlpha_02	*choraminga*	
VO_BigBadWolf_Male_Worgen_WolfEmoteResponse_01	Hum... \nDelícia...	
VO_BigBadWolf_Male_Worgen_WolfOpen_01	Fuja, garotinha, fuja!	
VO_BigBadWolf_Male_Worgen_WolfScarletCrusader_01	Ah, capuzinho vermelho, aonde você vai?	
VO_BigBadWolf_Male_Worgen_WolfTurn1_01	Olhe seus lacaios. Vê como se encolhem diante de mim?	
VO_BlackKing_Male_ChessPiece_ChessEmoteGreetings_01	Sempre.	
VO_BlackKing_Male_ChessPiece_ChessEmoteOops_01	Ou uma armadilha?	
VO_BlackKing_Male_ChessPiece_ChessEmoteSorry_01	Um sacrifício necessário.	
VO_BlackKing_Male_ChessPiece_ChessEmoteThanks	Disponha.	
VO_BlackKing_Male_ChessPiece_ChessEmoteThanks_01	Disponha.	
VO_BlackKing_Male_ChessPiece_ChessEmoteThreaten_01	Xeque-mate em 3.	
VO_BlackKing_Male_ChessPiece_ChessEmoteWellPlayed_01	Ainda não.	
VO_BlackKing_Male_ChessPiece_ChessEmoteWow_01	Naturalmente.	
VO_BlackKing_Male_ChessPiece_ChessOpen_01	Ninguém passará!	
VO_BOSS_AYA_Female_Pandaren_BC_0_Jade_Golem_02	Mais Golens? LEGAL!!!	
VO_BOSS_AYA_Female_Pandaren_BC_0_Jade_Golem_03	Hehehehehehe! EXÉRCITO, ATACAR!	
VO_BOSS_AYA_Female_Pandaren_BC_0_Jade_Golem_04	Outra! OUTRA!	
VO_BOSS_AYA_Female_Pandaren_BC_2_1st_Turn_Start_01	Isso mesmo! Geringontzan será MINHA!	
VO_BOSS_AYA_Female_Pandaren_BC_2_2nd_Turn_Start_01	Geringontzan é da Lótus de Jade, e a Lótus de Jade é minha!	
VO_BOSS_AYA_Female_Pandaren_BC_2_Arms_Dealing1_01	Mais armas, que criatividade! 	
VO_BOSS_AYA_Female_Pandaren_BC_2_Fill1_01	Uuuuuuh, você vai adorar isso...	
VO_BOSS_AYA_Female_Pandaren_BC_2_Fill2_01	Nahhh, eu gosto daqui! Acho que vou ficar!	
VO_BOSS_AYA_Female_Pandaren_BC_2_Goons_Win_01	Não, não, não, não! Que DROGA!	
VO_BOSS_AYA_Female_Pandaren_BC_2_Goons_Winning_02	Acho melhor você CALAR A BOCA!	
VO_BOSS_AYA_Female_Pandaren_BC_2_Jade_Win_01	A Lótus de Jade vence de novo! Eu sou demais!	
VO_BOSS_AYA_Female_Pandaren_BC_2_Lotus_Winning_01	Hehehe, continua jogando, continua!	
VO_BOSS_AYA_Female_Pandaren_BC_3_1st_Turn_Start_01	Geringontzan é MUITO LEGAL! Quero!	
VO_BOSS_AYA_Female_Pandaren_BC_3_1st_Turn_Start_02	Hehehe, com prazer...	
VO_BOSS_AYA_Female_Pandaren_BC_3_2nd_Turn_Start_01	Cara, vocês do Kabal são um tédio!	
VO_BOSS_AYA_Female_Pandaren_BC_3_Fill1_01	Que dia mais lindo, hein, Kazinho?	
VO_BOSS_AYA_Female_Pandaren_BC_3_Fill2_01	Hã, nossa, Kazinho, relaxa. Solta a franga.	
VO_BOSS_AYA_Female_Pandaren_BC_3_Jade_Golem3_01	Hehehehehe!	
VO_BOSS_AYA_Female_Pandaren_BC_3_Kabal_Winning_01	Só porque você é entediante demais.	
VO_BOSS_AYA_Female_Pandaren_BC_3_Kabal_Wins_01	NÃO É POSSÍVEL! NÃO! NÃO! NÃO! NÃO! 	
VO_BOSS_AYA_Female_Pandaren_BC_3_Lotus_Winning_01	Aaaah, que é que foi, Kazinho? Você ficou dodói, foi?	
VO_BOSS_AYA_Female_Pandaren_BC_3_Lotus_Wins_01	Bom, foi divertido. Obrigada por jogar, Kazinho!	
VO_BOSS_AYA_Female_Pandaren_BC_3_Potion1_02	Blá, blá, poções, blá, blá, blá, quero ver você LUTAR COMIGO!	
VO_BOSS_AYA_Female_Pandaren_BC_3_Potion3_01	Eca! Que coisa nojenta!	
VO_BOSS_AYA_Female_Pandaren_Concede_01	Ah, não tem graça.	
VO_BOSS_AYA_Female_Pandaren_Greetings_01	Iiiá!	
VO_BOSS_AYA_Female_Pandaren_Oops_01	Ops!	
VO_BOSS_AYA_Female_Pandaren_START_01	Preparem os golens!	
VO_BOSS_AYA_Female_Pandaren_Thanks_02	Obrigada!	
VO_BOSS_AYA_Female_Pandaren_Threaten_02	Hmm, acho que você vai morrer.	
VO_BOSS_AYA_Female_Pandaren_Well_Played_01	Essa foi legal!	
VO_BOSS_AYA_Female_Pandaren_Wow_02	Epa!	
VO_BOSS_CHO_Male_Ogre_BC_1_1st_Turn_Start_01	CAPANGAS CRUÉIS TOCAM O TERROR!	
VO_BOSS_CHO_Male_Ogre_BC_1_Fill2_01	PRA CIMA DELES!	
VO_BOSS_CHO_Male_Ogre_BC_2_Fill1_01	A MENINA TEM OLHAR DE DOIDO.	
VO_BOSS_CHO_Male_Ogre_Concede_01	ISSO! NÃO, PERA. VOCÊ GANHA!	
VO_BOSS_CHO_Male_Ogre_Oops_02	FOI MAL!	
VO_BOSS_CHO_Male_Ogre_Thanks_01	OBRIGADO.	
VO_BOSS_HAN_Male_Ogre_BC_0_Arms_Dealing_01	Achado não é roubado, não é assim que dizem?	
VO_BOSS_HAN_Male_Ogre_BC_0_Arms_Dealing_02	Capangas, juntos!	
VO_BOSS_HAN_Male_Ogre_BC_0_Arms_Dealing_03	Equipa bem esse Capanga e bota ele em ação!	
VO_BOSS_HAN_Male_Ogre_BC_0_Arms_Dealing_04	Os Capangas Cruéis ficam juntos!	
VO_BOSS_HAN_Male_Ogre_BC_1_1st_Turn_Start_01	Essas ruas daqui são bem perigosas, Kazakus.	
VO_BOSS_HAN_Male_Ogre_BC_1_2nd_Turn_Start_01	Geringontzan é território dos Capangas.	
VO_BOSS_HAN_Male_Ogre_BC_1_2nd_Turn_Start_02	Isso tudo é muito legal, mas Geringontzan é território dos Capangas.	
VO_BOSS_HAN_Male_Ogre_BC_1_Fill1_01	Pega suas poções e cai fora.	
VO_BOSS_HAN_Male_Ogre_BC_1_Fill2_01	Ei, Cho, chama os Capangas. Esse troll precisa se ligar.	test
VO_BOSS_HAN_Male_Ogre_BC_1_Goons_Win_01	Lamento, Kazakus. São só negócios.	
VO_BOSS_HAN_Male_Ogre_BC_1_Goons_Winning_01	Awww, parece que você sofreu um... acidente, Kazakus...	
VO_BOSS_HAN_Male_Ogre_BC_1_Kabal_Win_02	Ainda... não... acabou... Kazakus.	
VO_BOSS_HAN_Male_Ogre_BC_1_Kabal_Winning_02	Hum. Nada mau, velhinho.	
VO_BOSS_HAN_Male_Ogre_BC_1_Potion1_01	Sabe, eu nunca gostei de poções...	
VO_BOSS_HAN_Male_Ogre_BC_1_Potion2_01	Ei! Veja bem onde vai jogar isso!	
VO_BOSS_HAN_Male_Ogre_BC_2_1st_Turn_Start_01	Geringontzan é nossa! Cai fora, ratazana!	
VO_BOSS_HAN_Male_Ogre_BC_2_1st_Turn_Start_04	É, bem, nós, Capangas Cruéis, temos nossa opinião sobre isso...	
VO_BOSS_HAN_Male_Ogre_BC_2_Fill1_01	Não gosto desse olhar, Aya.	
VO_BOSS_HAN_Male_Ogre_BC_2_Goons_Win_01	Dá um tempo, Aya. Hehe. É melhor pra você.	
VO_BOSS_HAN_Male_Ogre_BC_2_Goons_Winning_01	Talvez você deva reconsiderar sua opinião...	
VO_BOSS_HAN_Male_Ogre_BC_2_Jade_Golem2_01	Tô ficando cansado desses fulanos de Jade.	
VO_BOSS_HAN_Male_Ogre_BC_2_Lotus_Win_01	Argh. Geringontzan será... nossa...	
VO_BOSS_HAN_Male_Ogre_BC_2_Lotus_Winning_01	Argh, alguém tira essa menina daqui.	
VO_BOSS_HAN_Male_Ogre_Concede_01	É tudo culpa sua, sabia?	
VO_BOSS_HAN_Male_Ogre_Greetings_01	Boas-vindas a Geringontzan.	
VO_BOSS_HAN_Male_Ogre_INTRO_PACK_OPEN_7	Ei, ei, ei! Quem é esse sujeito bonitão?	
VO_BOSS_HAN_Male_Ogre_Oops_01	Parece uma furada.	
VO_BOSS_HAN_Male_Ogre_START_01	Você tá no nosso pedaço agora!	
VO_BOSS_HAN_Male_Ogre_Thanks_01	Você prestou um bom serviço.	test
VO_BOSS_HAN_Male_Ogre_Threaten_01	Não dá pra recusar.	
VO_BOSS_HAN_Male_Ogre_Well_Played_02	Admito que você me impressionou.	
VO_BOSS_HAN_Male_Ogre_WOW_01	Nada mau!	
VO_BOSS_KAZAKUS_Male_Troll_BC_0_Potion_01	Ah, tão revigorante.	
VO_BOSS_KAZAKUS_Male_Troll_BC_0_Potion_02	Toma isso!	
VO_BOSS_KAZAKUS_Male_Troll_BC_0_Potion_04	Beber com vontade... Muahahaha!	
VO_BOSS_KAZAKUS_Male_Troll_BC_0_Potion_05	Que gosto tem?!	
VO_BOSS_KAZAKUS_Male_Troll_BC_1_1st_Turn_Start_01	Geringontzan será minha, Han'Cho!	
VO_BOSS_KAZAKUS_Male_Troll_BC_1_2nd_Turn_Start_01	O Kabal está em toda parte. Geringontzan se curva a nós.	
VO_BOSS_KAZAKUS_Male_Troll_BC_1_Arms_Dealing1_01	Hunf, covardia típica de Capangas. PAREM DE SE ESCONDER NA MÃO! 	
VO_BOSS_KAZAKUS_Male_Troll_BC_1_Fill1_01	Meu Kabal tem um poder ilimitado.	
VO_BOSS_KAZAKUS_Male_Troll_BC_1_Goons_Win_01	Eu voltarei, mais poderoso do que nunca!	
VO_BOSS_KAZAKUS_Male_Troll_BC_1_Goons_Winning_01	ARGH! VOCÊ SOFRERÁ, HAN'CHO!	
VO_BOSS_KAZAKUS_Male_Troll_BC_1_Kabal_Win_01	Sim, acabou.	
VO_BOSS_KAZAKUS_Male_Troll_BC_1_Kabal_Winning_01	Seu destino o aguarda, Han'Cho.	
VO_BOSS_KAZAKUS_Male_Troll_BC_3_1st_Turn_Start_01	Hehehe. Vai ter que me destruir pra conseguir.	
VO_BOSS_KAZAKUS_Male_Troll_BC_3_Fill1_01	NÃO DIGA ISSO DE MIM, MENINA ARROGANTE!	
VO_BOSS_KAZAKUS_Male_Troll_BC_3_Fill2_01	Curve-se ante o poder do Kabal!	
VO_BOSS_KAZAKUS_Male_Troll_BC_3_Jade_Golem2_01	Menina arrogante! Ousa debochar do poderoso líder de Geringontzan?	
VO_BOSS_KAZAKUS_Male_Troll_BC_3_Jade_Golem3_01	Insolente! Já estou farto de ouvir asneiras sobre golens.	
VO_BOSS_KAZAKUS_Male_Troll_BC_3_Kabal_Winning_01	Você parece um pouco fatigada, garotinha!	
VO_BOSS_KAZAKUS_Male_Troll_BC_3_Kabal_Winning_02	O quê...? Criança insolente! Eu serei sua RUÍNA!	test
VO_BOSS_KAZAKUS_Male_Troll_BC_3_Kabal_Wins_01	Haha! Outro oponente cai diante do poder do Kabal!	
VO_BOSS_KAZAKUS_Male_Troll_BC_3_Lotus_Winning_01	Pirralha atrevida...	
VO_BOSS_KAZAKUS_Male_Troll_BC_3_Lotus_Wins_01	Menina tola, ainda não é o fiiiiiim!	
VO_BOSS_KAZAKUS_Male_Troll_BC_3_Potion1_01	Sinta a fúria das poções do Kabal.	
VO_BOSS_KAZAKUS_Male_Troll_Concede_01	Essas ruas... são minhas.	
VO_BOSS_KAZAKUS_Male_Troll_Greetings_02	Saudações, tolos.	test
VO_BOSS_KAZAKUS_Male_Troll_Mirror_Start_01	Você tem certo talento.	
VO_BOSS_KAZAKUS_Male_Troll_Oops_01	Um erro de cálculo.	
VO_BOSS_KAZAKUS_Male_Troll_START_01	O mana está chamando.	
VO_BOSS_KAZAKUS_Male_Troll_Thanks_01	Fico muito grato, vassalo.	
VO_BOSS_KAZAKUS_Male_Troll_Threaten_01	EU CONTROLO GERINGONTZAN!	
VO_BOSS_KAZAKUS_Male_Troll_Well_Played_02	Você tem tanto potencial.	
VO_BOSS_KAZAKUS_Male_Troll_Wow_01	Tanto poder!	
VO_BRANN_MITHRIL_ALT_02	Fascinante. Estas runas de mithril contêm o código do guardião. Devem ser da época dos titãs!	
VO_BRANN_WIN_07_ALT_07	Escapamos! O castão está na próxima câmara!	
VO_BRM_027h_Death_63	Ah! AH! AAAAAAAAAH!!!	
VO_BRMA01_1_CARD_05	E agora, mostre o calor de nossa hospitalidade!	
VO_BRMA01_1_DEATH_09	Uia! O que...? Não gosto nada disso, mas é o que tem pra hoje!	
VO_BRMA01_1_ETC_06	Quem sabe faz ao vivo! Aplausos para o Chefe Tauren Elite!	
VO_BRMA01_1_HERO_POWER_04	Hahahaha! Montinho!	
VO_BRMA01_1_RESPONSE_03	Hahahaha!  *hic*  Oh... perdão. 	
VO_BRMA01_1_START_01	Boas-vindas ao Glutão Implacável.	
VO_BRMA01_1_SUCCUBUS_08	Lady Nagmara! Acho que nosso "amigo" quer uma "bebida".	
VO_BRMA01_1_TURN1_02	Hahaha! E aí pessoal! Vejam só... nós temos "visita".	
VO_BRMA01_1_WARGOLEM_07	Oh ho ho! Agora vocês tão encrencados! Falange! Pega eles!	
VO_BRMA02_1_ALAKIR_34	Ele é o lorde elemental que adora esmagar insetos: Al'akir!	
VO_BRMA02_1_ALEXSTRAZA_32	Mãe da Vida! Rainha dos Dragões! E boa de briga na Arena Ferro Negro… É Alexstrasza!	
VO_BRMA02_1_BEAST_22	A comida favorita dela são gnomos, mas hoje vai abrir uma exceção. É a Fera!	
VO_BRMA02_1_BOOM_28	Tomara que não tenha ninguém assistindo muito de perto, porque nosso próximo desafiante é o Dr. Cabum!	
VO_BRMA02_1_CAIRNE_20	Ele está ensinando o filho a pegar o touro à unha. Caerne Casco Sangrento!	
VO_BRMA02_1_CHO_07	Senta que lá vem história com o pandaren mais fofo de todos: Andarilho das Lendas Cho!	
VO_BRMA02_1_DEATH_38	Hjt! Huh? *Estertor de morte*	
VO_BRMA02_1_DEATHWING_35	Ooooh! Senhoras e senhores! O primeiro e único... ASA DA MORTE!	
VO_BRMA02_1_ETC_18	E agora, o tauren, o mito, a lenda: Chefe Tauren Elite!	
VO_BRMA02_1_FEUGEN_15	Palmas para Feugen!	
VO_BRMA02_1_FOEREAPER_29	Ele foi ajustado para destruição máxima: é o Ceifador de Inimigos 4000!	
VO_BRMA02_1_GEDDON_13	Essa Arena tá ficando quente! Uma salva de palmas para... Barão Geddon!	
VO_BRMA02_1_GELBIN_21	Direto da Vila da Gambiarra, uma salva de palmas para o líder de toda a gnomidade: Gelbin Mekkatorque!	
VO_BRMA02_1_GRUUL_31	Não chamam ele de Matador de Dragões à toa! Uma salva de palmas para Gruul!	
VO_BRMA02_1_HERO_POWER_05	A plateia está indócil. Ahahaha!	
VO_BRMA02_1_HOGGER_27	Deem as boas-vindas ao gnoll de nível 11 que se tornou uma lenda: Hogger!	
VO_BRMA02_1_ILLIDAN_23	Quem precisa de olhos quando se tem duas lâminas de guerra místicas? É ele mesmo, Illidan Tempesfúria!	
VO_BRMA02_1_LEVIATHAN_12	Recauchutado e pronto pra arrebentar: o Leviatã Flamejante!	
VO_BRMA02_1_LOATHEB_16	Tapem o nariz, cubram a boca e saúdem essa massa malcheirosa e podre: Repugnaz!	
VO_BRMA02_1_MAEXXNA_24	Hora da aranha gigante! Como é que pronuncia esse nome mesmo? Maexxna!	
VO_BRMA02_1_MILLHOUSE_09	Ah, não, pera aí. Quem deixou ele entrar na arena?	
VO_BRMA02_1_MOGOR_25	O vocabulário dele é limitado, mas a raiva não. É Mogor, o Ogro!	
VO_BRMA02_1_MUKLA_10	E agora, o rei do bananal! Rei Mukla!	
VO_BRMA02_1_NOZDORMU_36	Senhoras e... opa! Acabou o tempo!	
VO_BRMA02_1_ONYXIA_33	Direto do Pântano Vadeoso e do Castelo Ventobravo, preparem-se para Onyxia!	
VO_BRMA02_1_PAGLE_08	De volta de sua última pescaria, mestre pescador Nat Pagle!	
VO_BRMA02_1_RESPONSE_04	Ninguém sobrevive a todos esses heróis lendários!	
VO_BRMA02_1_SNEED_30	Nosso próximo desafiante está escondido atrás dos controles de um velho retalhador! Quem será?	
VO_BRMA02_1_STALAGG_14	Será que Stalagg sobrevive à arena? Vamos descobrir!	
VO_BRMA02_1_START_01	Um novo desafiante?	
VO_BRMA02_1_SYLVANAS_19	Ela arde de ódio por vocês. Deem as boas-vindas a Sylvana Correventos!	
VO_BRMA02_1_THALNOS_06	Aplausos para nosso esqueleto de saiote! Mago Sangrento Thalnos!	
VO_BRMA02_1_THAURISSAN_37	Vindo direto da missão que vem depois dessa: o imperador Thaurissan!	
VO_BRMA02_1_TINKMASTER_11	Quero ouvir muitas palmas para o grande inventor: Mestre-faz-tudo Superchispa!	
VO_BRMA02_1_TOSHLEY_26	Esse gnomo vai dar trabalho: uma salva de palmas pro Tocha!	
VO_BRMA02_1_TURN1_02	Senhoras e senhores anões! Hoje o espetáculo está demais!	
VO_BRMA02_1_TURN1_PT2_03	As maiores lendas de Azeroth contra um único aventureiro fracote!	
VO_BRMA02_1_VOLJIN_17	Silêncio, por favor! Nós temos um convidado especial, o primeiro e único Chefe Guerreiro Vol'jin!	
VO_BRMA03_1_CARD_04	Pelos poderes de Ragnaros, eu tenho a força!	
VO_BRMA03_1_DEATH_09	Aaaaaaaah!	
VO_BRMA03_1_HERO_POWER_06	Morra!	
VO_BRMA03_1_MOIRA_DEATH_05	Não! Moira! Você vai PAGAR POR ISSO!	
VO_BRMA03_1_RESPONSE_03	Se você não calar a boca, eu calo pra você.	
VO_BRMA03_1_START_01	Os Anões Ferro Negro jamais cairão!	
VO_BRMA03_1_TURN1_02	Epa! Deixa minha mulher em paz!	
VO_BRMA03_1_VS_RAG_07	Não! Ragnaros! De novo não!	
VO_BRMA04_1_CARD_04	Devoto do Fogo, vamos lá!	
VO_BRMA04_1_DEATH_06	Rrrrrrrrrrrrh!	
VO_BRMA04_1_HERO_POWER_05	Magma!	
VO_BRMA04_1_RESPONSE_03	A pedra vence tudo.	
VO_BRMA04_1_START_01	Eu vou mandar pedrada.	
VO_BRMA04_1_TURN1_02	Solta pedra!	
VO_BRMA05_1_CARD_05	Tique, taque... bum!	
VO_BRMA05_1_DEATH_04	Um último serviço...	
VO_BRMA05_1_HERO_POWER_06	Queime!	
VO_BRMA05_1_RESPONSE_03	Armagedom!	
VO_BRMA05_1_START_01	Você vai QUEIMAR!	
VO_BRMA05_1_TURN1_02	Ragnaros vai consumir você!	
VO_BRMA06_1_DEATH_04	Eu me rendo! Eu me rendo!	
VO_BRMA06_1_RESPONSE_03	Você pensa que já ganhou? Acho que precisa de uma lição mais dolorosa!	
VO_BRMA06_1_START_01	Ninguém desafia a chama viva!	
VO_BRMA06_1_SUMMON_RAG_05	Contemple Ragnaros! Ele já era velho quando este mundo ainda era jovem!	
VO_BRMA06_1_TURN1_02_ALT	Cacem-nos!	
VO_BRMA06_3_INTRO_01	CEDO DEMAIS! VOCÊ ME DESPERTOU CEDO DEMAIS, EXECUTUS!	
VO_BRMA06_3_RESPONSE_03	O QUE SIGNIFICA ESSA INVASÃO?	
VO_BRMA06_3_TURN1_02	INSETOS MORTAIS! COMO OUSAM INVADIR O MEU DOMÍNIO?	
VO_BRMA07_1_CARD_04	Hora de esmagar!	
VO_BRMA07_1_DEATH_06	Rrrnãããão!	
VO_BRMA07_1_HERO_POWER_05	Eu esmaga! Você morre!	
VO_BRMA07_1_RESPONSE_03	Rrr! Eu esmaga!	
VO_BRMA07_1_START_01	Eu vou esmagar você!	
VO_BRMA07_1_TURN1_02	Esmagar ou esmigalhar? Decisão difícil!	
VO_BRMA08_1_CARD_05	Eu vou proteger o Pináculo!	
VO_BRMA08_1_DEATH_06	Rrh. Aah! Nããããão!	
VO_BRMA08_1_RESPONSE_04	Por quê?? Mas por quê? Poxa, eu gostava de você.	
VO_BRMA08_1_START_01	O que você está fazendo aqui?	
VO_BRMA08_1_TURN1_03	Lorde Nefarius! Eu pensei que fosse esse aí que cuidou de Ragnaros para nós!	
VO_BRMA08_1_TURN1_ALT_02	Você veio me ajudar a destruir os mortais deste mundo?	
VO_BRMA09_1_CARD_05	O Pináculo é NOSSO!	
VO_BRMA09_1_DEATH_11	Aaahhhhh!	
VO_BRMA09_1_HERO_POWER1_06	Abram os portões!	
VO_BRMA09_1_HERO_POWER2_07	Mate aquele lá atrás!	
VO_BRMA09_1_HERO_POWER3_08	Concentrem-se no herói, seus tolos!	
VO_BRMA09_1_HERO_POWER4_09	Juntos, nós somos IMBATÍVEIS!	
VO_BRMA09_1_RESPONSE_04	Hahahahaha.	
VO_BRMA09_1_START_01	Nós somos a VERDADEIRA Horda!	
VO_BRMA09_1_TURN1_03	Você está subindo a montanha errada.	
VO_BRMA09_1_TURN1_ALT_02	Ninguém vai ficar no nosso caminho. MORRA!	
VO_BRMA10_1_DEATH_08	Rrrrrrrrrrrh!	
VO_BRMA10_1_EGG_DEATH_1_05	Tolos! Esses ovos são inestimáveis!	
VO_BRMA10_1_EGG_DEATH_2_06	Não! Mais um, não! Eu vou arrancar a cabeça de vocês por essa atrocidade!	
VO_BRMA10_1_EGG_DEATH_3_07	Você vai pagar por isso!	
VO_BRMA10_1_HERO_POWER_04	Afaste-se desses ovos!	
VO_BRMA10_1_RESPONSE_03	Você está frito!	
VO_BRMA10_1_START_01	Contemple os ovos corrompidos da nova revoada dragônica.	
VO_BRMA10_1_TURN1_02	Esses ovos serão a sua ruína.	
VO_BRMA11_1_ALEXSTRAZA_07	Me ajude. Mãe da Vida! Socorro!	
VO_BRMA11_1_CARD_04	A fúria de Rocha Negra corre por minhas veias!	
VO_BRMA11_1_DEATH_ALT_08	Finalmente. A agonia termina.	
VO_BRMA11_1_HERO_POWER_05	Aaaah! Destruição!	
VO_BRMA11_1_KILL_PLAYER_06	Perdoe-me, amigo. Eu fracassei.	
VO_BRMA11_1_RESPONSE_03	Você devia ter fugido quando podia, mortal.	
VO_BRMA11_1_START_01	Fuja! Antes que eu perca o controle...	
VO_BRMA11_1_TURN1_02	É tarde demais. A corrupção de Nefarian é completa.	
VO_BRMA13_1_DEATH_ALT_23	Não! NÃO! Eu voltareeeeeeei!	
VO_BRMA13_1_DEATHWING_19	P-papai??	
VO_BRMA13_1_HP_DRUID_14	Druida, eu controlo o verde!	
VO_BRMA13_1_HP_GENERIC_18	Sua magia é minha!	
VO_BRMA13_1_HP_HUNTER_12	O caçador vira a caça!	
VO_BRMA13_1_HP_MAGE_11	Mago, você devia tomar mais cuidado ao brincar com magia.	
VO_BRMA13_1_HP_PALADIN_07	Paladino, a Luz abandonou você?	
VO_BRMA13_1_HP_PRIEST_08	Sacerdote, a Luz me serve agora!	
VO_BRMA13_1_HP_ROGUE_15	Ladino! Pare de se esconder e me enfrente!	
VO_BRMA13_1_HP_SHAMAN_13	Xamã, os elementos obedecem a MIM agora.	
VO_BRMA13_1_HP_WARLOCK_10	Bruxo, você mexe com magias além da sua compreensão!	
VO_BRMA13_1_HP_WARRIOR_09	Guerreiro, sua força se torna sua fraqueza!	
VO_BRMA13_1_RESPONSE_05	Eu sou o mestre aqui!	
VO_BRMA13_1_START_01	Bem-vindo ao meu santuário particular, herói.	
VO_BRMA13_1_TURN1_PT1_02	Contemple! O poder verdadeiro de NEFARIAN!	
VO_BRMA13_1_TURN1_PT2_03	Mana infinito! Escama de Dragão Blindada!	
VO_BRMA14_1_CARD_09	Redirecionando energia em excesso.	
VO_BRMA14_1_DEATH_08	Sistemas de Defesa Obliterados. Desligando.	
VO_BRMA14_1_HP1_03	Unidade Eléctron ativada.	
VO_BRMA14_1_HP2_04	Unidade Toxitron ativada.	
VO_BRMA14_1_HP3_05	Unidade Arcanotron ativada.	
VO_BRMA14_1_HP4_06	Unidade Magmatron ativada.	
VO_BRMA14_1_HP5_07	Unidade de defesa online.	
VO_BRMA14_1_RESPONSE1_10	Bip. Bop. Bip.	
VO_BRMA14_1_RESPONSE2_11	Tentando conectar.	
VO_BRMA14_1_RESPONSE3_12	Conectado. Baixando atualizações do sistema operacional.	
VO_BRMA14_1_RESPONSE4_13	Atualização instalada. Olá! Olá! Olá!	
VO_BRMA14_1_RESPONSE5_14	Olá! Olá! Olá!	
VO_BRMA14_1_START_01	Intrusos detectados.	
VO_BRMA14_1_TURN1_02	Matriz de defesa primária: iniciar.	
VO_BRMA15_1_CARD_05	Meus fracassos serão sua ruína!	
VO_BRMA15_1_DEATH_04	Aaaaaaaahhhhh!	
VO_BRMA15_1_HERO_POWER_06	Misture e mexa. Aplique calor!	
VO_BRMA15_1_RESPONSE_03	Aqui nada se perde!	
VO_BRMA15_1_START_01	Não pode haver interrupções!	
VO_BRMA15_1_TURN1_02	Não posso deixar o mestre esperando! Não posso fracassar de novo!	
VO_BRMA16_1_CARD_04	Você não tem onde se esconder!	
VO_BRMA16_1_DEATH_06	Rrrraaaaaaaah!	
VO_BRMA16_1_GONG1_10	Aaah! Esse som!	
VO_BRMA16_1_GONG2_11	Não! Tão perto!	
VO_BRMA16_1_GONG3_12	Meus OUVIDOS!	
VO_BRMA16_1_HERO_POWER_05	Seus passos desajeitados e seu fedor denunciam sua posição!	
VO_BRMA16_1_RESPONSE_03	Sim, fale! Estou chegando perto.	
VO_BRMA16_1_START_01	Eu ouço seu coração bater!	
VO_BRMA16_1_TRIGGER1_07	Ah. Eu ouvi você!	
VO_BRMA16_1_TRIGGER2_08	Escuto passos.	
VO_BRMA16_1_TRIGGER3_09	Eu ouço seu coração bater. Você não pode fugir!	
VO_BRMA16_1_TURN1_02	A morte aguarda nas trevas.	
VO_BRMA17_1_CARD_86	Espero que você saiba nadar... NA LAVA!	
VO_BRMA17_1_DEATH_97	Aaaaaaaaaaah!	
VO_BRMA17_1_DEATH_HEROIC_98	NÃÃÃÃÃOOOO!	
VO_BRMA17_1_DEATHWING_88	PAPAI??	
VO_BRMA17_1_HERO_POWER_87	Minha chama sombria anima os ossos deles!	
VO_BRMA17_1_NEF_AIR1_89	Contemple! Eu cuspo fogo do céu! Um de dano é só o começo!	
VO_BRMA17_1_NEF_AIR2_90	Duas bolas de fogo! Vou cuspi-las aqui de cima!	
VO_BRMA17_1_NEF_AIR3_91	Dessa vez eu vou cuspir uma única bola de fogo, porque estou me preparando para uma rodada gloriosa!	
VO_BRMA17_1_NEF_AIR4_92	Haha! Três bolas de fogo! Chupa essa!	
VO_BRMA17_1_NEF_AIR5_93	De agora em diante, eu vou cuspir apenas 1 bola de fogo.	
VO_BRMA17_1_NEF_AIR6_94	Brincadeirinha! QUATRO bolas de fogo! Ahahahaha!	
VO_BRMA17_1_NEF_AIR7_95	Eu não vou lançar nenhuma bola de fogo agora... mas prepare-se.	
VO_BRMA17_1_NEF_AIR8_96	VINTE BOLAS DE FOGO! AHAHAHAHAH!	
VO_BRMA17_1_RESPONSE_85	Mentes mortais... Tão fáceis de manipular.	
VO_BRMA17_1_RESURRECT1_82	Eu farei chover destruição na sua cabeça!	
VO_BRMA17_1_RESURRECT2_83	Ah, e eu tenho uma surpresa pra vocês aí embaixo!	
VO_BRMA17_1_RESURRECT3_84	Contemplem minha criação suprema! Erga-se, irmã! Erga-se, Onyxia!	
VO_BRMA17_1_START_78	Você chegou ao glorioso final!	
VO_BRMA17_1_TRANSFORM1_80	Eu tentei ser um anfitrião compreensivo, mas você NÃO QUER MORRER!	
VO_BRMA17_1_TRANSFORM2_81	É hora de parar de fingimento e MATAR VOCÊ DE UMA VEZ!	
VO_BRMA17_1_TURN1_79	Minha criação suprema aguarda, mortal.	
VO_COOP02_00	Eu expurgarei a Maldição da Carne de ambos!	
VO_COOP02_02	Derrote o Engrenochefe Mecanozod com outro jogador para vencer!	
VO_COOP02_ABILITY_05	Aumentar velocidade do relógio!	
VO_COOP02_ABILITY_06	A mídia impressa morreu, Andarilho das Lendas Cho!	
VO_COOP03_01	Eu sou o mestre aqui!	
VO_COOP03_02	Não... NÃO! Eu vou destruir você!	
VO_COOP03_03	Mentes mortais... Tão fáceis de manipular...	
VO_COOP03_04	Eu tentei ser um anfitrião compreensivo, mas você NÃO QUER MORRER!	
VO_COOP03_05	É hora de parar de fingimento e MATAR VOCÊ DE UMA VEZ!	
VO_COOP03_06	SACERDOTE! A Luz me serve agora!	
VO_COOP03_07	XAMÃ! Os elementos me obedecem agora!	
VO_COOP03_08	Hahahahaha... Contemple! O verdadeiro poder de Nefarian!	
VO_COOP03_09	Hehehehe... Você chegou ao glorioso final!	
VO_Crone_Female_Troll_CroneDeath_02	Não! Vou pegar você! Eu vou pegar...	
VO_Crone_Female_Troll_CroneEmoteResponse_02	Ah hahahahahaha!	
VO_Crone_Female_Troll_CroneFlyingMonkeys_01	Tragam aquela garota!	
VO_Crone_Female_Troll_CroneHeroPower_02	Hehehehehe!	
VO_Crone_Female_Troll_CroneOpen_01	Ha hahahaha! Fujam, belezinhas!	
VO_Curator_Male_ArcaneGolem_CuratorArcaneGolem_01	Curioso. Uma semelhança impressionante.	
VO_Curator_Male_ArcaneGolem_CuratorBeasts_01	Este Curador é alérgico a feras.	
VO_Curator_Male_ArcaneGolem_CuratorDemons_01	Demônios não podem ficar no viveiro.	
VO_Curator_Male_ArcaneGolem_CuratorDragons_01	Sem fezes de dragão, por favor.	
VO_Curator_Male_ArcaneGolem_CuratorEmoteResponse_01	Sua solicitação não pode ser processada.	
VO_Curator_Male_ArcaneGolem_CuratorHarrison_02	Malandro detectado! Proibida a entrada de Harrison Jones.	
VO_Curator_Male_ArcaneGolem_CuratorMechs_01	Reprogramando os assistentes.	
VO_Curator_Male_ArcaneGolem_CuratorMedivhSkin_01	Medivh impostor. Olhos de louco entregam tudo.	
VO_Curator_Male_ArcaneGolem_CuratorMurlocs_01	Coisinhas-peixe estão liberadas.	
VO_Curator_Male_ArcaneGolem_CuratorPirates_01	Piratas têm que piraaaarrr.	
VO_Curator_Male_ArcaneGolem_CuratorReno_02	Malandro detectado! Proibida a entrada de Reno Jackson.	
VO_Curator_Male_ArcaneGolem_CuratorTurn1_01	Este Curador está equipado para gerenciar viveiros.	
VO_Curator_Male_ArcaneGolem_CuratorTurn5_01	Favor obedecer a todos os protocolos da galeria.	
VO_Curator_Male_ArcaneGolem_CuratorTurn9_01	Os convidados devem permanecer no viveiro.	
VO_Curator_Male_ArcaneGolem_IllhoofKilrekResponse_01	Este Curador não se importa. É proibido evocar.	
VO_Curator_Male_ArcaneGolem_IllhoofSenseDemons_01	Vários demônios detectados.	
VO_Curator_Male_ArcaneGolem_IllhoofTurn1_01	Rituais de evocação não são permitidos.	
VO_Curator_Male_ArcaneGolem_IllhoofTurn5_01	Rituais ferem os habitantes. O demônio não pode prosseguir.	
VO_Curator_Male_ArcaneGolem_IllhoofWin_01	Este Curador lhe agradece. O viveiro será restaurado.	
VO_Curator_Male_ArcaneGolem_NightbaneCorruption_01	Não! O viveiro não pode ser corrompido!	
VO_Curator_Male_ArcaneGolem_NightbaneTour_01	O dragão Nocturno. Antes chamado Arcanagos, teve a mente distorcida por magia descontrolada.	
VO_Curator_Male_ArcaneGolem_NightbaneTour_02	À esquerda, um busto de Aran. À sua direita, a Lanterna do Poder.	
VO_Curator_Male_ArcaneGolem_NightbaneTurn1_01	Espécimes à solta podem se ferir. É preciso levá-las de volta ao viveiro.	
VO_Curator_Male_ArcaneGolem_NightbaneTurn3_01	É preciso salvar as criaturas. Depois você pode prosseguir.	
VO_Curator_Male_ArcaneGolem_NightbaneUnstablePortal_01	Seja gentil, conviva. Este dragão tem medo de magia instável.	
VO_Curator_Male_ArcaneGolem_NightbaneWin_01	É necessário mais auxílio.	
VO_Curator_Neither_ArcaneGolem_CuratorDeath_04	Desligando.	
VO_Curator_Neither_ArcaneGolem_CuratorOpen_01	Não toque na exposição.	
VO_ELISE_LOE16_ALT_1_FIRST_HALF_02	Rafaam fica invulnerável enquanto o cajado carrega.	
VO_ELISE_LOE16_ALT_1_SECOND_HALF_03	Quando terminar, vamos ter um tempo para contra-atacar, mas também teremos que cuidar da criatura que ele evocar!	
VO_ELISE_WEIRD_DECK_05	Desculpe pelo deck. Nós montamos ano passado para um torneio e nunca mais mexemos nele.	
VO_EMOTE_HERO_TBKTRAF_KT_DRAWING_BOARD	*suspiro*. De volta à prancheta.	
VO_EMOTE_HERO_TBKTRAF_KT_GLOAT	Peça misericórdia.	
VO_EMOTE_HERO_TBKTRAF_KT_MINIONS_SERVANTS	Lacaios, servos, soldados das trevas gélidas...	
VO_FP1_014t_EnterPlay_01	Agora VOCÊ vai sentir dor.	
VO_FP1_031_Attack_07	São ovelhas indo para o matadouro...	
VO_FP1_031_EnterPlay_06	O Flagelo consumirá você!	
VO_GIL_504_Female_Orc_TUT_LootSelect2_01	Quem ousa destruir minhas crias monstruosas? 	
VO_GIL_504_Female_Orc_TUT_Victory_Generic_01	Uma vitória vazia. Eu sou o bosque e não sou facilmente derrotada.	
VO_GIL_504_Female_Orc_TUT_Victory1_01	O Bosque das Bruxas não será conquistado tão facilmente. Acha que os outros se sairão tão bem quanto você?	
VO_GIL_504_Female_Orc_TUT_Victory2_01	Dois heróis conquistaram o Bosque das Bruxas, mas você ainda não encontrou a MIM.	
VO_GIL_504_Female_Orc_TUT_Victory3_01	Seu caminho leva você até mim. Seu último campeão será capaz de triunfar?	
VO_GIL_504_Female_Orc_TUT_Victory4_01	Isso termina esta noite. Venha a mim e testemunhe o horror no coração da floresta!	
VO_GIL_504_Female_Orc_UI_Monster_Azlina_02	Ah, pobre Azalina. Ela encontrará uma saída. De um jeito ou de outro.	
VO_GIL_504_Female_Orc_UI_Monster_Baran_01	Baran tinha uma alma gentil... Infelizmente, eu precisei dos olhos dele.	
VO_GIL_504_Female_Orc_UI_Monster_Brushwood_Cent_01	Foi fácil usar a ira desse druida.	
VO_GIL_504_Female_Orc_UI_Monster_Chupacabran_01	O Chupacabra. Ah! Como foi difícil torná-lo meu. 	
VO_GIL_504_Female_Orc_UI_Monster_Cragtorr_01	Enfrente a ira desta terra atormentada.\n Penhascoso, levante-se!	
VO_GIL_504_Female_Orc_UI_Monster_Crowskin_01	Glinda, acabe com ele. Todo o culto está à sua disposição.	
VO_GIL_504_Female_Orc_UI_Monster_DrSezavo_01	Vocês são uma doença. Sezavo tem a cura. 	
VO_GIL_504_Female_Orc_UI_Monster_Experiment3C_01	Hmmm... Esse aí eu não conheço.	
VO_GIL_504_Female_Orc_UI_Monster_Face_Collector_01	O seu rosto ficaria ótimo na coleção dele.	
VO_GIL_504_Female_Orc_UI_Monster_Gnarlroot_01	Espíritos ancestrais, ouçam o meu chamado! Pela raiz e pela vinha, vou esmagá-los. 	
VO_GIL_504_Female_Orc_UI_Monster_Griselda_01	Griselda pagou o preço por me aborrecer.	
VO_GIL_504_Female_Orc_UI_Monster_Groddo_01	Meu precioso Guardião do Pântano... Quando me abandonaram à beira da morte, ele zelou por mim.	
VO_GIL_504_Female_Orc_UI_Monster_Grubb_01	Nem eu consigo controlar o Grubb. 	
VO_GIL_504_Female_Orc_UI_Monster_Grum_01	Terra antiga, solo torturado, levante-se e arrase esse lugar amaldiçoado!	
VO_GIL_504_Female_Orc_UI_Monster_Gustave_01	Gustave! Deixe um pouco para mim.	
VO_GIL_504_Female_Orc_UI_Monster_Hannigul_01	Hannigul livrou a cidade dos vermes. Como você.	
VO_GIL_504_Female_Orc_UI_Monster_Havnixx_01	Hav'nixx ouve seus pensamentos. Ele se alimenta do seu medo.	
VO_GIL_504_Female_Orc_UI_Monster_Infinite_Toki_01	Gnomida intrometida. Isso acaba aqui. Vocês já não se conhecem?	
VO_GIL_504_Female_Orc_UI_Monster_Ivan_01	Ivan era um de vocês. Agora ele é meu.	
VO_GIL_504_Female_Orc_UI_Monster_Lord_Godfrey_01	Godfrey! Tínhamos um trato.\nEsse aí é seu. 	
VO_GIL_504_Female_Orc_UI_Monster_Lovers_01	É uma história de amor. É uma história de fantasmas. É a história do seu fim.	
VO_GIL_504_Female_Orc_UI_Monster_Mistwraith_01	Na calada da noite, os sussurros sussurram de volta. 	
VO_GIL_504_Female_Orc_UI_Monster_Mute_01	Silenciosa. Mortal. 	
VO_GIL_504_Female_Orc_UI_Monster_Niira_01	Nada de joguinhos dessa vez, Niira. Acabe com isso!	
VO_GIL_504_Female_Orc_UI_Monster_Raeth_01	Nem todos os Renegados abandonaram esse bosque. Alguns servem a mim.	
VO_GIL_504_Female_Orc_UI_Monster_Rancel_01	Os venenos de Rancel ajudaram a moldar essa madeira retorcida.	
VO_GIL_504_Female_Orc_UI_Monster_Sazzmi_01	Fique um pouco e escute. Fique para sempre.	
VO_GIL_504_Female_Orc_UI_Monster_Sephira_01	Com as asas e as garras, minhas irmãs harpias mantêm a paz no meu bosque.	
VO_GIL_504_Female_Orc_UI_Monster_Shivers_01	Levante-se, Calafrio! É hora da vingança. Eu lhe ofereço a Princesa de Guilnéas.	
VO_GIL_504_Female_Orc_UI_Monster_Shudderwock_01	O Calafrarte! Uma alegria de se ver... um pesadelo de se enfrentar. 	
VO_GIL_504_Female_Orc_UI_Monster_Splintergraft_01	Uivo da floresta, medo e gritos. Ramos e galhos, esmaguem os inimigos!	
VO_GIL_504_Female_Orc_UI_Monster_Sthara_01	O povo de Guilnéas aprenderá a me amar... depois que S'thara convencê-los.	
VO_GIL_504_Female_Orc_UI_Monster_Vitus_01	Um de vocês, abandonado! No meu bosque, encontrou um lar...	
VO_GIL_504_Female_Orc_UI_Monster_Wharrgarbl_01	Adoro murlocs. São como sapos, mas mais descoordenados.	
VO_GIL_598_Female_Human_SpecialSylvanas_01	Sua bruxa horrorosa! Você matou o meu irmão!	
VO_GIL_692_Male_Worgen_TUT_AdventureSelect_01	Heróis! Quem é bravo o bastante para se aventurar no Bosque das Bruxas?	
VO_GIL_692_Male_Worgen_TUT_BossReveal1_01	Monstros terríveis assombram a floresta ao redor de Guilnéas. \nCace-os, um por um.	
VO_GIL_692_Male_Worgen_TUT_BossReveal2_01	As criaturas ficam mais perigosas à medida que você avança pela floresta.	
VO_GIL_692_Male_Worgen_TUT_BossReveal3_01	"Hagatha" é o poder sombrio por trás do Bosque das Bruxas. Encontre-a e a detenha!	
VO_GIL_692_Male_Worgen_TUT_BossReveal3ALT_01	Esses monstros são obra de Hagatha. Derrote-os enquanto a procuramos!	
VO_GIL_692_Male_Worgen_TUT_CharacterSelect_01	Montei uma equipe de primeira. Cada um de vocês tem algo diferente para oferecer. 	
VO_GIL_692_Male_Worgen_TUT_Defeat1_01	Se sofrer uma derrota no Bosque das Bruxas, perderá o deck que montou.	
VO_GIL_692_Male_Worgen_TUT_FightBegin1Crowley_01	Crowley! Manobre o canhão para maximizar o estrago. 	
VO_GIL_692_Male_Worgen_TUT_FightBegin1Shaw_01	A caçada começou, Shaw. Use seus cães para surpreender os inimigos.	
VO_GIL_692_Male_Worgen_TUT_FightBegin1Tess_01	Vocês estarão por conta própria. Procurem feitiços para usar no campo de batalha.	
VO_GIL_692_Male_Worgen_TUT_FightBegin1Tess_02	Você é a última sobrevivente entre os meus filhos, Tess. Tenha cuidado.	
VO_GIL_692_Male_Worgen_TUT_FightBegin1Toki_01	Toki, sua capacidade de manipular o tempo faz com que tenha mais sorte que a maioria. 	
VO_GIL_692_Male_Worgen_TUT_FightBegin2_01	Essas... coisas... não são normais. Algo está voltando a floresta contra nós!	
VO_GIL_692_Male_Worgen_TUT_LootSelect1_01	Melhore seu deck para se aventurar com segurança pelo Bosque das Bruxas.	
VO_GIL_692_Male_Worgen_TUT_LootSelect2_02	Você! Você é a criatura por trás dessas... coisas?	
VO_GIL_692_Male_Worgen_TUT_TreasureSelect1_01	Mate monstros para receber recompensas poderosas. Escolha-as muito bem!	
VO_GIL_692_Male_Worgen_TUT_Victory_Final_01	Finalmente! A floresta já se aquieta e a luz retorna à cidade.	
VO_GILA_400h_Male_Human_EVENT_HAGATHA_ALMOSTDEAD_02	Não sem lutar. 	
VO_GILA_400h_Male_Human_EVENT_HAGATHA_INTRO_01	Meus cães a encontraram! Hagatha está aqui!	
VO_GILA_400h_Male_Human_EVENT_HAGATHA_LOWHEALTH_01	Ela está ferida. Sigam o rastro, rapazes. 	
VO_GILA_400h_Male_Human_EVENT_HAGATHA_TURN4_01	Eu tenho cães. 	
VO_GILA_400h_Male_Human_EVENT_IVAN_INTRO_01	Você era um de nós, Ivan!	
VO_GILA_400h_Male_Human_EVENT_NEMESIS_INTRO_01	Finalmente, Pele de Corvo!	
VO_GILA_400h_Male_Human_EVENT_NEMESIS_TURN2_01	Por quê? Por que se juntou a Hagatha?	
VO_GILA_500h3_Female_Human_EVENT_HAGATHA_SUB_IN_01	Protejam-se! Vou acabar com isso. 	
VO_GILA_500h3_Female_Human_EVENT_HAGATHA_TURN2_01	Guilnéas já sobreviveu a coisas piores que você, Hagatha. 	
VO_GILA_500h3_Female_Human_EVENT_HAGATHA_TURN4_01	Saia daqui, bruxa!	
VO_GILA_500h3_Female_Human_EVENT_HAGATHA_WOUNDED_01	Vá embora do bosque, e eu permitirei que viva.	
VO_GILA_500h3_Female_Human_EVENT_IVAN_INTRO_01	Ivan, você vem comigo.	
VO_GILA_500h3_Female_Human_EVENT_NEMESIS_INTRO_01	Calafrio. Achei que estivesse morto.	
VO_GILA_500h3_Female_Human_EVENT_NEMESIS_TURN2_01	Vou terminar o que o meu pai começou.	
VO_GILA_600h_Male_Worgen_EVENT_HAGATHA_SUB_IN_01	Você está na minha mira, Hagatha.	
VO_GILA_600h_Male_Worgen_EVENT_HAGATHA_TURN2_01	Essa terra pertence aos guilneanos.	
VO_GILA_600h_Male_Worgen_EVENT_HAGATHA_TURN4_01	Pelo menos eu TENHO um povo.	
VO_GILA_600h_Male_Worgen_EVENT_HAGATHA_WOUNDED_01	Vou explodir cada árvore. Vou deixar uma cratera no lugar desse bosque.	
VO_GILA_600h_Male_Worgen_EVENT_IVAN_INTRO_01	Encontrei você! Seu verme traidor.	
VO_GILA_600h_Male_Worgen_EVENT_NEMESIS_INTRO_01	Godfrey, traidor! Hora de pagar pelo que fez.	
VO_GILA_600h_Male_Worgen_EVENT_NEMESIS_TURN02_01	Você já era podre antes de morrer, Godfrey.	
VO_GILA_900h_Female_Gnome_EVENT_HAGATHA_ALMOST_DEAD_01	O tempo cura todas as feridas.	
VO_GILA_900h_Female_Gnome_EVENT_HAGATHA_SUB_IN_01	Vá descansar, chegou a minha vez. 	
VO_GILA_900h_Female_Gnome_EVENT_HAGATHA_TURN2_01	Eu movi montanhas pra te derrotar.	
VO_GILA_900h_Female_Gnome_EVENT_HAGATHA_WOUNDED_01	Sua hora está chegando, bruxa. 	
VO_GILA_900h_Female_Gnome_EVENT_IVAN_INTRO_01	Ivan, você tá frito. Eu sei como isso vai acabar.	
VO_GILA_900h_Female_Gnome_EVENT_NEMESIS_INTRO_B_01	Isso já... aconteceu antes?	
VO_GILA_900h_Female_Gnome_EVENT_NEMESIS_TURN2_02	O que eu acho que eu tô fazendo?!	
VO_GILA_900h_Female_Gnome_EVENT_NEMESIS_TURN6_01	Você veio do futuro? Quem de nós vai ganhar?	
VO_GILA_BOSS_20h_MangyWolf_DefeatPlayer	Grrowrooo!	
VO_GILA_BOSS_20h_MangyWolf_Emote	Grwruraaah!	
VO_GILA_BOSS_20h_MangyWolf_Intro	Rowooaoo!	
VO_GILA_BOSS_21h_Rottooth_Emote	ROOOooooah!	
VO_GILA_BOSS_21h_Rottooth_Intro	Nrgruhh... HOOOO!	
VO_GILA_BOSS_21h_Rottooth_PlayerDefeat	Unf, unf... Graaauur!	
VO_GILA_BOSS_22h_Male_Undead_Death_01	<Morte>	
VO_GILA_BOSS_22h_Male_Undead_DefeatPlayer_01	Finalmente vou poder comprar uma bainha pra minha adaga.	
VO_GILA_BOSS_22h_Male_Undead_EmoteResponse_01	Pode continuar falando. A tripulação tá chegando.	
VO_GILA_BOSS_22h_Male_Undead_EmoteResponseTess_01	Vai precisar implorar pro Capitão Calafrio, Princesa!	
VO_GILA_BOSS_22h_Male_Undead_EventPlaysCoin_01	Eu sabia que você tinha ouro!	
VO_GILA_BOSS_22h_Male_Undead_EventPlaysShiv_01	Gostei do seu estilo.	
VO_GILA_BOSS_22h_Male_Undead_Intro_01	O Capitão quer que eu acabe com você!	
VO_GILA_BOSS_22h_Male_Undead_IntroCrowley_01	Comandante, é? Isso dá dinheiro?	
VO_GILA_BOSS_22h_Male_Undead_IntroTess_01	O Capitão tá de olho em você, Princesa.	
VO_GILA_BOSS_23h_Male_Ettin_DefeatPlayer_01	Eu ganhei!\n(<i>Cadê meus lacaios?</i>)	
VO_GILA_BOSS_23h_Male_Ettin_EmoteResponse_02	Não gosto de tu!\n(<i>Eu gosto só um pouco de tu!</i>)	
VO_GILA_BOSS_23h_Male_Ettin_HeroPower_01	Lá vai você!	
VO_GILA_BOSS_23h_Male_Ettin_HeroPower_02	Upa!	
VO_GILA_BOSS_23h_Male_Ettin_HeroPower_03	Hua!	
VO_GILA_BOSS_23h_Male_Ettin_HeroPower_04	VOA!	
VO_GILA_BOSS_23h_Male_Ettin_HeroPower_05	Pega eles!	
VO_GILA_BOSS_23h_Male_Ettin_Intro_01	Você parece fácil de jogar.\n(<i>Fácil, fácil</i>.)	
VO_GILA_BOSS_24h_Male_Bogbeast_DefeatPlayer_01	Primeiros eles boiam, depois eles incham...	
VO_GILA_BOSS_24h_Male_Bogbeast_EmoteResponse_01	Borbulha e podridão, borbulha e podridão...	
VO_GILA_BOSS_24h_Male_Bogbeast_EventPlaysSmallMinion_01	Buaheheha.	
VO_GILA_BOSS_24h_Male_Bogbeast_EventPlaysSmallMinion_02	Huahahaha.	
VO_GILA_BOSS_24h_Male_Bogbeast_EventPlaysSmallMinion_03	Muhuhahah.	
VO_GILA_BOSS_24h_Male_Bogbeast_EventPlaysSmallMinion_04	Um erro.	
VO_GILA_BOSS_24h_Male_Bogbeast_HeroPower_01	Eu nunca estou sozinho.	
VO_GILA_BOSS_24h_Male_Bogbeast_HeroPower_02	O pântano tem seus segredos.	
VO_GILA_BOSS_24h_Male_Bogbeast_HeroPower_04	Olha o que apareceu.	
VO_GILA_BOSS_24h_Male_Bogbeast_Intro_01	Esse é o MEU\n pântano! Só os\n mortos vivem aqui.	
VO_GILA_BOSS_25h_Male_Dwarf_DefeatPlayerALT_01	Hagatha colocou tua cabeça a prêmio, sabia?	
VO_GILA_BOSS_25h_Male_Dwarf_EmoteResponse_01	Continue falando, que eu continuo caçando.	
VO_GILA_BOSS_25h_Male_Dwarf_EventPlayCompass_01	Bússola bacana! Acho que vou ficar com ela.	
VO_GILA_BOSS_25h_Male_Dwarf_EventPlaysSecret_01	Eu também sei brincar disso.	
VO_GILA_BOSS_25h_Male_Dwarf_EventPlaysSecret_02	Já vi isso antes.	
VO_GILA_BOSS_25h_Male_Dwarf_EventPlaysSecret_03	Tu se acha inteligente, é?	
VO_GILA_BOSS_25h_Male_Dwarf_EventPlayToolsOfTheTrade_01	Algumas dessas armas eram minhas, mocinha.	
VO_GILA_BOSS_25h_Male_Dwarf_EventPlayTrapper_01	Bah! É uma arte!	
VO_GILA_BOSS_25h_Male_Dwarf_EventTokiAbility_01	Eu falei nada de truques, gnomida!	
VO_GILA_BOSS_25h_Male_Dwarf_HeroPower_01	Cuidado onde pisa.	
VO_GILA_BOSS_25h_Male_Dwarf_HeroPower_02	Pise de leve. Cuidado.	
VO_GILA_BOSS_25h_Male_Dwarf_HeroPower_03	Sempre um passo à frente.	
VO_GILA_BOSS_25h_Male_Dwarf_HeroPower_04	Não existe lugar seguro.	
VO_GILA_BOSS_25h_Male_Dwarf_Intro_01	Tua cabeça tá a prêmio.	
VO_GILA_BOSS_25h_Male_Dwarf_IntroDarius_01	Tu é muito corajoso com esse trabuco na mão, Crowley.	
VO_GILA_BOSS_25h_Male_Dwarf_IntroShaw_01	Não sou como tu, Shaw. Não luto por causas perdidas. 	
VO_GILA_BOSS_25h_Male_Dwarf_IntroTess_02	Tu tá na minha mira, Greymane. E teu pai é o próximo!	
VO_GILA_BOSS_25h_Male_Dwarf_IntroToki_01	Nada de truques, gnomida!	
VO_GILA_BOSS_26h_Male_Tauren_Death_01	Meus... gnomos...	
VO_GILA_BOSS_26h_Male_Tauren_DeathToki_01	Que... ironia!	
VO_GILA_BOSS_26h_Male_Tauren_DefeatPlayer_01	Você não vai caber no meu saco.	
VO_GILA_BOSS_26h_Male_Tauren_DefeatPlayerToki_01	Nada como adicionar uma gnomida rara à coleção.	
VO_GILA_BOSS_26h_Male_Tauren_EmoteResponse_01	Não divido com ninguém!	
VO_GILA_BOSS_26h_Male_Tauren_EmoteResponseToki_01	Hmm... Mais um tagarela...	
VO_GILA_BOSS_26h_Male_Tauren_EventBurgle_01	Tem algum gnomo aí?	
VO_GILA_BOSS_26h_Male_Tauren_EventBurgle_03	Tem um gnomo no seu bolso?	
VO_GILA_BOSS_26h_Male_Tauren_EventPlayClockworkAssistant_01	É uma imitação barata. 	
VO_GILA_BOSS_26h_Male_Tauren_EventPlayGattlingGunner_01	Onde você encontrou esse daí?	
VO_GILA_BOSS_26h_Male_Tauren_EventPlaysClockwork_02	Modelo antigo, difícil de encontrar hoje em dia.	
VO_GILA_BOSS_26h_Male_Tauren_EventPlaysGnome_01	Eu tenho um igual a esse! Só não sei onde.	
VO_GILA_BOSS_26h_Male_Tauren_EventPlaysGnome_02	Uh! Esse é raro!	
VO_GILA_BOSS_26h_Male_Tauren_EventPlaysGnome_05	Ah... Você tem bom gosto. 	
VO_GILA_BOSS_26h_Male_Tauren_EventPlaysGnome_06	Vou botar esse aí na minha coleção.	
VO_GILA_BOSS_26h_Male_Tauren_EventPlaysLeper_01	Esse é meio nojento.	
VO_GILA_BOSS_26h_Male_Tauren_EventPlaysMillhouse_02	Esse aqui não cala a boca!	
VO_GILA_BOSS_26h_Male_Tauren_EventPlaysThermaplugg_02	Ótima relação custo-benefício!	
VO_GILA_BOSS_26h_Male_Tauren_EventSackOfGnomes_01	Esqueci o que tinha aí dentro.	
VO_GILA_BOSS_26h_Male_Tauren_EventSackOfGnomes_03	Perdi a conta de quantos tenho!	
VO_GILA_BOSS_26h_Male_Tauren_EventSackOfGnomes_04	O que temos aqui?	
VO_GILA_BOSS_26h_Male_Tauren_EventSackOfGnomes_05	Esses são os que eu não quero mais.	
VO_GILA_BOSS_26h_Male_Tauren_EventSilence_03	Quietinhos...	
VO_GILA_BOSS_26h_Male_Tauren_Intro_02	Você veio atrás dos meus gnomos?	
VO_GILA_BOSS_26h_Male_Tauren_IntroToki_02	Ah, mais um pra minha coleção...	
VO_GILA_BOSS_27h_Male_Construct_Death_02	Finalmente... escapamos!	
VO_GILA_BOSS_27h_Male_Construct_DefeatPlayer_01	Você não... era o meu alvo.	
VO_GILA_BOSS_27h_Male_Construct_EmoteResponse_01	Desculpe. \nEu faço isso de vez em quando.	
VO_GILA_BOSS_27h_Male_Construct_EventPlayDrBoom_02	Dr. Cabum?! Não me leve de volta ao laboratório!	
VO_GILA_BOSS_27h_Male_Construct_EventPlaySparePart_01	Tinha tantas peças... no laboratório...	
VO_GILA_BOSS_27h_Male_Construct_EventPlayUnstablePortal_01	O laboratório... em Eternévoa...	
VO_GILA_BOSS_27h_Male_Construct_HeroPowerBeast_02	...uma fera dentro de mim...	
VO_GILA_BOSS_27h_Male_Construct_HeroPowerDemon_01	...tamanha escuridão...	
VO_GILA_BOSS_27h_Male_Construct_HeroPowerDragon_01	...que criatura magnífica...	
VO_GILA_BOSS_27h_Male_Construct_HeroPowerGeneric_01	...mais um...	
VO_GILA_BOSS_27h_Male_Construct_HeroPowerMech_02	...um coração mecânico!	
VO_GILA_BOSS_27h_Male_Construct_HeroPowerMurloc_01	...mais peixe...	
VO_GILA_BOSS_27h_Male_Construct_HeroPowerPirate_01	...arrr?	
VO_GILA_BOSS_27h_Male_Construct_Intro_01	Prazer em assustar.	
VO_GILA_BOSS_29h_Female_Satyr_DefeatPlayer_01	Essa floresta tem sua própria música.	
VO_GILA_BOSS_29h_Female_Satyr_EmoteResponse_01	Hum... Você vai direto ao ponto. 	
VO_GILA_BOSS_29h_Female_Satyr_EventPlaysEnchantingTune_01	Você gosta da minha melodia?	
VO_GILA_BOSS_29h_Female_Satyr_EventPlaysEnchantingTune_02	Não dá pra gente se dar bem?	
VO_GILA_BOSS_29h_Female_Satyr_EventPlaysEnchantingTune_03	Senta aqui comigo! Eu não mordo.	
VO_GILA_BOSS_29h_Female_Satyr_EventPlaysOldMilitiaHorn_01	Um dueto?	
VO_GILA_BOSS_29h_Female_Satyr_EventPlaysSmallMinion_01	Oh... Que amorzinho!	
VO_GILA_BOSS_29h_Female_Satyr_EventPlaysSmallMinion_02	Você é quase tão fofo quanto eu!	
VO_GILA_BOSS_29h_Female_Satyr_EventPlaysSmallMinion_03	Dá vontade de morder!	
VO_GILA_BOSS_29h_Female_Satyr_HeroPower_01	Venham comigo, pequeninos.	
VO_GILA_BOSS_29h_Female_Satyr_HeroPower_02	Dó, Ré, Mi! Sigam-me!	
VO_GILA_BOSS_29h_Female_Satyr_HeroPower_03	Por aqui! Vamos.	
VO_GILA_BOSS_29h_Female_Satyr_HeroPower_04	Sigam os sons da minha melodia.	
VO_GILA_BOSS_29h_Female_Satyr_HeroPower_05	Eu vou cuidar de vocês! Confiem em mim.	
VO_GILA_BOSS_29h_Female_Satyr_Intro_01	Finalmente! Terei plateia.	
VO_GILA_BOSS_30h_Female_Gnome_DefeatPlayer_01	Nada é de graça, docinho.	
VO_GILA_BOSS_30h_Female_Gnome_EmoteResponse_01	Ah, agora é tarde demais.	
VO_GILA_BOSS_30h_Female_Gnome_EventBloodMagic_01	Tão frágil. Tão débil.	
VO_GILA_BOSS_30h_Female_Gnome_EventBloodMagic_02	Dê uma mordida.	
VO_GILA_BOSS_30h_Female_Gnome_EventBloodMagic_04	Tchu-Tchururu!	
VO_GILA_BOSS_30h_Female_Gnome_EventBloodMagic_05	Todos são iguais diante da minha magia.	
VO_GILA_BOSS_30h_Female_Gnome_EventBloodMagic_06	Gostoso, né?	
VO_GILA_BOSS_30h_Female_Gnome_Intro_01	Quer uma mordidinha?	
VO_GILA_BOSS_31h_Male_Treant_Death_01	<Morte>	
VO_GILA_BOSS_31h_Male_Treant_DefeatPlayer_01	Todos são formigas perante as árvores.	
VO_GILA_BOSS_31h_Male_Treant_Emote Response_01	Se uma árvore derruba você na floresta, será que faz um som?	
VO_GILA_BOSS_31h_Male_Treant_HeroPower_01	Liberte-se.	
VO_GILA_BOSS_31h_Male_Treant_HeroPower_02	Lascado.	
VO_GILA_BOSS_31h_Male_Treant_HeroPower_03	Vá, pequenino.	
VO_GILA_BOSS_31h_Male_Treant_HeroPower_05	Um pedaço de mim.	
VO_GILA_BOSS_31h_Male_Treant_Intro_01	Dê o folha daqui.	
VO_GILA_BOSS_32h_Female_Sprite_Death_01	Sem... graça!	
VO_GILA_BOSS_32h_Female_Sprite_DefeatPlayer_01	Ah, vamos brincar mais um pouquinho! Hã... oops!	
VO_GILA_BOSS_32h_Female_Sprite_EmoteResponse_01	Tá, tá. A gente joga depois!	
VO_GILA_BOSS_32h_Female_Sprite_EventPlaysAoEBuff_01	Você joga bem!	
VO_GILA_BOSS_32h_Female_Sprite_EventPlaysAoEBuff_02	Você já jogou antes.	
VO_GILA_BOSS_32h_Female_Sprite_EventPlaysBigMinion_01	Ei!! Isso é trapaça!	
VO_GILA_BOSS_32h_Female_Sprite_EventPlaysBigMinion_02	Uaaaau!	
VO_GILA_BOSS_32h_Female_Sprite_HeroPower_01	Cresce, cresce! Mais rápido!	
VO_GILA_BOSS_32h_Female_Sprite_HeroPower_02	Maior! Vamos lá!	
VO_GILA_BOSS_32h_Female_Sprite_HeroPower_03	Pra cima, pra cima, pra cima!	
VO_GILA_BOSS_32h_Female_Sprite_HeroPower_04	Acho que eu\n tô ganhando!	
VO_GILA_BOSS_32h_Female_Sprite_Intro_01	Quer jogar um jogo?	
VO_GILA_BOSS_33h_Male_Mech_Attack_01	Atacar.	
VO_GILA_BOSS_33h_Male_Mech_Death_01	Falha de segmentação...	
VO_GILA_BOSS_33h_Male_Mech_DefeatPlayer_01	Erro: nenhum alvo restante. Retomar patrulha.	
VO_GILA_BOSS_33h_Male_Mech_EmoteResponse_01	Olá, prazer em ceifar.	
VO_GILA_BOSS_33h_Male_Mech_EventPlayHarvestGolem_01	Atenção: o alvo não tem alma.	
VO_GILA_BOSS_33h_Male_Mech_EventWeaponKill_01	Ceifado.	
VO_GILA_BOSS_33h_Male_Mech_EventWeaponKill_02	Aprimorado.	
VO_GILA_BOSS_33h_Male_Mech_EventWeaponKill_03	Excluído.	
VO_GILA_BOSS_33h_Male_Mech_HeroPower_01	Colheita.	
VO_GILA_BOSS_33h_Male_Mech_HeroPower_02	Alimento.	
VO_GILA_BOSS_33h_Male_Mech_HeroPower_03	Reabastecendo.	
VO_GILA_BOSS_33h_Male_Mech_HeroPower_04	Reciclado.	
VO_GILA_BOSS_33h_Male_Mech_Intro_01	A colheita começará.	
VO_GILA_BOSS_34h_Male_Demon_DefeatPlayer_01	Sua alma é... poderosa. Vou adorar devorá-la!	
VO_GILA_BOSS_34h_Male_Demon_EmoteResponse_01	Espero que sua alma não seja tão... falante.	
VO_GILA_BOSS_34h_Male_Demon_HeroPower_01	Huuum… Ambrosia.	
VO_GILA_BOSS_34h_Male_Demon_HeroPower_02	Delícia.	
VO_GILA_BOSS_34h_Male_Demon_HeroPower_03	Você está empalidecendo.	
VO_GILA_BOSS_34h_Male_Demon_HeroPower_04	Vou tirar esse peso dos seus ombros.	
VO_GILA_BOSS_34h_Male_Demon_HeroPower_05	A alma não passa de um fardo.	
VO_GILA_BOSS_34h_Male_Demon_Intro_01	Em breve, você não passará de uma carcaça.	
VO_GILA_BOSS_35h_Male_Beast_DefeatPlayer	Aaagheaa!	
VO_GILA_BOSS_35h_Male_Beast_EmoteResponse	Aoor aagh harahrahgh!	
VO_GILA_BOSS_35h_Male_Beast_Intro	Rrghaghaogh!	
VO_GILA_BOSS_36h_Female_Human_Death_01	Ah, ribbit!	
VO_GILA_BOSS_36h_Female_Human_DefeatPlayer_01	Você obviamente não é o meu Príncipe!	
VO_GILA_BOSS_36h_Female_Human_Emote Response_01	Chega de conversa. Dá uma bitoca!	
VO_GILA_BOSS_36h_Female_Human_EventHex_01	Nossa! Que... encantador!	
VO_GILA_BOSS_36h_Female_Human_EventHex_02	Eu sei como é.	
VO_GILA_BOSS_36h_Female_Human_HeroPower_01	Muaac!	
VO_GILA_BOSS_36h_Female_Human_HeroPower_02	<Beijo>	
VO_GILA_BOSS_36h_Female_Human_HeroPower_03	Muá!	
VO_GILA_BOSS_36h_Female_Human_Intro_01	Ah, não. De novo, não.	
VO_GILA_BOSS_37h_Male_Murloc_DefeatPlayer_01	...	
VO_GILA_BOSS_37h_Male_Murloc_EmoteResponse_01	…!	
VO_GILA_BOSS_37h_Male_Murloc_EventPlayMurlocHolmes_02	…? …!	
VO_GILA_BOSS_37h_Male_Murloc_EventPlayPlague_01	…!	
VO_GILA_BOSS_37h_Male_Murloc_EventPlayPlague_02	…!	
VO_GILA_BOSS_37h_Male_Murloc_EventPlayPlague_07	…!	
VO_GILA_BOSS_37h_Male_Murloc_HeroPower_01	…	
VO_GILA_BOSS_37h_Male_Murloc_HeroPower_02	…	
VO_GILA_BOSS_37h_Male_Murloc_HeroPower_03	…!	
VO_GILA_BOSS_37h_Male_Murloc_HeroPower_04	…	
VO_GILA_BOSS_37h_Male_Murloc_Intro_01	…	
VO_GILA_BOSS_38h_Male_Goblin_Death_01	Nunca... mais!	
VO_GILA_BOSS_38h_Male_Goblin_DefeatPlayer_01	E disse o corvo... 	
VO_GILA_BOSS_38h_Male_Goblin_EmoteResponse_01	Que chamado péssimo!	
VO_GILA_BOSS_38h_Male_Goblin_EventBirdDead_01	Você... Você é um monstro!	
VO_GILA_BOSS_38h_Male_Goblin_EventBirdDead_02	O que foi que ele fez pra você?!	
VO_GILA_BOSS_38h_Male_Goblin_EventBirdDead_03	Por quê?? São só pássaros!	
VO_GILA_BOSS_38h_Male_Goblin_EventPlayBird_01	Voe! Liberte-se!	
VO_GILA_BOSS_38h_Male_Goblin_EventPlayBird_02	Eles passarão!	
VO_GILA_BOSS_38h_Male_Goblin_EventPlayBird_03	Olha o passarinho! 	
VO_GILA_BOSS_38h_Male_Goblin_EventPlayBird_04	Quem me dera ser um pássaro.	
VO_GILA_BOSS_38h_Male_Goblin_EventPlayerPlayBird_01	Esse é bonito.	
VO_GILA_BOSS_38h_Male_Goblin_EventPlayerPlayBird_02	Essa luta é pelos pássaros.	
VO_GILA_BOSS_38h_Male_Goblin_EventPlayNestingRoc_01	Eu... não queria chamar esse daí.	
VO_GILA_BOSS_38h_Male_Goblin_EventPlayNestingRoc_02	Hã... Quase lá.	
VO_GILA_BOSS_38h_Male_Goblin_HeroPower_01	Crá! Crá!	
VO_GILA_BOSS_38h_Male_Goblin_HeroPower_02	Crá... cof... blérg	
VO_GILA_BOSS_38h_Male_Goblin_HeroPower_03	Crá. Crá. Crá!	
VO_GILA_BOSS_38h_Male_Goblin_Intro_01	Lutar ou fugir? Por que não os DOIS?	
VO_GILA_BOSS_40h_Female_Treant_Death_01	Tombou.	
VO_GILA_BOSS_40h_Female_Treant_DefeatPlayer_01	O primeiro de muitos. Minha colheita tem início.	
VO_GILA_BOSS_40h_Female_Treant_EmoteResponse_01	Hora do desbaste.	
VO_GILA_BOSS_40h_Female_Treant_EventPlaysAxe_01	Tantos foram derrubados na flor da idade.	
VO_GILA_BOSS_40h_Female_Treant_EventPlaysAxe_02	Quantos de nós ainda sofrerão?	
VO_GILA_BOSS_40h_Female_Treant_EventPlaysWoodsmansAxe_01	Odioso. 	
VO_GILA_BOSS_40h_Female_Treant_HeroPower_01	A floresta os reivindica. 	
VO_GILA_BOSS_40h_Female_Treant_HeroPower_02	Esse bosque está vivo.	
VO_GILA_BOSS_40h_Female_Treant_HeroPower_03	Venha. Chegou sua hora.	
VO_GILA_BOSS_40h_Female_Treant_HeroPower_04	Você conhecerá o nosso ódio.	
VO_GILA_BOSS_40h_Female_Treant_Intro_01	Sua espécie vai pagar.	
VO_GILA_BOSS_41h_Female_HumanGhost_Death_01	Meu amor...	
VO_GILA_BOSS_41h_Female_HumanGhost_DefeatPlayer_01	Nada pode nos separar.	
VO_GILA_BOSS_41h_Female_HumanGhost_EmoteResponse_01	Deixe-nos em paz.	
VO_GILA_BOSS_41h_Female_HumanGhost_EventFatigue_01	Meu amor... Para onde foi?	
VO_GILA_BOSS_41h_Female_HumanGhost_EventFatigue_02	Não sinto mais a presença dele...	
VO_GILA_BOSS_41h_Female_HumanGhost_EventFatigueDeath_01	Finalmente... estamos livres? Obrigada!	
VO_GILA_BOSS_41h_Female_HumanGhost_EventPlayRin_01	Será ela quem nos libertará?	
VO_GILA_BOSS_41h_Female_HumanGhost_EventShuffle_01	Você... entende... não entende?	
VO_GILA_BOSS_41h_Female_HumanGhost_EventShuffle_02	Juntos... para sempre.	
VO_GILA_BOSS_41h_Female_HumanGhost_EventShuffle_03	Você é como nós.	
VO_GILA_BOSS_41h_Female_HumanGhost_HeroPower_01	Nunca desistirei.	
VO_GILA_BOSS_41h_Female_HumanGhost_HeroPower_02	Volte para mim!	
VO_GILA_BOSS_41h_Female_HumanGhost_HeroPower_03	Não vá...	
VO_GILA_BOSS_41h_Female_HumanGhost_HeroPower_04	Vou manter você por perto.	
VO_GILA_BOSS_41h_Female_HumanGhost_Intro_01	Estarei com você em breve, meu amor.	
VO_GILA_BOSS_41h_Male_NightElf_Death_01	Não...	
VO_GILA_BOSS_41h_Male_NightElf_DefeatPlayer_01	O Bosque das Bruxas não tem serventia para você.	
VO_GILA_BOSS_41h_Male_NightElf_EmoteResponse_02	Suas palavras não me convencerão.	
VO_GILA_BOSS_41h_Male_NightElf_EventHack_01	Quarenta machadadas!	
VO_GILA_BOSS_41h_Male_NightElf_EventHack_02	Retaliação.	
VO_GILA_BOSS_41h_Male_NightElf_EventHack_03	Saia... desse... bosque!	
VO_GILA_BOSS_41h_Male_NightElf_HeroPower_01	Só os fortes sobrevivem!	
VO_GILA_BOSS_41h_Male_NightElf_HeroPower_02	Pela raiz e pelo talo.	
VO_GILA_BOSS_41h_Male_NightElf_HeroPower_03	Teste sua força!	
VO_GILA_BOSS_41h_Male_NightElf_HeroPower_04	Toma essa	
VO_GILA_BOSS_41h_Male_NightElf_Intro_01	Vá embora, intruso.	
VO_GILA_BOSS_42h_Male_Ogre_DefeatPlayer_01	Por essa você não esperava. Nem eu.	
VO_GILA_BOSS_42h_Male_Ogre_EmoteResponse_01	Continue falando, que eu continuo pisando!	
VO_GILA_BOSS_42h_Male_Ogre_EventHeroPowerEnemy_01	Te peguei!	
VO_GILA_BOSS_42h_Male_Ogre_EventHeroPowerEnemy_02	Esmaga!	
VO_GILA_BOSS_42h_Male_Ogre_EventHeroPowerEnemy_03	Eu nunca erro!	
VO_GILA_BOSS_42h_Male_Ogre_EventHeroPowerFriendly_01	Ah, isso não tá certo.	
VO_GILA_BOSS_42h_Male_Ogre_EventHeroPowerFriendly_02	Alguma coisa estalou.	
VO_GILA_BOSS_42h_Male_Ogre_Intro_01	Quem tá aí? Sinto seu cheiro!	
VO_GILA_BOSS_43h_Male_HumanGhost_DefeatPlayer_01	Hora de cavar.	
VO_GILA_BOSS_43h_Male_HumanGhost_EmoteResponse_01	Vá embora.	
VO_GILA_BOSS_43h_Male_HumanGhost_EventPlaysDeathrattle_01	O chacoalhar dos ossos.	
VO_GILA_BOSS_43h_Male_HumanGhost_EventPlaysDeathrattle_02	Os mortos têm histórias para contar.	
VO_GILA_BOSS_43h_Male_HumanGhost_EventPlaysDeathrattle_03	Não somos tão diferentes.	
VO_GILA_BOSS_43h_Male_HumanGhost_EventPlaysDeathrattle_04	Entre. Descanse.	
VO_GILA_BOSS_43h_Male_HumanGhost_EventPlaysDeathrattle_05	Uma cova rasa para esse aí.	
VO_GILA_BOSS_43h_Male_HumanGhost_EventPlayStrokeOfMidnight_01	Como senti falta do soar dos sinos.	
VO_GILA_BOSS_43h_Male_HumanGhost_Intro_01	Você não devia estar por aí a essa hora.	
VO_GILA_BOSS_44h_Male_Troll_Death_01	<Morte>	
VO_GILA_BOSS_44h_Male_Troll_DefeatPlayer_02	Melhor prevenir do que levar uma surra!	
VO_GILA_BOSS_44h_Male_Troll_EmoteResponse_01	O dotô tem sempre razão.	
VO_GILA_BOSS_44h_Male_Troll_EventHeals_01	Ahhhhh...	
VO_GILA_BOSS_44h_Male_Troll_EventHeals_02	Esse é do bom...	
VO_GILA_BOSS_44h_Male_Troll_EventHeals_04	Hahaha. Hmmm...	
VO_GILA_BOSS_44h_Male_Troll_EventPlayerHeals_03	Ei, tá fazendo tudo errado.	
VO_GILA_BOSS_44h_Male_Troll_EventPlayerHeals_04	Deixa que eu trato disso.	
VO_GILA_BOSS_44h_Male_Troll_EventPlaysBandages_01	Material de qualidade.	
VO_GILA_BOSS_44h_Male_Troll_HeroPower_01	Vai sentir uma picadinha.	
VO_GILA_BOSS_44h_Male_Troll_HeroPower_02	Medo de agulha?	
VO_GILA_BOSS_44h_Male_Troll_HeroPower_03	Rápido e indolor. Quase sempre.	
VO_GILA_BOSS_44h_Male_Troll_HeroPower_04	Vudu? Eu sou licenciado!	
VO_GILA_BOSS_44h_Male_Troll_HeroPower_05	Que delícia, né?	
VO_GILA_BOSS_44h_Male_Troll_HeroPower_06	Vai doer um pouquinho.	
VO_GILA_BOSS_44h_Male_Troll_Intro_01	Venha! Sente-se. Mostre onde vai doer.	
VO_GILA_BOSS_45h_Female_Human_Death_02	<Morte>	
VO_GILA_BOSS_45h_Female_Human_DefeatPlayer_01	Você tinha tanto potencial.	
VO_GILA_BOSS_45h_Female_Human_EmoteResponse_01	Vamos conversar. E beber. 	
VO_GILA_BOSS_45h_Female_Human_EventDrawsExtraCards_01	Sim. Beba!	
VO_GILA_BOSS_45h_Female_Human_EventDrawsExtraCards_02	Tem gosto de quê?	
VO_GILA_BOSS_45h_Female_Human_EventDrawsExtraCards_03	Beba com gosto. Vamos lá.	
VO_GILA_BOSS_45h_Female_Human_EventFirstDamage_01	Isso significa que você não quer se juntar a nós?	
VO_GILA_BOSS_45h_Female_Human_EventPlayHallowedWater_01	Água benta? Blé! Nunca gostei do sabor.	
VO_GILA_BOSS_45h_Female_Human_EventPlaysAcolyte_01	Ah... Eu gosto dele. 	
VO_GILA_BOSS_45h_Female_Human_EventPlaysHoarder_01	Beba quando ele for embora.	
VO_GILA_BOSS_45h_Female_Human_EventPlaysNovice_01	Nossa mais nova iniciada. Viva!	
VO_GILA_BOSS_45h_Female_Human_Intro_01	Baixe as armas. Junte-se a nós. 	
VO_GILA_BOSS_46h_Male_Worgen_DefeatPlayer_01	Só os mais fortes sobrevivem.	
VO_GILA_BOSS_46h_Male_Worgen_EmoteResponse_01	Está sentindo esse cheiro? É medo.	
VO_GILA_BOSS_46h_Male_Worgen_EventPlayBloodMoon_01	AUUUUUU!	
VO_GILA_BOSS_46h_Male_Worgen_EventPlaysWorgen_01	Deplorável.	
VO_GILA_BOSS_46h_Male_Worgen_EventPlaysWorgen_03	Fracote!	
VO_GILA_BOSS_46h_Male_Worgen_EventPlaysWorgen_06	Você não é nada.	
VO_GILA_BOSS_46h_Male_Worgen_EventPlayTrapper_02	Sucumba à sua fúria!	
VO_GILA_BOSS_46h_Male_Worgen_Intro_01	Ainda está tentando me caçar?	
VO_GILA_BOSS_47h_Male_Monster_Death_01	Pois então tu mataste o Calafrarte!	
VO_GILA_BOSS_47h_Male_Monster_DefeatPlayer_01	A floresta se fortalece a cada herói que perece.	
VO_GILA_BOSS_47h_Male_Monster_EmoteResponse_01	Era briluz! As lesmolisas touvas roldavam e reviam nos gramilvos!	
VO_GILA_BOSS_47h_Male_Monster_HeroPower_01	Ei-lo que volta galunfante.	
VO_GILA_BOSS_47h_Male_Monster_HeroPower_02	Bravooh! Bravarte!	
VO_GILA_BOSS_47h_Male_Monster_HeroPower_03	Uma vez mais, nunca é demais.	
VO_GILA_BOSS_47h_Male_Monster_IntroALT_01	Foge do Calafrarte, o que não morre!	
VO_GILA_BOSS_48h_Female_Gnome_Death_01	Isso vai doer mais em você do que em mim!	
VO_GILA_BOSS_48h_Female_Gnome_DefeatPlayer_01	Já vou tarde! Peraí, isso é um paradoxo?	
VO_GILA_BOSS_48h_Female_Gnome_EmoteResponse_01	Eu sabia que eu ia dizer isso. 	
VO_GILA_BOSS_48h_Female_Gnome_EventAlt_01	Não! Vamos fazer tudo de novo.	
VO_GILA_BOSS_48h_Female_Gnome_EventAlt_02	Acho que foi mais ou menos... assim!	
VO_GILA_BOSS_48h_Female_Gnome_EventAlt_03	Parar! Rebobinar.	
VO_GILA_BOSS_48h_Female_Gnome_EventPlayerAltTime_01	Isso é novidade.	
VO_GILA_BOSS_48h_Female_Gnome_EventPlayerAltTime_02	Nossa, a gente bagunçou MESMO a linha do tempo.	
VO_GILA_BOSS_48h_Female_Gnome_EventPlayerTimeWarp_01	Tá tudo cada vez mais confuso.	
VO_GILA_BOSS_48h_Female_Gnome_EventPlayerTimeWarp_02	Nota mental: evitar essa luta.	
VO_GILA_BOSS_48h_Female_Gnome_EventPlayerTimeWarpToki_01	Pera! Não era pra você saber disso ainda!	
VO_GILA_BOSS_48h_Female_Gnome_EventPlayerTimeWarpToki_02	Eu lembro da última vez que eu fiz isso!	
VO_GILA_BOSS_48h_Female_Gnome_EventTimeWarp_01	Você vai aprender isso daqui a uns anos.	
VO_GILA_BOSS_48h_Female_Gnome_EventTimeWarp_02	Isso foi difícil de entender.	
VO_GILA_BOSS_48h_Female_Gnome_EventTurn2_01	Preciso me deter! Antes que eu chegue tarde demais!	
VO_GILA_BOSS_48h_Female_Gnome_EventTurn4_01	Você não pode vencer! Eu conheço todas as minhas jogadas!	
VO_GILA_BOSS_48h_Female_Gnome_EventTurn6_01	Nós duas vamos nos arrepender do que você vai fazer agora. A não ser que eu te impeça! 	
VO_GILA_BOSS_48h_Female_Gnome_HeroPower_01	Hora de acelerar as coisas!	
VO_GILA_BOSS_48h_Female_Gnome_HeroPower_02	Tique-taque, tique-taque!	
VO_GILA_BOSS_48h_Female_Gnome_HeroPower_03	Vamos acabar logo com isso.	
VO_GILA_BOSS_48h_Female_Gnome_Intro_01	Ah! Nos encontramos de novo! Pela primeira vez!	
VO_GILA_BOSS_48h_Female_Gnome_Intro_02	Eu de novo? É a segunda vez que lutamos. 	
VO_GILA_BOSS_48h_Female_Gnome_Intro_03	É a terceira vez que lutamos. Desista!	
VO_GILA_BOSS_48h_Female_Gnome_Intro_04	Você... de novo! Para com isso!	
VO_GILA_BOSS_48h_Female_Gnome_Intro_05	Quantas vezes vamos precisar fazer isso?	
VO_GILA_BOSS_48h_Female_Gnome_PlayerHeroPower_01	Por que achei que isso fosse uma boa ideia?	
VO_GILA_BOSS_48h_Female_Gnome_PlayerHeroPower_02	Eu me achava tão esperta.	
VO_GILA_BOSS_48h_Female_Gnome_PlayerHeroPower_03	De novo, não!	
VO_GILA_BOSS_48h_Female_Gnome_PlayerHeroPower_04	Eu tô ficando cansada de mim!	
VO_GILA_BOSS_49h_Female_Undead_Death_01	Um coração... apodrecido...	
VO_GILA_BOSS_49h_Female_Undead_DefeatPlayer_01	Você poderia ter se juntado a nós. 	
VO_GILA_BOSS_49h_Female_Undead_EmoteResponse_01	Venha para o nosso culto. Temos pizza. 	
VO_GILA_BOSS_49h_Female_Undead_EventFaithfulDies_01	Eu precisava dele!	
VO_GILA_BOSS_49h_Female_Undead_EventFaithfulDies_02	Bons ajudantes são difíceis de controlar.	
VO_GILA_BOSS_49h_Female_Undead_EventFaithfulDies_03	Não me esquecerei de você... seja lá qual for o seu nome!	
VO_GILA_BOSS_49h_Female_Undead_EventPact_01	Junte-se a nós...	
VO_GILA_BOSS_49h_Female_Undead_EventPact_02	Mais alguém se junta a nós!	
VO_GILA_BOSS_49h_Female_Undead_EventPact_03	Venha até mim, sim...	
VO_GILA_BOSS_49h_Female_Undead_EventPact_05	Meu culto cresce!	
VO_GILA_BOSS_49h_Female_Undead_EventPlayBird_01	De lagarto a perna fina, acúleo de colubrina.	
VO_GILA_BOSS_49h_Female_Undead_EventPlayCauldron_01	Mais dores para a barrela, mais fogo para a panela.	
VO_GILA_BOSS_49h_Female_Undead_EventPlayDragon_01	Escama de dragão com bucho de tubarão. Couro lupino com cipó-de-sino.	
VO_GILA_BOSS_49h_Female_Undead_EventPlayFaithful_01	Venham, minhas crianças. 	
VO_GILA_BOSS_49h_Female_Undead_EventPlayFaithful_02	Avancem, meus fiéis...	
VO_GILA_BOSS_49h_Female_Undead_EventPlayFaithful_03	Conceda-me sua vida.	
VO_GILA_BOSS_49h_Female_Undead_EventPlayFaithful_04	Meus gratos seguidores!	
VO_GILA_BOSS_49h_Female_Undead_EventPlayFaithful_05	Sirvam-me uma última vez!	
VO_GILA_BOSS_49h_Female_Undead_EventPlayHex_01	Pelos brandos de morcego, asa de bufo-sossego.	
VO_GILA_BOSS_49h_Female_Undead_EventPlaySnake_01	Lombo de cobra novinha, atirai no pote asinha!	
VO_GILA_BOSS_49h_Female_Undead_EventPlayTreant_01	Atirai no caldeirão madeira em podridão.	
VO_GILA_BOSS_49h_Female_Undead_EventTurn02_01	Se você visse o poder dela, Shaw, a seguiria como um de seus cães.	
VO_GILA_BOSS_49h_Female_Undead_Intro_02	Você nos encontrou? Ou fomos nós que trouxemos você aqui?	
VO_GILA_BOSS_50h_Male_Spirit_DefeatPlayer_01	É melhor queimar do que se desvanecer... 	
VO_GILA_BOSS_50h_Male_Spirit_EmoteResponse_01	Respire... 	
VO_GILA_BOSS_50h_Male_Spirit_EventPlaysEcho_01	Sim... 	
VO_GILA_BOSS_50h_Male_Spirit_EventPlaysEcho_02	Outro...	
VO_GILA_BOSS_50h_Male_Spirit_EventPlaysEcho_03	Mais...!	
VO_GILA_BOSS_50h_Male_Spirit_EventPlaysEcho_04	Hmhmhahaha	
VO_GILA_BOSS_50h_Male_Spirit_Intro_01	A bruma chama...	
VO_GILA_BOSS_51h_Male_Undead_Death_01	<Morte>	
VO_GILA_BOSS_51h_Male_Undead_DefeatPlayer_01	Ah! Parece que você não vai mais precisar desse ouro.	
VO_GILA_BOSS_51h_Male_Undead_EmoteResponse_01	Dobre a língua.	
VO_GILA_BOSS_51h_Male_Undead_EventPlayCoinPouch_01	Vamos lá. Me dê isso.	
VO_GILA_BOSS_51h_Male_Undead_EventPlayMinion_01	Ei! Tem um imposto sobre isso.	
VO_GILA_BOSS_51h_Male_Undead_EventPlayMinion_03	Isso vai lhe custar caro.	
VO_GILA_BOSS_51h_Male_Undead_EventPlayMinion_04	Você vai pagar por isso. Em breve.	
VO_GILA_BOSS_51h_Male_Undead_HeroPower_01	Uma gota no oceano.	
VO_GILA_BOSS_51h_Male_Undead_HeroPower_02	Aqui se faz, aqui se paga.	
VO_GILA_BOSS_51h_Male_Undead_HeroPower_03	Uma ninharia.	
VO_GILA_BOSS_51h_Male_Undead_HeroPower_04	Esvazie... seus... bolsos.	
VO_GILA_BOSS_51h_Male_Undead_Intro_01	Você tem cara de quem me deve dinheiro.	
VO_GILA_BOSS_52h_Male_Human_DefeatPlayerALT_02	Não vou voltar pra cadeia! Hoje não!	
VO_GILA_BOSS_52h_Male_Human_EmoteResponse_02	Aqui só tem cinza e fumaça.	
VO_GILA_BOSS_52h_Male_Human_EventPlayRoyalGift_02	Aah! Que brilhante! Não me importaria de levar pra casa.	
VO_GILA_BOSS_52h_Male_Human_EventPlayStealth_02	Que ironia!	
VO_GILA_BOSS_52h_Male_Human_EventPlayStealth_03	Ah... e depois EU é que sou o ladrão sorrateiro.	
VO_GILA_BOSS_52h_Male_Human_EventTransform_01	Agora você me irritou.	
VO_GILA_BOSS_52h_Male_Human_HeroPower_01	Invisível!	
VO_GILA_BOSS_52h_Male_Human_HeroPower_02	Não tô me escondendo, juro!	
VO_GILA_BOSS_52h_Male_Human_HeroPower_03	Camuflagem urbana.	
VO_GILA_BOSS_52h_Male_Human_HeroPower_04	Um toque de fuligem.	
VO_GILA_BOSS_52h_Male_Human_HeroPower_05	Tudo vira pó!	
VO_GILA_BOSS_52h_Male_Human_IntroALT_02	Ladrão?? Eu?? Imagina…	
VO_GILA_BOSS_52h2_Male_Worgen_EmoteResponse_02	Olha o que você me obrigou a fazer!	
VO_GILA_BOSS_52h2_Male_Worgen_HeroPower_01	AUUUUUU!	
VO_GILA_BOSS_52h2_Male_Worgen_HeroPower_02	Pega eles!	
VO_GILA_BOSS_52h2_Male_Worgen_HeroPower_03	Sinta a fera interior!	
VO_GILA_BOSS_54h_Male_Golem_DefeatPlayer_01	Como um graveto.	
VO_GILA_BOSS_54h_Male_Golem_EmoteResponse_01	É pau, é pedra.	
VO_GILA_BOSS_54h_Male_Golem_HeroPower_01	Todos pertencerão.	
VO_GILA_BOSS_54h_Male_Golem_HeroPower_02	O Bosque das Bruxas se expande.	
VO_GILA_BOSS_54h_Male_Golem_HeroPower_03	Arrasar a terra. Espalhar as sementes.	
VO_GILA_BOSS_54h_Male_Golem_HeroPower_04	O amor de Hagatha nos deixa mais fortes.	
VO_GILA_BOSS_54h_Male_Golem_HeroPower_05	Pela vontade de Hagatha.	
VO_GILA_BOSS_54h_Male_Golem_Intro_01	Tinha uma pedra no meio do caminho.	
VO_GILA_BOSS_55h_Female_NightElf_Death_01	Quem poderá salvá-los?	
VO_GILA_BOSS_55h_Female_NightElf_DefeatPlayer_01	Silêncio. Eu conduzirei seu espírito em segurança...	
VO_GILA_BOSS_55h_Female_NightElf_EmoteResponse_01	Shhhh! Na frente dos fogos-fátuos, não.	
VO_GILA_BOSS_55h_Female_NightElf_EventAssimilation_01	O que é seu será nosso.	
VO_GILA_BOSS_55h_Female_NightElf_EventAssimilation_02	Apoderem-se dos corpos!	
VO_GILA_BOSS_55h_Female_NightElf_EventAssimilation_03	É a nossa chance!	
VO_GILA_BOSS_55h_Female_NightElf_EventKillsWisp_02	Não!	
VO_GILA_BOSS_55h_Female_NightElf_EventKillsWisp_03	Pare!	
VO_GILA_BOSS_55h_Female_NightElf_EventKillsWisp_04	Meus filhos!	
VO_GILA_BOSS_55h_Female_NightElf_EventPlayCartographer_01	Uma fazedora de mapas! Talvez ela conheça a saída.	
VO_GILA_BOSS_55h_Female_NightElf_EventPlayCompass_01	Talvez isso nos ajude a encontrar a saída.	
VO_GILA_BOSS_55h_Female_NightElf_HeroPower_01	Venham, crianças.	
VO_GILA_BOSS_55h_Female_NightElf_HeroPower_02	Ah, aí está você.	
VO_GILA_BOSS_55h_Female_NightElf_HeroPower_03	Apareçam! Apareçam…	
VO_GILA_BOSS_55h_Female_NightElf_Intro_01	A maldição de Hagatha devora. Preciso salvar os meus filhos!	
VO_GILA_BOSS_56h_Male_Elemental_DefeatPlayer_01	Por que essa cara tão triste? 	
VO_GILA_BOSS_56h_Male_Elemental_EmoteResponse_01	Eu não teria dito melhor.	
VO_GILA_BOSS_56h_Male_Elemental_EventTransformFace_02	Ah! A máscara perfeita.	
VO_GILA_BOSS_56h_Male_Elemental_HeroPower_01	Uma nova máscara, um novo rosto.	
VO_GILA_BOSS_56h_Male_Elemental_HeroPower_02	Um novo rosto, uma nova pessoa.	
VO_GILA_BOSS_56h_Male_Elemental_HeroPower_03	Uma nova pessoa, uma nova vida.	
VO_GILA_BOSS_56h_Male_Elemental_HeroPower_05	Sempre mudando, sempre cambiante.	
VO_GILA_BOSS_56h_Male_Elemental_HeroPower_07	Somos um, somos todos.	
VO_GILA_BOSS_56h_Male_Elemental_HeroPower_09	Você se lembra de quem era?	
VO_GILA_BOSS_56h_Male_Elemental_HeroPower_10	Você só precisa de uma máscara.	
VO_GILA_BOSS_56h_Male_Elemental_IntroALT_02	Não somos tão diferentes, você e eu.	
VO_GILA_BOSS_57h_Male_Undead_DefeatPlayer_01	Você voltará, na hora certa. 	
VO_GILA_BOSS_57h_Male_Undead_EmoteResponse_01	Mandarei seus cumprimentos à Dama Sombria.	
VO_GILA_BOSS_57h_Male_Undead_EventDesecrate_01	Deixe a doença tomar conta de você.	
VO_GILA_BOSS_57h_Male_Undead_EventDesecrate_02	Mais um para as sepulturas.	
VO_GILA_BOSS_57h_Male_Undead_EventDesecrate_03	É contagioso.	
VO_GILA_BOSS_57h_Male_Undead_EventDesecrate_04	Você se unirá a eles em breve.	
VO_GILA_BOSS_57h_Male_Undead_EventPlayHolyBook_01	Suas escrituras não ajudarão.	
VO_GILA_BOSS_57h_Male_Undead_EventShallowGraves_01	Levantem-se!	
VO_GILA_BOSS_57h_Male_Undead_EventShallowGraves_02	Retornem!	
VO_GILA_BOSS_57h_Male_Undead_EventShallowGraves_03	A Dama Sombria chama vocês!	
VO_GILA_BOSS_57h_Male_Undead_HeroPower_01	Profanação.	
VO_GILA_BOSS_57h_Male_Undead_HeroPower_02	Um prato cheio.	
VO_GILA_BOSS_57h_Male_Undead_HeroPower_03	Inale a fumaça.	
VO_GILA_BOSS_57h_Male_Undead_HeroPower_04	A corrupção se espalha.	
VO_GILA_BOSS_57h_Male_Undead_Intro_01	Boas-vindas! Venha ver o que eu desenterrei.	
VO_GILA_BOSS_58h_Male_Giant_Death_01	<Morte>	
VO_GILA_BOSS_58h_Male_Giant_DefeatPlayer_01	Cidade boa. DE PISAR!	
VO_GILA_BOSS_58h_Male_Giant_DefeatPlayer_02	Vou sacudir essa cidade!	
VO_GILA_BOSS_58h_Male_Giant_EmoteResponse_01	Vou pisar em você!	
VO_GILA_BOSS_58h_Male_Giant_EventBigWeapon_01	Cê também esmaga?!	
VO_GILA_BOSS_58h_Male_Giant_EventMinionReturn_01	Achei você!	
VO_GILA_BOSS_58h_Male_Giant_EventMinionReturn_02	Você voltou!	
VO_GILA_BOSS_58h_Male_Giant_EventMinionReturn_03	Olá de novo.	
VO_GILA_BOSS_58h_Male_Giant_HeroPower_01	Fujaaaaaaa!	
VO_GILA_BOSS_58h_Male_Giant_HeroPower_02	Hã... BUU!	
VO_GILA_BOSS_58h_Male_Giant_HeroPower_03	Onde é que você se escondeu...?	
VO_GILA_BOSS_58h_Male_Giant_HeroPower_04	Fe, fi, fo, BUMMM.	
VO_GILA_BOSS_58h_Male_Giant_HeroPower_05	Você pode correr, mas... pode se esconder?	
VO_GILA_BOSS_58h_Male_Giant_Intro_01	Éééééé! Esmaga!	
VO_GILA_BOSS_59h_Male_Undead_DefeatPlayer_01	Você não passa de um cão rafeiro.	
VO_GILA_BOSS_59h_Male_Undead_DefeatPlayer_02	Adeus, camarada.	
VO_GILA_BOSS_59h_Male_Undead_DefeatPlayer_03	Mandaram você vir aqui me matar? Patético.	
VO_GILA_BOSS_59h_Male_Undead_EmoteResponse_01	Trouxe um canhão para um tiroteio? Quem é o covarde aqui?	
VO_GILA_BOSS_59h_Male_Undead_EventDeadlyShot_01	Na mosca!	
VO_GILA_BOSS_59h_Male_Undead_EventDeadlyShot_02	Que foi? Foi uma morte misericordiosa.	
VO_GILA_BOSS_59h_Male_Undead_EventQuickShot_01	Ainda tenho uns truques na manga.	
VO_GILA_BOSS_59h_Male_Undead_EventQuickShot_02	Saque!	
VO_GILA_BOSS_59h_Male_Undead_EventTurn02_01	Eu disse a Greymane que deixasse você apodrecer na prisão, Crowley.	
VO_GILA_BOSS_59h_Male_Undead_HeroPowerKills_01	Isso me traz lembranças.	
VO_GILA_BOSS_59h_Male_Undead_HeroPowerKills_02	Tinha me esquecido como era bom!	
VO_GILA_BOSS_59h_Male_Undead_HeroPowerKills_03	Ahhahaha.	
VO_GILA_BOSS_59h_Male_Undead_HeroPowerKills_04	Ver o mundo arder...	
VO_GILA_BOSS_59h_Male_Undead_HeroPowerKills_05	Queria fazer isso com cada um dos worgens.	
VO_GILA_BOSS_59h_Male_Undead_Intro_01	Sua jornada termina em agonia!	
VO_GILA_BOSS_59h_Male_Undead_IntroCrowley_01	Quem é você para falar de lealdade, Crowley? 	
VO_GILA_BOSS_60h_Male_HumanGhost_Death_02	Levado... pelo mar...	
VO_GILA_BOSS_60h_Male_HumanGhost_DefeatPlayer_01	Boas-vindas a bordo. Para sempre!	
VO_GILA_BOSS_60h_Male_HumanGhost_EmoteResponseTess_01	É melhor começar a acreditar em histórias de assombração, senhorita.	
VO_GILA_BOSS_60h_Male_HumanGhost_EventBigWeapon_01	Bonita e afiada.	
VO_GILA_BOSS_60h_Male_HumanGhost_EventBigWeapon_02	Que belezura.	
VO_GILA_BOSS_60h_Male_HumanGhost_EventBigWeapon_03	Já viu lâmina mais bonita?	
VO_GILA_BOSS_60h_Male_HumanGhost_EventPlayerKingsblade_01	Calma aí... Tem mais de uma?	
VO_GILA_BOSS_60h_Male_HumanGhost_EventPlayKingsblade_01	Rodei o mundo em busca dessa belezura.	
VO_GILA_BOSS_60h_Male_HumanGhost_EventPlayKingsblade_02	Ela sempre volta pra mim.	
VO_GILA_BOSS_60h_Male_HumanGhost_EventPlayKragg_02	Trocou o mar pelo céu? Que imbecil.	
VO_GILA_BOSS_60h_Male_HumanGhost_EventPlayPatches_02	Remendo! Você perdeu alguns olhos, velho amigo!	
VO_GILA_BOSS_60h_Male_HumanGhost_EventPlayTuskarrRaider_01	Qualquer um pode ser pirata hoje em dia.	
VO_GILA_BOSS_60h_Male_HumanGhost_EventTurn2_01	Quer vingança\nmelhor que trazer\nvocê pra minha\ntripulação?	
VO_GILA_BOSS_60h_Male_HumanGhost_HeroPower_01	Minha espada canta, e eu canto com ela!	
VO_GILA_BOSS_60h_Male_HumanGhost_HeroPower_07	Afoguem o barulho das ondas!	
VO_GILA_BOSS_60h_Male_HumanGhost_IntroTess_01	Sim! É a filha do rei que acabou com a gente. 	
VO_GILA_BOSS_61h_Female_Orc_DefeatPlayer_01	Eu e o bosque somos um só, e eu nunca morrerei.	
VO_GILA_BOSS_61h_Female_Orc_EmoteResponse_01	Veja o seu reflexo. Veja o seu fim.	
VO_GILA_BOSS_61h_Female_Orc_EmoteResponseCrowley_01	Você está tentando compensar alguma coisa, Crowley? Hmmm?	
VO_GILA_BOSS_61h_Female_Orc_EmoteResponseShaw_01	Blá, blá, blá. E seus cachorros também são irritantes!	
VO_GILA_BOSS_61h_Female_Orc_EmoteResponseTess_01	Seus pais não gostavam muito de você, né?	
VO_GILA_BOSS_61h_Female_Orc_EmoteResponseToki_01	Como escapou dos caça-gnomos?	
VO_GILA_BOSS_61h_Female_Orc_EventCannonKill_01	Maldito seja esse canhão!	
VO_GILA_BOSS_61h_Female_Orc_EventCannonKill_02	Você faz muito barulho. Pouco inteligente.	
VO_GILA_BOSS_61h_Female_Orc_EventCannonKill_03	O ferro enferruja como a pele se decompõe.	
VO_GILA_BOSS_61h_Female_Orc_EventCannonKill_04	Você late alto, vira-lata.	
VO_GILA_BOSS_61h_Female_Orc_EventCrowleyHagathaLow_01	Eu nunca morrerei enquanto esse bosque sobreviver...	
VO_GILA_BOSS_61h_Female_Orc_EventCrowleyLow_01	Vou enterrá-lo com o seu canhão, Crowley.	
VO_GILA_BOSS_61h_Female_Orc_EventCrowleyTurn2_01	Você abandonou essa terra! Eu a retomei!	
VO_GILA_BOSS_61h_Female_Orc_EventCrowleyTurn4_01	Você é um pária até entre o seu povo.	
VO_GILA_BOSS_61h_Female_Orc_EventShawHoundKill_01	Cachorro mau.	
VO_GILA_BOSS_61h_Female_Orc_EventShawHoundKill_02	Vira-latas imundos.	
VO_GILA_BOSS_61h_Female_Orc_EventShawLow_01	A maldição do Bosque das Bruxas cai sobre você.	
VO_GILA_BOSS_61h_Female_Orc_EventShawTurn2_01	Todas as criaturas da floresta passam a ser minhas...	
VO_GILA_BOSS_61h_Female_Orc_EventShawTurn2_02	Quando sentem o meu toque.	
VO_GILA_BOSS_61h_Female_Orc_EventShawTurn4_01	Mil espíritos sombrios se unem contra você. 	
VO_GILA_BOSS_61h_Female_Orc_EventSummonCrowskin_01	Meu culto nunca morrerá. 	
VO_GILA_BOSS_61h_Female_Orc_EventSummonGodfrey_01	Godfrey, os espíritos da floresta o chamam de volta...	
VO_GILA_BOSS_61h_Female_Orc_EventTessHagathaLow_01	Eu SOU o bosque. 	
VO_GILA_BOSS_61h_Female_Orc_EventTessLow_01	Seus restos alimentarão a floresta.	
VO_GILA_BOSS_61h_Female_Orc_EventTessScavenges_01	Nada será capaz de salvar você.	
VO_GILA_BOSS_61h_Female_Orc_EventTessScavenges_02	Ah, continue cavando, Princesa.	
VO_GILA_BOSS_61h_Female_Orc_EventTessScavenges_03	Revirando o lixo?	
VO_GILA_BOSS_61h_Female_Orc_EventTessScavenges_04	Você não encontrará consolo nos canaviais.	
VO_GILA_BOSS_61h_Female_Orc_EventTessTurn2_01	A floresta vai engolir a sua cidade. 	
VO_GILA_BOSS_61h_Female_Orc_EventTessTurn4_01	Essa terra estava MORTA! Eu a trouxe de volta à vida. Ela é MINHA.	
VO_GILA_BOSS_61h_Female_Orc_EventTokiHagathaLow_01	Os espíritos desse bosque me preservarão...	
VO_GILA_BOSS_61h_Female_Orc_EventTokiHeroPower_01	...o que aconteceu?	
VO_GILA_BOSS_61h_Female_Orc_EventTokiHeroPower_03	Você está brincando com a sorte.	
VO_GILA_BOSS_61h_Female_Orc_EventTokiHeroPower_04	Os espíritos veem o que você faz. 	
VO_GILA_BOSS_61h_Female_Orc_EventTokiHeroPower_05	Um dia você vai pagar pelos seus truques.	
VO_GILA_BOSS_61h_Female_Orc_EventTokiLow_01	Você não tem mais truques, gnomida. 	
VO_GILA_BOSS_61h_Female_Orc_EventTokiTurn2_01	Você também é uma abominação, gnomida.	
VO_GILA_BOSS_61h_Female_Orc_EventTokiTurn4_01	Você pensa que\nsuas tramoias são invisíveis.\nEu vejo tudo.	
VO_GILA_BOSS_61h_Female_Orc_Intro_01	Eu sou o coração desse bosque.	
VO_GILA_BOSS_61h_Female_Orc_IntroCrowley_01	A paz será uma benção quando eu silenciar essa arma.	
VO_GILA_BOSS_61h_Female_Orc_IntroShaw_01	Vou voltar seus cães contra o dono.	
VO_GILA_BOSS_61h_Female_Orc_IntroTess_01	Vá embora, "Princesa". Diga ao seu pai que não há esperança.	
VO_GILA_BOSS_61h_Female_Orc_IntroToki_01	Você brinca com o destino, mas as árvores e as estrelas não esquecem.	
VO_GILA_BOSS_62h_GustaveTheGutRipper_Emote	OOOoozzzz	
VO_GILA_BOSS_62h_GustaveTheGutRipper_Intro	WhrReeooo!	
VO_GILA_BOSS_62h_GustaveTheGutRipper_PlayerDefeat	Mragrararuh!	
VO_GILA_BOSS_63h_Female_Harpy_Death_01	Meus... ovos...	
VO_GILA_BOSS_63h_Female_Harpy_DefeatPlayer_01	Irmãs! Tragam os restos para o meu ninho.	
VO_GILA_BOSS_63h_Female_Harpy_EmoteResponse_01	Temo que um debate prolongado afete a dinâmica do nosso relacionamento. 	
VO_GILA_BOSS_63h_Female_Harpy_HeroPower_01	Meu!	
VO_GILA_BOSS_63h_Female_Harpy_HeroPower_02	Sua magia só escurece este bosque.	
VO_GILA_BOSS_63h_Female_Harpy_HeroPower_03	Eu fico cada vez mais forte. 	
VO_GILA_BOSS_63h_Female_Harpy_Intro_01	Daqui você não passará. Ordens de Hagatha!	
VO_GILA_BOSS_64h_Male_Goblin_Death_01	E-e-espere!	
VO_GILA_BOSS_64h_Male_Goblin_DefeatPlayer_01	Obrigado, obrigado! Agora, quanto ao meu pagamento...	
VO_GILA_BOSS_64h_Male_Goblin_EmoteResponse_01	Eu adoro quando o público participa.	
VO_GILA_BOSS_64h_Male_Goblin_EvenPlayCursedCurio_01	Que belezura! Onde consigo um desses?	
VO_GILA_BOSS_64h_Male_Goblin_EventMCTech_01	Ei, ei! Quem faz isso aí sou eu!	
VO_GILA_BOSS_64h_Male_Goblin_EventMindControl_01	Tá tentando me enganar, é?	
VO_GILA_BOSS_64h_Male_Goblin_HeroPowerHandBig_01	Você está ficando com sono.	
VO_GILA_BOSS_64h_Male_Goblin_HeroPowerHandBig_03	Suas pálpebras estão pesadas. Você não consegue manter os olhos abertos!	
VO_GILA_BOSS_64h_Male_Goblin_HeroPowerHandEmpty_01	Zzzz... Zzzz...	
VO_GILA_BOSS_64h_Male_Goblin_HeroPowerHandMedium_01	Olhe nos meus olhos.	
VO_GILA_BOSS_64h_Male_Goblin_HeroPowerHandMedium_02	Olhe para o meu relógio... Pera... Pera... Como era mesmo?	
VO_GILA_BOSS_64h_Male_Goblin_HeroPowerHandMedium_03	Pra frente e pra trás. Veja como ele balança!	
VO_GILA_BOSS_64h_Male_Goblin_HeroPowerHandSmall_01	Onde eu estava mesmo?	
VO_GILA_BOSS_64h_Male_Goblin_HeroPowerHandSmall_02	Você... está cansando.	
VO_GILA_BOSS_64h_Male_Goblin_Intro_01	Ah! Um voluntário? 	
VO_GILA_BOSS_66h_Female_Undead_DefeatPlayer_01	…	
VO_GILA_BOSS_66h_Female_Undead_EmoteResponse_02	…	
VO_GILA_BOSS_66h_Female_Undead_EventPlayHorn_02	…	
VO_GILA_BOSS_66h_Female_Undead_HeroPower_01	…	
VO_GILA_BOSS_66h_Female_Undead_HeroPower_02	…	
VO_GILA_BOSS_66h_Female_Undead_HeroPower_03	…	
VO_GILA_BOSS_66h_Female_Undead_Intro_01	…	
VO_GILA_BOSS_67h_Male_Undead_DefeatPlayer_01	A vida não passa de uma dança de rato.	
VO_GILA_BOSS_67h_Male_Undead_EmoteResponse_01	Não quero ouvir nem um guincho!	
VO_GILA_BOSS_67h_Male_Undead_EventPlayRat_01	Eu gosto desses bichinhos. Principalmente na sopa.	
VO_GILA_BOSS_67h_Male_Undead_EventPlayRat_02	Criaturas tão simplórias. Como você.	
VO_GILA_BOSS_67h_Male_Undead_EventPlayRat_03	Cuidado, esses dentinhos fazem um estrago.	
VO_GILA_BOSS_67h_Male_Undead_EventPlayRatTrap_01	Uma caixa? Um graveto? Cadê a sutileza?	
VO_GILA_BOSS_67h_Male_Undead_Intro_01	Peguei você! Eu sempre soube como pegar um rato.	
VO_GILA_BOSS_68h_Male_Undead_DefeatPlayer_01	Você durou bastante! Vai ser interessante estudar o seu caso.	
VO_GILA_BOSS_68h_Male_Undead_EmoteResponse_01	Tem ideia de como é difícil CRIAR uma praga?	
VO_GILA_BOSS_68h_Male_Undead_EventPlayPoison_01	Um passo à minha frente.	
VO_GILA_BOSS_68h_Male_Undead_EventPlayPoison_02	Ah! Veneno!	
VO_GILA_BOSS_68h_Male_Undead_EventPlayPoison_03	Eu gosto do seu jeito de pensar.	
VO_GILA_BOSS_68h_Male_Undead_EventPlayPoison_04	Posso pegar emprestado? É rápido.	
VO_GILA_BOSS_68h_Male_Undead_Intro_01	Que venham os seus mortos! Eu preciso deles.	
VO_HeadlessHorseman_Male_Human_HallowsEve_01	Estou aqui, ó corpo imbecil!	
VO_HeadlessHorseman_Male_Human_HallowsEve_02	Escute, verme. Desprezo teu viver. Agora sinta o mundo ARDER!	
VO_HeadlessHorseman_Male_Human_HallowsEve_04	O céu, uma treva. O mundo, uma pira. Você luta, mas a roda do destino gira!	
VO_HeadlessHorseman_Male_Human_HallowsEve_07	Minhas chamas se apagaram completamente. Eu mesmo devo mandá-los à escuridão emergente!	
VO_HeadlessHorseman_Male_Human_HallowsEve_08	Meu sangue vocês estão ávidos para derramar. Se querem vencer, é minha cabeça que devem aniquilar!	
VO_HeadlessHorseman_Male_Human_HallowsEve_10	HAHAHAHAHHA AHAHAAAAAA!	
VO_HeadlessHorseman_Male_Human_HallowsEve_11	AAAAAHAHAHA HAHHAAHAH!	
VO_HeadlessHorseman_Male_Human_HallowsEve_12	Preparem-se, os sinos soaram. Protejam os fracos, os velhos, todos que restaram!	
VO_HeadlessHorseman_Male_Human_HallowsEve_13	Cada um de vocês pagará caro. Clamem por piedade, pois é tempo de desamparo!	
VO_HeadlessHorseman_Male_Human_HallowsEve_17	HAHAHAHAahaha....	
VO_HRW_DEBUG_01	1	
VO_HRW_DEBUG_02	2	
VO_HRW_DEBUG_03	3	
VO_HRW_DEBUG_04	4	
VO_HRW_DEBUG_05	5	
VO_HRW_TEST_00	Eu vou limpar vocês dois da Maldição da Carne!	
VO_HRW_TEST_01	Muito bem! Vocês derrotaram o chefe juntos.\n\nOs dois jogadores vencem!	
VO_HRW_TEST_02	Derrote o Engrenochefe Mecanozod com outro jogador para vencer!	
VO_HRW_TEST_ABILITY_00	Causando dano a um herói.	
VO_HRW_TEST_ABILITY_01	Destruindo lacaio de ataque mais forte.	
VO_HRW_TEST_ABILITY_02	Arremessando 3 bombas.	
VO_HRW_TEST_ABILITY_03	Causando dano a todos os outros personagens.	
VO_HRW_TEST_ABILITY_04	Recebendo 2 de ataque.	
VO_HRW_TEST_ABILITY_05	Causando dano a ambos os heróis.	
VO_HRW_TEST_ABILITY_06	Silenciando o Andarilho das Lendas Cho. Permanentemente.	
VO_HRW_TEST_ABILITY_98	A mesa está cheia. Limpando a mesa.	
VO_ICC_841_Female_Sanlayn_Death_02	Mas... estávamos nos dando... tão... bem...	
VO_ICC01_Jaina_Female_Human_DrawsRager_01	Isso é sério mesmo!?	
VO_ICC01_Jaina_Female_Human_JainaDKIntro_05	Ouço os sussurros... dos mortos...	
VO_ICC01_Jaina_Female_Human_PostDeath_02	Temos que... resistir...	
VO_ICC01_LichKing_Male_Human_EmoteResponse_01	Suas súplicas não serão atendidas.	
VO_ICC01_LichKing_Male_Human_EndOfTurn2_01	Hahaha... Isso é só o COMEÇO!	
VO_ICC01_LichKing_Male_Human_EndOfTurn2_02	E este deck nem é o mais agressivo. 	
VO_ICC01_LichKing_Male_Human_Idle_01	Vamos. Acabe seu turno para eu acabar com você!	
VO_ICC01_LichKing_Male_Human_Intro_01	Escolha seus cards com cuidado: é a última vez que fará isso.	
VO_ICC01_LichKing_Male_Human_JainaDKIntro_01	Erga-se, maga. Sua tarefa ainda não terminou. 	
VO_ICC01_LichKing_Male_Human_JainaDKIntro_02	Junte-se a mim. Os vivos tremerão, e os mortos obedecerão.	
VO_ICC01_LichKing_Male_Human_JainaDKIntro_03	Seus inimigos terão mais medo de você do que da morte...	
VO_ICC01_LichKing_Male_Human_JainaDKintro_06	Agora pode tirar esse monte de sujeira da minha frente.	
VO_ICC01_LichKing_Male_Human_PlaysFrostmourne_01	Seu ranque vai sofrer.	
VO_ICC01_LichKing_Male_Human_Turn1_01	Meus cards são tão bons...	
VO_ICC01_LichKing_Male_Human_Turn11_01	Minhas hordas de mortos-vivos estão ao seu dispor.	
VO_ICC01_LichKing_Male_Human_Turn13_01	Faça com que sofram.	
VO_ICC01_LichKing_Male_Human_Turn15_01	Piedade é para os fracos.	
VO_ICC01_LichKing_Male_Human_Turn2_02	Contemple meu poder.	
VO_ICC01_LichKing_Male_Human_Turn4_01	Ninguém pode salvar você.	
VO_ICC01_LichKing_Male_Human_Turn4_02	Meu poder é absoluto.	
VO_ICC01_LichKing_Male_Human_Turn5_01	Ninguém resiste a mim.	
VO_ICC01_LichKing_Male_Human_Turn5_02	Você também servirá a mim. 	
VO_ICC01_Tirion_Male_Human_AFKay_01	Preste atenção! 	
VO_ICC01_Tirion_Male_Human_EmoteResponse_02	Eu nem sei mais quem é você!	
VO_ICC01_Tirion_Male_Human_EndOfTurn4_01	Resista, camarada! 	
VO_ICC01_Tirion_Male_Human_EndOfTurn4_02	Eu tenho fé que a providência lhe dará enorme poder quando você mais necessitar.	
VO_ICC01_Tirion_Male_Human_EndOfTurn4_03	Eu tenho fé que a providência intervirá quando você necessitar.	
VO_ICC01_Tirion_Male_Human_Flavor01_01	Vou precisar de aventureiros mais competentes...	
VO_ICC01_Tirion_Male_Human_Flavor02_01	Jaina, você virou um monstro!	
VO_ICC01_Tirion_Male_Human_Flavor03_01	O Lich Rei pagará por essa atrocidade! 	
VO_ICC01_Tirion_Male_Human_JainaDKintro_05	O que é isso? O que você se tornou?	
VO_ICC01_Tirion_Male_Human_PauseDeath_02	Não faça nada!	
VO_ICC01_Tirion_Male_Human_PostDeath_01	Não deixe que controlem sua vontade. Rebele-se contra o Lich Rei! 	
VO_ICC01_Tirion_Male_Human_TerribleTank_01	Por que você não está provocando?	
VO_ICC01_Tirion_Male_Human_Turn2_01	Não tema! Nós já estamos a caminho.	
VO_ICC01_Tirion_Male_Human_Turn3_01	Estamos quase lá! Como vão as coisas? Tudo bem?	
VO_ICC01_Tirion_Male_Human_Turn6_01	Nós estamos quase prontos para...	
VO_ICC01_Tirion_Male_Human_Turn6_02	O quê!?	
VO_ICC01_Tirion_Male_Human_Turn8_01	Você está frente a frente com os campeões de Azeroth!	
VO_ICC04_LichKing_Male_Human_BreathNoMinion_01	Quê? Nenhum lacaio para Sindragosa congelar? Que incompetência.	
VO_ICC04_LichKing_Male_Human_Lose_01	Seus restos congelados servirão de alerta a outros...	
VO_ICC04_LichKing_Male_Human_Turn5_01	Você deve estar se perguntando: "Como me livro desses blocos de gelo?".	
VO_ICC04_LichKing_Male_Human_Turn5_02	A resposta é: não tem como!	
VO_ICC04_LichKing_Male_Human_Win_02	ESTE DECK INTEIRO PRECISA SER PURIFICADO! 	
VO_ICC04_Sindragosa_Female_Dragon_Bounce_01	Traga de volta!	
VO_ICC04_Sindragosa_Female_Dragon_BreathNoRoomLeft_01	Não há mais lacaios para proteger você.	
VO_ICC04_Sindragosa_Female_Dragon_Death_01	Roaaaaarr!	
VO_ICC04_Sindragosa_Female_Dragon_EmoteResponse_01	Esses jogos me cansam!	
VO_ICC04_Sindragosa_Female_Dragon_Intro_01	Que tolice você ter vindo aqui!	
VO_ICC04_Sindragosa_Female_Dragon_LichKing_01	Eu fui traída!	
VO_ICC04_Sindragosa_Female_Dragon_Malygos_01	Malygos... meu antigo amor!	
VO_ICC04_Sindragosa_Female_Dragon_PlayerPlaysMinion_02	Escolha suas vítimas com cuidado. A mão fria da morte virá buscar todos vocês. 	
VO_ICC04_Sindragosa_Female_Dragon_SecondBreath_01	Sintam o ilimitado poder de meu mestre e desesperem-se!	
VO_ICC04_Sindragosa_Female_Dragon_Sindragosa_01	Nossa magia patética nos trai!	
VO_ICC04_Sindragosa_Female_Dragon_Sindragosa_02	Nossa magia patética está nos traindo!	
VO_ICC04_Sindragosa_Female_Dragon_TransformDK_01	Eu sirvo a apenas um mestre!	
VO_ICC04_Sindragosa_Female_Dragon_UnchainedMagic_02	Sua magia patética traiu vocês!	
VO_ICC04_Sindragosa_Female_Dragon_UnchainedMagic_04	Sofram!	
VO_ICC05_Lanathel_Female_Sanlayn_BiteOoze_01	Uhhh, você botou sua boca NISSO?	
VO_ICC05_Lanathel_Female_Sanlayn_BitePoisonous_01	Lembre-se de cuspir o veneno quando terminar.	
VO_ICC05_Lanathel_Female_Sanlayn_BiteReminder_01	Está esquecendo alguma coisa? A sede arde em suas veias!	
VO_ICC05_Lanathel_Female_Sanlayn_BiteReminderAcolyte_01	Não hesite. Alimente-se! Alimente-se dos que dormem!	
VO_ICC05_Lanathel_Female_Sanlayn_BiteShell_01	Não vá quebrar um dente.	
VO_ICC05_Lanathel_Female_Sanlayn_BiteSpikes_01	Essa deve ter machucado a boca.	
VO_ICC05_Lanathel_Female_Sanlayn_BloodEssence_01	Está ficando cheio demais aqui.	
VO_ICC05_Lanathel_Female_Sanlayn_BloodEssence_02	Você não ia usar isso aí, não é?	
VO_ICC05_Lanathel_Female_Sanlayn_BloodEssence_03	Que tal variar as coisas?	
VO_ICC05_Lanathel_Female_Sanlayn_BloodPrince_01	Traidor! Devolva suas presas!	
VO_ICC05_Lanathel_Female_Sanlayn_BossBite_01	Conheçam minha fome!	
VO_ICC05_Lanathel_Female_Sanlayn_EmoteResponse_01	Você está... flertando comigo?	
VO_ICC05_Lanathel_Female_Sanlayn_Intro_01	Vocês tomaram uma... decisão... insensata.	
VO_ICC05_Lanathel_Female_Sanlayn_LichKing_01	Você...!	
VO_ICC05_Lanathel_Female_Sanlayn_PlayerBiteAcolyte_01	Ah, que deliciosa ironia! 	
VO_ICC05_Lanathel_Female_Sanlayn_PlayerBloodBite_01	Chegaram tarde demais. Eu já estou perdida!	
VO_ICC05_Lanathel_Female_Sanlayn_TransformDK_01	Ah, sabia que eu ia gostar de você.	
VO_ICC05_Lanathel_Female_Sanlayn_Turn3_01	Por que não se alimentar de um dos MEUS lacaios?	
VO_ICC05_Lanathel_Female_Sanlayn_Turn3_02	Eles estão dormindo... e deliciosos... e cobertos de molho!	
VO_ICC05_Lanathel_Female_Sanlayn_Wounded_01	Sério? É só isso mesmo?	
VO_ICC05_LichKing_Male_Human_BossBite_02	Ah, claro, a mordida de San'layn.	
VO_ICC05_LichKing_Male_Human_BossBite_03	Cuidado com a fome. Você tem que se alimentar todo turno.	
VO_ICC05_LichKing_Male_Human_LichKing_02	Esse chefe morde.	
VO_ICC05_LichKing_Male_Human_Lose_01	Está com medo de morder seus lacaios? Aqui é a Coroa de Gelo. Não é "DE BOA no Gelo"! 	
VO_ICC05_LichKing_Male_Human_Win_01	Lana'thel... É uma pena que você não possa perder estrelas do ranque.	
VO_ICC06_LichKing_Male_Human_LichKing_02	Não é nada pessoal, Medulante.	
VO_ICC06_LichKing_Male_Human_Win_01	Tenho que criar OUTRO serviçal de ossos. Talvez um dourado.	
VO_ICC06_Marrowgar_Male_BoneWraith_Alexstraza_01	Ela me lambeu... essa dragonesa me lambeu!	
VO_ICC06_Marrowgar_Male_BoneWraith_AncientOne_01	Não me arrependo de NADA!	
VO_ICC06_Marrowgar_Male_BoneWraith_AuchenaiSoulpriest_01	Haha, agora eu peguei sua sacerdalma. Espere. Não. Vá embora! Xô!	
VO_ICC06_Marrowgar_Male_BoneWraith_BigHeal_01	A morte é eterna e implacável...	
VO_ICC06_Marrowgar_Male_BoneWraith_Bonespike_01	A única saída é a morte!	
VO_ICC06_Marrowgar_Male_BoneWraith_Bonespike_02	O mestre destruirá você.	
VO_ICC06_Marrowgar_Male_BoneWraith_Bonespike_03	Carne e tendões derretem ao meu suave toque.	
VO_ICC06_Marrowgar_Male_BoneWraith_Bonespike_04	Está na hora de ceifar.	
VO_ICC06_Marrowgar_Male_BoneWraith_Bonespike_05	Tão perigoso. Tão prazeroso!	
VO_ICC06_Marrowgar_Male_BoneWraith_BonespikePlayerHit_01	Agh! A ira do amo corre através de mim!!	
VO_ICC06_Marrowgar_Male_BoneWraith_BonespikeStolen_01	Agh! Seu... ladrão de ossos!	
VO_ICC06_Marrowgar_Male_BoneWraith_Bonestorm_01	Tempestade de Ossos!	
VO_ICC06_Marrowgar_Male_BoneWraith_Bonestorm_02	Tempestaaade de Ooossos!	
VO_ICC06_Marrowgar_Male_BoneWraith_Bonestorm_03	Tempestaaaade de Oooossos!	
VO_ICC06_Marrowgar_Male_BoneWraith_Bonestorm_04	Tempestaaaaaade de Oooooossos!	
VO_ICC06_Marrowgar_Male_BoneWraith_Bonestorm_05	TEMPESTAAAAADE DE OOOOOOSSOS!!!	
VO_ICC06_Marrowgar_Male_BoneWraith_BonestormFast_01	Tempestade de Ossos.	
VO_ICC06_Marrowgar_Male_BoneWraith_Death_01	Das cinzas às cinzas...	
VO_ICC06_Marrowgar_Male_BoneWraith_DKTransform_01	Sim. Aceite o seu destino... atenda ao chamado do mestre!	
VO_ICC06_Marrowgar_Male_BoneWraith_EmoteResponse_01	Que tolice! Eu não tenho ouvidos!	
VO_ICC06_Marrowgar_Male_BoneWraith_Idle_01	Hummmm...	
VO_ICC06_Marrowgar_Male_BoneWraith_Intro_01	Ninguém adentrará o sacrário do meu mestre! 	
VO_ICC06_Marrowgar_Male_BoneWraith_LichKing_01	… Mestre?	
VO_ICC06_Marrowgar_Male_BoneWraith_Skeleton_01	E aí, meu amiguinho esquelético? Hmm?	
VO_ICC07_LichKing_Male_Human_LichKing_02	Eu gosto de supervisionar de perto.	
VO_ICC07_LichKing_Male_Human_Lose_01	Putricida, seu deck é nojento. Eu subestimei você.	
VO_ICC07_LichKing_Male_Human_Win_02	Putricida, que patético. Você devia estar no deck de Caçador, não na minha cidadela.	
VO_ICC07_Putricide_Male_Undead_Aviana_01	Sua ciência é melhor que a minha ciência!	
VO_ICC07_Putricide_Male_Undead_CloakedHuntress_01	Bom, parece meio supérfluo. 	
VO_ICC07_Putricide_Male_Undead_Death_01	Más notícias, pessoal...	
VO_ICC07_Putricide_Male_Undead_EaglehornBow_01	Onde consigo um desses?	
VO_ICC07_Putricide_Male_Undead_EaterOfSecrets_01	Não! Meus segredos! Minha obra!	
VO_ICC07_Putricide_Male_Undead_EmoteResponse_01	Isso é falta de educação.	
VO_ICC07_Putricide_Male_Undead_EquipWeapon_01	Oh, não.	
VO_ICC07_Putricide_Male_Undead_EquipWeapon_02	Eu NEM SABIA que eu tinha uma destas.	
VO_ICC07_Putricide_Male_Undead_EquipWeapon_03	É, isso vai resolver.	
VO_ICC07_Putricide_Male_Undead_EquipWeapon_04	De onde é que saiu aquilo?	
VO_ICC07_Putricide_Male_Undead_EquipWeapon_05	Tão perigoso. Tão prazeroso!	
VO_ICC07_Putricide_Male_Undead_EtherealArcanist_01	Nunca confie num etéreo. Não dá pra ver o rosto deles!	
VO_ICC07_Putricide_Male_Undead_FestergutDeath_01	Ah, Tripapútrida, você sempre foi meu queridinho... depois do Rostorroto.	
VO_ICC07_Putricide_Male_Undead_Intro_02	Boas notícias, pessoal! Consertei a tubulação de gosma venenosa.	
VO_ICC07_Putricide_Male_Undead_LichKing_01	Ah, eu não esperava ver você aqui.	
VO_ICC07_Putricide_Male_Undead_MysteriousChallenger_01	Não há ninguém mais misterioso que eu!	
VO_ICC07_Putricide_Male_Undead_Ooze_01	Uuuh, gosma!	
VO_ICC07_Putricide_Male_Undead_PhaseTransition_01	Tentáculos! Minha nossa... É difícil controlar eles, não é?	
VO_ICC07_Putricide_Male_Undead_PhaseTransition_03	Humm, interessante.	
VO_ICC07_Putricide_Male_Undead_Putricide_02	Quê? Esse cara aí sou eu!	
VO_ICC07_Putricide_Male_Undead_Putricide_03	Boas notícias... eu!	
VO_ICC07_Putricide_Male_Undead_Putricide_04	Boas notícias coisa nenhuma, seu imitador barato! 	
VO_ICC07_Putricide_Male_Undead_Rotface_01	Rostorroto! Como você pôde!?	
VO_ICC07_Putricide_Male_Undead_RotfaceDeath_01	Rostorroto não! O que foi que ele fez para você!?	
VO_ICC07_Putricide_Male_Undead_Scientist_01	Você andou caçando meu pessoal?	
VO_ICC07_Putricide_Male_Undead_Slime_01	Ótimas notícias, pessoal! A gosma voltou a circular!	
VO_ICC07_Putricide_Male_Undead_TentaclesForArms_01	A escolha dessa arma é de muito bom gosto.	
VO_ICC07_Putricide_Male_Undead_TransformDK_01	Quuêêê? Você mudou de penteado agora?	
VO_ICC07_Rotface_Male_Abomination_Rotface_02	Rostorroto tem NECESSIDADES.	
VO_ICC08_Anduin_Male_Human_Muted_02	Mmpphh!	
VO_ICC08_Anduin_Male_Human_Muted_03	Mmphmm.	
VO_ICC08_Anduin_Male_Human_Muted_06	Mmpphhhhhh…!!	
VO_ICC08_Anduin_Male_Human_Muted_07	Mmpphhhhhh!!!	
VO_ICC08_Anduin_Male_Human_Muted_11	Mmpphh?	
VO_ICC08_Anduin_Male_Human_Muted_13	Mmpphh…	
VO_ICC08_Anduin_Male_Human_WinA_01	Sempre haverá...	
VO_ICC08_Anduin_Male_Human_WinB_01	um Lich Rei!	
VO_ICC08_Garrosh_Male_Orc_WinA_01	Sempre haverá...	
VO_ICC08_Garrosh_Male_Orc_WinB_01	um Lich Rei!	
VO_ICC08_Guldan_Male_Orc_WinA_01	Sempre haverá...	
VO_ICC08_Guldan_Male_Orc_WinB_01	um Lich Rei!	
VO_ICC08_Jaina_Female_Human_WinA_01	Sempre haverá...	
VO_ICC08_Jaina_Female_Human_WinB_01	um Lich Rei!	
VO_ICC08_LichKing_Male_Human_Archmage Antonidas_01	Eu já derrotei você, velhote. Posso derrotar de novo.	
VO_ICC08_LichKing_Male_Human_Arfas_01	Cachorro mau!	
VO_ICC08_LichKing_Male_Human_Bolvar_01	Foi difícil dobrar este aqui.	
VO_ICC08_LichKing_Male_Human_Death_01	Eu vejo... apenas trevas diante de mim...	
VO_ICC08_LichKing_Male_Human_DeathPunisher_01	Golpe baixo. Esse foi baixo. 	
VO_ICC08_LichKing_Male_Human_EmoteResponse_01	Ninguém me dá ordens!	
VO_ICC08_LichKing_Male_Human_EndOfTurn4_01	Nenhum card vai postergar meu inevitável triunfo.	
VO_ICC08_LichKing_Male_Human_Frostmourne_01	Gélido Lamento tem fome...	
VO_ICC08_LichKing_Male_Human_Frostmourne_02	Gélido Lamento tem fome... Você queria alguma coisa?	
VO_ICC08_LichKing_Male_Human_Frostmourne_07	Contemple o poder de Gélido Lamento!	
VO_ICC08_LichKing_Male_Human_GenericStart_03	Eu vou destroçar o seu deck e depois... SUA ALMA!	
VO_ICC08_LichKing_Male_Human_Horsemen_01	Se eu conseguir todos os quatro, vai ser uma VERGONHA para você.	
VO_ICC08_LichKing_Male_Human_Hunter_01	Caçador solitário. Se eu tirar seus amiguinhos, o que resta para me enfrentar, hein?	
VO_ICC08_LichKing_Male_Human_Illidan_01	O Trono de Gelo é meu, demônio. Afaste-se.	
VO_ICC08_LichKing_Male_Human_IndestructableWeapon_01	Que tentativa ridícula.	
VO_ICC08_LichKing_Male_Human_Intro_01	Seu sofrimento será lendário. Já o seu ranque... não.	
VO_ICC08_LichKing_Male_Human_Intro_02	No final, todos servirão a mim.	
VO_ICC08_LichKing_Male_Human_Intro_03	Você chama esse monte patético de cards de "deck"?	
VO_ICC08_LichKing_Male_Human_Intro_04	Eu sou o começo e o fim... EU SOU O NOVO META.	
VO_ICC08_LichKing_Male_Human_Intro_06	Acha que eu terei piedade de gente como você?	
VO_ICC08_LichKing_Male_Human_Intro_07	Isso é o seu deck? Parece mais um pedido de socorro.	
VO_ICC08_LichKing_Male_Human_Intro_08	Seu gritos agonizantes serão prova do nível lendário em que eu jogo.	
VO_ICC08_LichKing_Male_Human_Intro_09	É mesmo a retidão que os\nmotiva? Eu me pergunto...	
VO_ICC08_LichKing_Male_Human_Kelthuzad_01	Kel'Thuzad! Você está na aventura errada!	
VO_ICC08_LichKing_Male_Human_Lanathel_01	Sua traição não me surpreende, Lana'thel.	
VO_ICC08_LichKing_Male_Human_LichKing_01	Olha só... e aí, bonitão?	
VO_ICC08_LichKing_Male_Human_LichKing_02	Eu estou ótimo.	
VO_ICC08_LichKing_Male_Human_LichKingMuted_01	Espere, você não pode...	
VO_ICC08_LichKing_Male_Human_LichKingMutedResponse_01	Mmmph.	
VO_ICC08_LichKing_Male_Human_LichKingMutedResponse_02	Humpf Hummmpf!	
VO_ICC08_LichKing_Male_Human_LichKingMutedResponse_03	HumpfHUMPF!	
VO_ICC08_LichKing_Male_Human_LichKingMutedResponse_04	Huuuumpf...	
VO_ICC08_LichKing_Male_Human_LilLich_01	Eu... eu o amo.	
VO_ICC08_LichKing_Male_Human_Lose_03	Una-se a mim na escuridão...	
VO_ICC08_LichKing_Male_Human_Mage_01	Somente eu domino o frio inclemente da morte, não os magos! 	
VO_ICC08_LichKing_Male_Human_MageSpellReflect_01	Cadê o controle de qualidade que não viu isso!?	
VO_ICC08_LichKing_Male_Human_MageSpellReflect_02	Quem testa essas aventuras!?	
VO_ICC08_LichKing_Male_Human_Mograine_01	Mograine! Eu nem sei mais se você está do lado dos vilões ou dos heróis.	
VO_ICC08_LichKing_Male_Human_MutedResponse_01	Silêncio!	
VO_ICC08_LichKing_Male_Human_MutedResponse_02	Shhh!	
VO_ICC08_LichKing_Male_Human_MutedResponse_03	Shhhhh!	
VO_ICC08_LichKing_Male_Human_MutedResponse_04	Calado.	
VO_ICC08_LichKing_Male_Human_MutedResponse_05	Eu disse "calado".	
VO_ICC08_LichKing_Male_Human_MutedResponse_06	Ca-la-do.	
VO_ICC08_LichKing_Male_Human_Paladin_01	A Luz não protegerá você aqui, paladino. Ninguém protegerá você...	
VO_ICC08_LichKing_Male_Human_Phase03_01	Encarem agora o trágico fim.	
VO_ICC08_LichKing_Male_Human_PhaseTransition_02	Alguém nerfou minha arma? 	
VO_ICC08_LichKing_Male_Human_PowerReplace_01	Meu poder não será eclipsado tão facilmente.	
VO_ICC08_LichKing_Male_Human_Priest_01	Silêncio, Sacerdote! A Luz não dará ouvidos às suas súplicas.	
VO_ICC08_LichKing_Male_Human_Putricide_01	Eu já não gostava de você antes.	
VO_ICC08_LichKing_Male_Human_Rogue_01	Saia das sombras, ladina. O que seria de você sem seus truques baratos?	
VO_ICC08_LichKing_Male_Human_Shaman_01	Seus lacaios se acovardam perante o meu poder, xamã!	
VO_ICC08_LichKing_Male_Human_Sindragosa_01	Ela era MEU golpe final! Devolva!	
VO_ICC08_LichKing_Male_Human_Sylvanas_01	Depois de tudo que você me fez passar, a última coisa que eu vou lhe dar é a paz da morte. 	
VO_ICC08_LichKing_Male_Human_Tirion_01	Vou manter você vivo para testemunhar o fim, Fordring.	
VO_ICC08_LichKing_Male_Human_TransformDK_01	Sim... entregue-se ao seu novo poder... Eu já venci...	
VO_ICC08_LichKing_Male_Human_Turn6_01	Esse foi seu turno mais ridículo. E olha que já houve uns bem ruins.	
VO_ICC08_LichKing_Male_Human_Turn6_03	Você joga cartas como meu pai governava o reino dele. Sem força. 	
VO_ICC08_LichKing_Male_Human_Turn6_04	Você não sente um desgosto profundo a cada card que puxa desse deck?	
VO_ICC08_LichKing_Male_Human_Turn6_05	A cada card você fica mais perto do esquecimento.	
VO_ICC08_LichKing_Male_Human_Turn6_06	Sua derrocada é inevitável. E não há como expressar essa vergonha.	
VO_ICC08_LichKing_Male_Human_Turn6_07	Quem montou esse deck para você? 	
VO_ICC08_LichKing_Male_Human_Turn6_08	Acharam que você ia enfrentar o Hogger?	
VO_ICC08_LichKing_Male_Human_Warlock_01	Bruxo, pode entregar os pontos. Os terrores que você comanda em breve servirão a MIM.	
VO_ICC08_LichKing_Male_Human_Warrior_01	Guerreiro, você dará um excelente Cavaleiro da Morte quando eu tiver dobrado você.	
VO_ICC08_LichKing_Male_Human_Wounded_01	A esperança se esvai...	
VO_ICC08_LichKing_Male_Human_Wounded_02	Impossível… IMPOSSÍVEL!	
VO_ICC08_LichKing_Male_Human_YoungArthas_01	O que é isso? Uma representação dramática do meu conflito interior?	
VO_ICC08_Malfurion_Male_NightElf_WinA_01	Sempre haverá...	
VO_ICC08_Malfurion_Male_NightElf_WinB_01	um Lich Rei!	
VO_ICC08_Rexxar_Male_Orc_WinA_01	Sempre haverá...	
VO_ICC08_Rexxar_Male_Orc_WinB_01	um Lich Rei!	
VO_ICC08_Thrall_Male_Orc_WinA_01	Sempre haverá...	
VO_ICC08_Thrall_Male_Orc_WinB_01	um Lich Rei!	
VO_ICC08_Tirion_Male_Human_Win_01	Você conseguiu!	
VO_ICC08_Tirion_Male_Human_Win_02	Mas, sem o comando do mestre da morte, o Flagelo se tornará uma ameaça ainda maior para este mundo.	
VO_ICC08_Uther_Male_Human_WinA_01	Sempre haverá...	
VO_ICC08_Uther_Male_Human_WinB_01	um Lich Rei!	
VO_ICC08_Valeera_Female_Human_WinA_01	Sempre haverá...	
VO_ICC08_Valeera_Female_Human_WinB_01	um Lich Rei!	
VO_ICC09_LichKing_Male_Human_LichKing_02	Não se preocupe, não posso atacar você.	
VO_ICC09_LichKing_Male_Human_Lose_01	Você trouxe a arma errada para uma briga de faca.	
VO_ICC09_LichKing_Male_Human_Win_01	Esse era meu lendário preferido! Agora eu vou ter que trocar por outro melhor.	
VO_ICC09_Saurfang_Male_Orc_AttackedByPlayer_01	Pode bater com força!	
VO_ICC09_Saurfang_Male_Orc_AttacksPlayer_01	Você vai encarar o poder do Flagelo!	
VO_ICC09_Saurfang_Male_Orc_AttacksPlayer_02	Eu me tornei a morte!	
VO_ICC09_Saurfang_Male_Orc_AttacksPlayer_03	O Lich Rei consome a todos.	
VO_ICC09_Saurfang_Male_Orc_AttacksPlayer_04	Lute! Morra! Seu destino está selado.	
VO_ICC09_Saurfang_Male_Orc_BloodBeast_01	Fartem-se, meus lacaios!	
VO_ICC09_Saurfang_Male_Orc_BloodBeast_02	Devorem todos...	
VO_ICC09_Saurfang_Male_Orc_BloodBeast_03	Meu poder continua crescendo.	
VO_ICC09_Saurfang_Male_Orc_BloodBeast_04	Minha fúria encarnada!	
VO_ICC09_Saurfang_Male_Orc_BloodBeastStolen_01	Pode pegar. Esse cheiro nunca mais vai sair da sua roupa.	
VO_ICC09_Saurfang_Male_Orc_CursedBlade_01	Quem teve essa ideia?	
VO_ICC09_Saurfang_Male_Orc_Death_01	Estou... livre...	
VO_ICC09_Saurfang_Male_Orc_DKTransform_01	Finalmente! Um oponente digno!	
VO_ICC09_Saurfang_Male_Orc_Doomerang_01	Hmm... Tenho que arranjar um desses...	
VO_ICC09_Saurfang_Male_Orc_EmoteResponse_01	Choraminga, covarde.	
VO_ICC09_Saurfang_Male_Orc_EquipWeapon_01	Pelo poder do Lich Rei!	
VO_ICC09_Saurfang_Male_Orc_EquipWeapon_02	Impressionante.	
VO_ICC09_Saurfang_Male_Orc_Intro_01	Venha enfrentar o poder do Flagelo!	
VO_ICC09_Saurfang_Male_Orc_LichKing_01	O que VOCÊ está fazendo aqui?	
VO_ICC09_Saurfang_Male_Orc_WeaponDestroyed_01	Raarggh!	
VO_ICC10_Deathwhisper_Female_Lich_DamageByValithria_01	Argh..	
VO_ICC10_Deathwhisper_Female_Lich_Death_01	Impossível...!	
VO_ICC10_Deathwhisper_Female_Lich_DKTransform_01	Ah! Você também experimentou o poder do mestre...	
VO_ICC10_Deathwhisper_Female_Lich_EmoteResponse_01	Ah, isso foi uma ameaça?	
VO_ICC10_Deathwhisper_Female_Lich_Equality_01	Essa ideia não é tão boa quanto você pensa.	
VO_ICC10_Deathwhisper_Female_Lich_HeroPower_01	Os vivos são tão fracos...	
VO_ICC10_Deathwhisper_Female_Lich_HeroPower_02	A sua carne é uma maldição...	
VO_ICC10_Deathwhisper_Female_Lich_HeroPower_03	Compreende a futilidade de suas ações?	
VO_ICC10_Deathwhisper_Female_Lich_HeroPower_04	A escuridão aguarda você...	
VO_ICC10_Deathwhisper_Female_Lich_HeroPowerInitial_01	A morte chama...	
VO_ICC10_Deathwhisper_Female_Lich_Intro_01	Que perturbação é essa? Meu trabalho não está concluído.	
VO_ICC10_Deathwhisper_Female_Lich_LichKing_01	Mestre... por favor... eu juro que eu estou matando eles!	
VO_ICC10_Deathwhisper_Female_Lich_PlayerPlaysEnrage_01	Seus lacaios estão ansiosos para serem castigados!	
VO_ICC10_Deathwhisper_Female_Lich_StoneskinGargoyle_01	Como é? Eu não sabia que dava para jogar cards do Livre aqui!	
VO_ICC10_Deathwhisper_Female_Lich_ValithriaBlessedChampion_01	Vá colocar suas mãos em outro lugar!	
VO_ICC10_Deathwhisper_Female_Lich_ValithriaDivineShield_01	Tire a mão do dragão agora mesmo!	
VO_ICC10_Deathwhisper_Female_Lich_ValithriaResurrect_01	Eu não estou gostando mais deste jogo.	
VO_ICC10_Deathwhisper_Female_Lich_ValithriaTaunt_01	Eu já detestava esse dragão, agora então...	
VO_ICC10_Deathwhisper_Female_Lich_ValithriaWindfury_01	Que absurdo.	
VO_ICC10_LichKing_Male_Human_DamageByValithria_02	Esse dragão vai destruir tudo que construímos! Mate-o, Sibilamorte!	
VO_ICC10_LichKing_Male_Human_Lose_01	Mais uma vez. Com cura!	
VO_ICC10_LichKing_Male_Human_Turn2_01	Sibilamorte! Eu mandei você dar cabo desse dragão!	
VO_ICC10_LichKing_Male_Human_Turn2_02	Para quem é líder de uma seita profana, você está demorando demais.	
VO_ICC10_LichKing_Male_Human_Win_01	Seu deck me decepcionou, Sibilamorte. Fique satisfeita de a derrota ter sido rápida.	
VO_ICC10_LichKing_Male_Human_Wounded_01	Pare de brincadeira e acabe logo com isso, Sibilamorte.	
VO_ICC10_LichKing_Male_Human_Wounded_02	Por que não tem Explosão Arcana no seu deck!?	
VO_ICCA08_033_Male_HumanGhost_Flavor_01	... ajude...	
VO_ICCA08_033_Male_HumanGhost_Flavor_02	... socorro...	
VO_ICCA08_033_Male_HumanGhost_Flavor_03	... não há saída...	
VO_ICCA08_033_Male_HumanGhost_Flavor_04	... pode haver uma saída...	
VO_ICCA08_033_Male_HumanGhost_Flavor_05	... shhh!	
VO_ICCA10_001_Female_GreenDragon_Healed_01	Estou... renovada! 	
VO_ICCA10_001_Female_GreenDragon_Start_01	Socorro! Eu não posso... ceder.	
VO_Illhoof_Male_Demon_IlhoofKilrek_01	Venha, Kil'rek. Agora concluiremos a evocação!	
VO_Illhoof_Male_Demon_IllhoofDeath_02	Não! Tão perto! Sargar...	
VO_Illhoof_Male_Demon_IllhoofEmoteResponse_01	Sua essência alimenta o ritual!	
VO_Illhoof_Male_Demon_IllhoofOpen_01	Ah, bem na hora!	
VO_Illhoof_Male_Demon_IllhoofSummonImps_01	Venham, habitantes da escuridão. Atendam meu chamado!	
VO_Illhoof_Male_Demon_IllhoofSummoningPortal_01	Um portal sem um ritual? Isso parece muito mais fácil...	
VO_Illhoof_Male_Demon_IllhoofTurn1_01	O ritual começa agora!	
VO_Illhoof_Male_Demon_IllhoofWounded_01	Reúnam-se, mascotes. O ritual tem que ser concluído!	
VO_INNKEEPER_Male_Dwarf_HSNewYearBrawl_02	O Ano do Corvo é um pouquinho mais assombrado que os outros.	
VO_INNKEEPER_Male_Dwarf_HSNewYearBrawl_03	Olha! Parece que chegou um arauto do Ano do Corvo!	
VO_INNKEEPER_Male_Dwarf_HSNewYearBrawl_05	O Ano do Corvo traz mudanças sombrias.	
VO_INNKEEPER_Male_Dwarf_HSNewYearBrawl_08	As feras das sombras ficam mais ousadas...	
VO_INNKEEPER_Male_Dwarf_HSNewYearBrawl_09	As criaturas da escuridão saem da toca...	
VO_INNKEEPER_Male_Dwarf_HSNewYearBrawl_10	Os monstros do pântano se aproximam...	
VO_Jaraxxus_Male_Demon_FinalMalchezaarJaraxxus_01	Príncipe tolo. Cante no karaokê como Jaraxxus!	
VO_Jaraxxus_Male_Demon_FinalMalchezaarJaraxxus_02	Nós somos a\nLiga dos Exploradores\ne exploradores da Liga!	
VO_Julianne_Female_Human_JulianneDeath_01	Romão! Eu brindo a ti...	
VO_Julianne_Female_Human_JulianneEmoteResponse_01	Está mordendo seu polegar para nós?	
VO_Julianne_Female_Human_JulianneFeignDeath_03	Para depois acordar, como de um sono suave...	
VO_Julianne_Female_Human_JulianneHeroPower_01	Vem, gentil noite, e restitui-me o meu Romão!	
VO_Julianne_Female_Human_JulianneOpen_01	Que tipo de diabo és tu?	
VO_KAR03_MOROES_MALE_HUMAN_CHESS_TURN_1	Ah, lembrei. As peças atacarão automaticamente no final do seu turno.	
VO_KAR03_MOROES_MALE_HUMAN_CHESS_TURN_3	Se uma peça estiver entre dois inimigos, ela atingirá os dois!	
VO_KAR03_MOROES_MALE_HUMAN_CHESS_TURN_5	Posicionamento adequado é a chave do xadrez. Use os ataques duplos!	
VO_KARA_04_01_Female_Human_CroneHuffer_01	Bufo, tenho a sensação de que não estamos mais em Cerro Oeste...	
VO_KARA_04_01_Female_Human_CroneLionTigerBear_02	Ah! Leões e dragões e ursos! Puxa vida!	
VO_KARA_04_01_Female_Human_CroneTurn1_01	Ai, não! Não deixe ela me ferir!	
VO_KARA_04_01_Female_Human_CroneTurn3_01	Deem os braços! Juntos somos fortes!	
VO_KARA_06_01_Male_Human_JulianneDeadlyPoison_02	Ah, uma gota de veneno.	
VO_KARA_06_01_Male_Human_JulianneTurn1_01	Queres provocar-me? Defende-te, pois!	
VO_KT_ANTI_CHEESE1_65	Esta é a Naxxramas Heroica! Sua estratégia barata não vale nada aqui.	
VO_KT_ANTI_CHEESE2_66	Agoureiro? Você se acha muito esperto, não é?	
VO_KT_ANTI_CHEESE3_67	Igualdade? Comigo não!	
VO_KT_ANUB2_43	NÃOOO!!! Quer dizer... bobagem. Você nunca derrotará a Grã-Viúva.	
VO_KT_BARON2_64	O Distrito Militar fracassou comigo! Hoje em dia é tão difícil arrumar bons empregados.	
VO_KT_FAERLINA2_45	Faerlina não é nada. A Rainha Aranha vai cuidar de você FÁCIL FÁCIL.	
VO_KT_GLUTH2_73	Eu perguntei aos Zumbis se eles queriam comer seu cérebro e eles disseram: "Não, a gente não come porcaria". MUAHAHAHA	
VO_KT_GLUTH2_ALT_74	Existe uma conquista para quando você perde para Gluth. Tenho certeza.	
VO_KT_GLUTH3_75	AHAHAH NÃO EXISTE CONQUISTA POR PERDER PARA GLUTH!	
VO_KT_GLUTH4_76	Não! E agora quem vai comer as sobras dos zumbis??	
VO_KT_GLUTH5_77	O que eu gosto mesmo é de Dizimação. Não, peraí, eu gosto mesmo é de Congelar o seu sangue nas veias.	
VO_KT_GLUTH6_78	Booom garoto! Booom garoto!	
VO_KT_GOTHIK2_62	Por que o Gothik não retorna como Fantasma de Gothik? Pôôô...	
VO_KT_GROBBULUS2_71	De volta à prancheta...	
VO_KT_HEIGAN2_55	Eu estou FERVENDO de raiva. FERVENDO.	
VO_KT_LOATHEB2_57	Você continua MATANDO MEUS LACAIOS! Pare! Pare agora mesmo!	
VO_KT_MAEXXNA2_47	O veneno dela causará uma morte *quase* indolor.	
VO_KT_MAEXXNA3_48	Gigante do Mar?? Maexxna, esse card não está na minha lista de cards aprovados!	
VO_KT_MAEXXNA4_49	Impossível! Isso ainda não terminou, MÍSERO MORTAL!	
VO_KT_MAEXXNA6_51	Como se chama o jogador que teve o lacaio preso em teia? CONDENADO!	
VO_KT_NOTH2_53	Pobre Noth. Levou um capoth.	
VO_KT_PATCHWERK2_69	Meu avatar de guerra! Eu devia ter usado pedaços de jogadores melhores...	
VO_KT_RAZUVIOUS2_59	Quem irá treinar meus Cavaleiros da Morte agora?! Eu não tenho tempo, estou SUPER ocupado.	
VO_KT_SAPPHIRON2_84	Olhe só esse gnomo. Ele também era um invasor... COMO VOCÊ.	
VO_KT_SAPPHIRON3_85	Pare de se esconder atrás desse bloco de gelo!	
VO_KT_SAPPHIRON4_ALT_87	Sapphiron, executar o plano: "CONGELAR SANGUE NAS VEIAS"	
VO_KT_SAPPHIRON5_88	Meu dragão! EU TE ODEEEIO!	
VO_KT_THADDIUS2_81	Invasor! Essa foi a gota d'água.	
VO_LichKing_Male_Human_Brawl_01	Esta taverna inteira será expurgada!	
VO_LichKing_Male_Human_Brawl_03	Tragam quantos tolos quiser para a batalha. Eu prevalecerei.	
VO_LichKing_Male_Human_Brawl_05	Vejam minha enorme quantidade de Pontos de Vida e se desesperem...	
VO_LichKing_Male_Human_ExpansionIntro_02	Coroa de Gelo! Você vem por causa do poder terrível, mas fica porque vai morrer.	
VO_LichKing_Male_Human_FinaleFirstVictory_01	Impossível... Impossível... Então, que tal melhor de nove?	
VO_LichKing_Male_Human_FinaleLock_01	Vocês NUNCA vão me derrotar! Não enquanto esta ala estiver bloqueada.	
VO_LichKing_Male_Human_FinaleUnlock_03	Devo abandonar a Gélido Lamento e ficar à sua mercê? Aviso: Espere SENTADO.	
VO_LichKing_Male_Human_LowerCitadelUnlock_01	Cidadela da Coroa de Gelo! Uma ala cheia dos meus lacaios mais horrendos, criados com ÓDIO.	
VO_LichKing_Male_Human_PrologueBossCoin_01	Pode vir! Eu vou aniquilar você e depois desencantar para ganhar Pó Arcano!	
VO_LichKing_Male_Human_PrologueBossCoin_02	Eu construí essa mistura hedionda usando os restos imprestáveis dos meus cards duplicados. 	
VO_LichKing_Male_Human_PrologueBossCoin_03	O Carrasco Saurfang foi o meu primeiro lacaio Lendário. Eu criei esta aventura inteira em torno dele.	
VO_LichKing_Male_Human_PrologueBossCoin_04	Esta é Lady Sibilamorte. Antes de ter sido nerfada!	
VO_LichKing_Male_Human_PrologueBossCoin_05	Professor Putricida é meu novo mecanismo de compra de cards. Mas só vem "Gás". Eu detesto ele.	
VO_LichKing_Male_Human_PrologueBossCoin_07	Lana'thel! Tem MARCAS DE DENTES nos meus CARDS! Eu mandei você colocar eles nas CAPINHAS! 	
VO_LichKing_Male_Human_PrologueBossCoin_08	Sindragosa é meu golpe final! Saia daqui! Você não vai pegar ela!	
VO_LichKing_Male_Human_PrologueBossCoin_09	Você vai implorar misericórdia. Você vai apertar o botão “Desistir”, e eu negarei.	
VO_LichKing_Male_Human_PrologueBossCoin_11	Olhe para a sua mão. Olhe o que você se tornou. Tem certeza de que nós somos tão diferentes assim? 	
VO_LichKing_Male_Human_PrologueBossCoin_12	Aqui estou, o lobo diante dos cordeiros... e eles não sentem medo.	
VO_LichKing_Male_Human_ResponseAnubaArak_01	Sirva a mim, Anub'arak!	
VO_LichKing_Male_Human_ResponseMalganis_01	Quantas vezes eu vou ter que derrotar você, Malganis?	
VO_LichKing_Male_Human_UpperReachesLock_01	Você quer usar meu poder contra mim? Espere aí enquanto eu procuro um deck que vai deixar este mundo na escuridão para sempre.	
VO_LichKing_Male_Human_UpperReachesUnlock_01	Você quer usar meu poder contra mim? Sabe quantas vezes eu já cheguei a Lenda no ranqueado?	
VO_LOE_01_DEATH_2	Orsis! Vingue-me!	
VO_LOE_01_RESPONSE	Trema diante da ira do sol!	
VO_LOE_01_STAFF	Haha! É meu!	
VO_LOE_01_STAFF_2	Você vai arder em chamas! 	
VO_LOE_01_STAFF_2_RENO	É melhor você guardar bem essa haste. É valiosa.	
VO_LOE_01_START	Eu sou INVENCÍVEL!	
VO_LOE_01_WIN	Haha! Peguei a haste. Só queria que Harrison me visse agora! 	
VO_LOE_01_WIN_2	Pegue aquele cajado!	
VO_LOE_01_WIN_2_ALT_2	Uhh, será que era para o chão estar tremendo assim?	
VO_LOE_01_WOUNDED	Haha! Peguei ele de jeito agora! Pode acabar com ele!	
VO_LOE_02_DEATH	Voltar para a lâmpada, nãããoooo!	
VO_LOE_02_INTRO	A haste do sol é MINHA!	
VO_LOE_02_MORE_WISHES	Uau, não acredito que funcionou.	
VO_LOE_02_PHAERIX_STAFF_RECOVER	Você jamais compreenderá os poderes da haste!	
VO_LOE_02_RESPONSE	Poder cósmico fenomenal!	
VO_LOE_02_START	Finalmente livre! Sua recompensa será uma morte rápida!	
VO_LOE_02_START2	Meu nome é Reno Jackson, arqueólogo, explorador e caçador de tesouros mundialmente famoso. 	
VO_LOE_02_START3	Tem o autocontrole de uma gralha histérica.	
VO_LOE_02_TURN_10	Dá para imaginar, camarada? A Haste do Sol! Vale milhões!	
VO_LOE_02_TURN_6	Então, eu já contei daquela vez que eu usei um disfarce para me infiltrar entre os ogros de Gládio Cruel?	
VO_LOE_02_TURN_6_2	Hmm, que tal se esgueirar pelo Liceu Rocha Negra para pegar...	
VO_LOE_02_WIN	Avante! A haste está logo adiante nesse salão!	
VO_LOE_02_WISH	É bacana da parte dele conceder esses desejos ao mesmo tempo que tenta nos matar.	
VO_LOE_03_RESPONSE	Depressa!	
VO_LOE_03_TURN_1	Teto desabando e monstros por toda parte! Melhor correr!	
VO_LOE_03_TURN_10	Quase lá! Já dá para ver o sol!	
VO_LOE_03_TURN_2	Ah, ha! Uma poça brilhante. Quer ver o que é isso?	
VO_LOE_03_TURN_2_2	Você não tem tempo pra isso!	
VO_LOE_03_TURN_3	Hmm... Ok... Direita ou esquerda? 	
VO_LOE_03_TURN_3_BOULDER	Esse pedregulho é imenso! Sai da frente!	
VO_LOE_03_TURN_3_WARNING	Ok, o barulho está ficando pior. Aposto que o teto vai desabar no próximo turno!	
VO_LOE_03_TURN_4	Ah, ha. Um fosso cheio de espetos!	
VO_LOE_03_TURN_4_BAD	Oh ho ho ho! Acho que isso ia doer um pouquinho.	
VO_LOE_03_TURN_4_GOOD	Ha, boa! Quase tão eficiente quanto eu.	
VO_LOE_03_TURN_4_NEITHER	Tá certo, então você vai tentar passar por entre os espetos? Vá depressa!	
VO_LOE_03_TURN_5	Opa, que estátua bacana! E olha só esse rubi...	
VO_LOE_03_TURN_5_4	Opa, parece que ele não gostou. Acho que ele quer a joia de volta.	
VO_LOE_03_TURN_6	Cuidado! O teto está desabando!	
VO_LOE_03_TURN_6_2	Uuh! Essa passou perto! Ainda bem que consegui salvar você. De nada.	
VO_LOE_03_TURN_7	Hmm, está escuro à beça aqui. Mas assim a gente anda mais rápido. Vamos!	
VO_LOE_03_TURN_7_2	No meu mapa só está escrito "NÃO VENHA AQUI".	
VO_LOE_03_TURN_8	Ufa! Está ficando quente. Temos que andar rápido!	
VO_LOE_03_TURN_9	Eca. Por que sempre tem insetos?	
VO_LOE_03_WIN	Ufa! Conseguimos! Nunca pensei que ficaria feliz em ver esse deserto... deserto? Acho que preciso de água.	
VO_LOE_04_RESPONSE	Trogg esmaga burro!	
VO_LOE_04_SCARVASH_TURN_2	Trogg não é burro! Trogg faz você burro!	
VO_LOE_04_START	Uldaman é SÓ dos troggs!	
VO_LOE_04_WIN	Ainda tem um monte deles! Por aqui! Suba no vagonete!	
VO_LOE_07_RESPONSE	Tu achas mesmo que tem tempo pra isso?	
VO_LOE_07_START	Cuidado, eles estão logo atrás da gente!	
VO_LOE_07_WIN	Ha ha! Fugir de carrinho jogando bomba! Isso é que é diversão!	
VO_LOE_08_ANIMATE_STONE	Terra e rocha, despertem!	
VO_LOE_08_LANDSLIDE	Vou enterrar você!	
VO_LOE_08_RESPONSE	Você é pó.	
VO_LOE_08_START	Quem desafia a ira dos criadores?	
VO_LOE_08_WIN	O castão está na mão! Só falta mais uma parte agora!	
VO_LOE_092_Attack_02	Contemplem!	
VO_LOE_10_NYAH	Mrrrglmrrrgl Nyah!	
VO_LOE_10_RESPONSE	Mrglmrrglrmrrgl	
VO_LOE_10_RESPONSE_ALT_read	O que você está fazendo aqui?	
VO_LOE_10_START	Mrglmrglmrgl	
VO_LOE_10_START_2	É mesmo? Que gesto mais grosseiro! 	
VO_LOE_10_TURN_2_GIANTFIN	MRRRGL! MRRRGLMRGL!	
VO_LOE_10_TURN1	Mrrrgl! Mrrglrrglmrgl	
VO_LOE_10_WIN	Que lástima. Com uma educação melhor, certamente teria saído um gajo decente.	
VO_LOE_12_NAZJAR_PEARL	Impressionante. A Pérola das Marés supera todas as minhas expectativas.	
VO_LOE_12_NAZJAR_TURN_1	Eu sou a lâmina da Azshara. Quem é você para me desafiar?	
VO_LOE_12_NAZJAR_TURN_1_FINLEY	Dom Finlei Mrrggltone, ao seu inteiro dispor.	
VO_LOE_12_NAZJAR_TURN_3_FINLEY	Elise, a quantas andam os outros?	
VO_LOE_12_NAZJAR_TURN_5	Exército das profundezas, cubram nossos inimigos como uma maré da morte!	
VO_LOE_12_NAZJAR_TURN_5_FINLEY	Isto parece-me um tanto quanto extremo.	
VO_LOE_12_NAZJAR_TURN_7_FINLEY	*Som de dor* Mrgggl!  MRRGLMRRGL!	
VO_LOE_12_NAZJAR_TURN_7_FINLEY_2	Perdoa-me, colega, que falta de modos a minha.	
VO_LOE_12_RESPONSE	Eu tenho o poder da pérola!	
VO_LOE_12_START	O poder das marés consumirá você!	
VO_LOE_12_WIN	Bravo! A pérola é nossa! Acompanha-me ao Salão dos Exploradores e havemos de recompor o artefato juntos!	
VO_LOE_13_RESPONSE	GRAAAUUUURRRRR	
VO_LOE_13_START_2	Raaaur!	
VO_LOE_13_TURN_1	O cajado estava amaldiçoado! Acabou evocando um Etéreo que furou nossos bloqueios. E agora está roubando tudo!	
VO_LOE_13_TURN_1_2	Nem tudo. Só as coisas boas.	
VO_LOE_13_TURN_5	Uuuu, esse é mesmo o anel-sinete de Arthas? E está praticamente novo!	
VO_LOE_13_TURN_5_2	Reno, Brann, escondam os artefatos!	
VO_LOE_13_TURN_9	Ele está dando vida a um exército! Elise, não deixe ele fazer isso!	
VO_LOE_13_TURN_9_2	Tel'zaxus Nalore! O cajado é poderoso demais, mas posso ganhar um tempo!	
VO_LOE_13_WIN	A gente ajuda com a exposição. Vá atrás de Rafaam!	
VO_LOE_14_RESPONSE	CLANGOR	
VO_LOE_14_START	Ah, é a armadura de Lothar! Me custou meses cavucando esterco de dragão em Rocha Negra.	
VO_LOE_14_TURN_13	Brann, ele está dando vida aos livros da biblioteca! Eu dou conta dos martelos voadores da ala de Lordaeron.	
VO_LOE_14_TURN_5	Já dei cabo das espadas vivas que assolavam o saguão leste. Elise, a quem devo ajudar agora?	
VO_LOE_14_TURN_5_2	Encontre Reno no almoxarifado principal! Ele está cercado de Robombas!	
VO_LOE_14_TURN_9	Parece que vocês estão ocupados. Eu vou pegar esse lindo broche.	
VO_LOE_14_WIN	O museu já está protegido... Mostre a Rafaam como é que se luta!	
VO_LOE_15_RESPONSE	Que cards maravilhosos.	
VO_LOE_15_SPARE	Temos um deck sobrando. Use este aqui!	
VO_LOE_16_BOOM_BOT	Isso aí. Tenho um monte dessas sobrando. Acabe com ele!	
VO_LOE_16_CROWN	A magia de um mago maluco à mostra mesmo.	
VO_LOE_16_EYE	Engraçado. Esse troço ainda estava no meu bolso. Pode pegar emprestado se quiser.	
VO_LOE_16_FIRST_ITEM	Estamos vasculhando o museu para ver o que tem de útil. Avise se você precisar de alguma coisa!	
VO_LOE_16_GOBLET	Eu odeio cobra.	
VO_LOE_16_GREAVE	Uma parte da Armadura de Lothar saiu intacta depois da tua contenda.	
VO_LOE_16_LOCKET	Os fantasmas de Karazhan assombram esse medalhão.	
VO_LOE_16_PIPE	Toma! Mas não conte a Brann. Ele adora esse cachimbo!	
VO_LOE_16_RAFAAM_DEATH2	NÃO! Ninguém pode me vencer!	
VO_LOE_16_SHARD	Essa coisa estava em uma caixa que tinha escrito "NÃO ABRA". Então... boa sorte!	
VO_LOE_16_SPLINTER	Encontrei no Núcleo Derretido. Um senescal estava usando para palitar os dentes.	
VO_LOE_16_START_2	O cajado está carregando. Tenha cuidado!	
VO_LOE_16_TEAR	Um artefato sagrado do meu povo. Beba rápido!	
VO_LOE_16_TURN_2	O cajado está quase no limite. Prepare-se!	
VO_LOE_16_TURN_2_2	HAHAHA! PODER ESMAGADOR!	
VO_LOE_16_TURN_2_3	O cajado está sobrecarregado! É a nossa chance!	
VO_LOE_16_TURN_3	Eu sou invencível! Vocês nunca vão me derrotar!	
VO_LOE_16_TURN_3_2	O cajado está carregando de novo. Vamos ter mais uma chance a qualquer momento!	
VO_LOE_16_TURN_4	O cajado está quase cheio. A postos!	
VO_LOE_16_TURN_5	HAHAHA! PODER ESMAGADOR!	
VO_LOE_16_TURN_5_2	A proteção dele caiu! Ataque agora!	
VO_LOE_16_TURN_6	Ele está protegido de novo. Tome cuidado!	
VO_LOE_16_VIAL	Diz aqui: "BEBA-ME", mas achamos esse troço em Naxxramas, aí ninguém quis se arriscar.	
VO_LOE_ARCHAEDAS_TURN_1_CARTOGRAPHER	Se ele não estivesse tão ocupado fazendo uma tumba de pedras pra você...	
VO_LOE_GIANTFIN_TIDEHUNTER_2	Finlei, não! Você era tão... especial.	
VO_LOE_NAZJAR_TURN_3_CARTOGRAPHER	Reno voltou trazendo a Haste do Sol, e Brann está a caminho.	
VO_LOE_SCARVASH_TURN_6_CARTOGRAPHER	Concentre-se, Brann!	
VO_LOE_ZINAAR_TURN_10_CARTOGRAPHER_2	Não vamos vendê-lo.	
VO_LOE_ZINAAR_TURN_6_CARTOGRAPHER_2	Sim.	
VO_LOE_ZINAAR_TURN_6_CARTOGRAPHER_2_ALT	Sim.	
VO_LOE10_DEAD_MURLOCS	Ah, tantos mortos. Que desperdício.	
VO_LOE10_NYAH_FINLEY	Ah, tolices. Não sejas infantil.	
VO_LOE10_TIDEHUNTER	Eu fui nascido e criado Caçador de Maré até Elise encontrar-me.  Quem diria que esta seria minha sina?	
VO_LOE10_TURN_2_FINLEY	Irmãos meus! Precisamos mesmo chegar as vias de fato!	
VO_LOE10_TURN_2_FINLEY_2	Imagino que isso já era de se esperar.	
VO_LOEA04_BRANN_TURN_1	Scarvash era um filhote de trogg da última vez que vim aqui. Agora ele tá maior, mais burro e mais feio.	
VO_LOEA04_BRANN_TURN_6	Parece que os troggs estão mais raivosos do que antes. Talvez tenha alguma explicação pra isso nessas runas de mithril.	
VO_LOEA07_MINE_ALMOST_DONE	Quase lá! O que será que esse botão faz...	
VO_LOEA07_MINE_ARCHAEDAS	PELAS BARBAS DE MAGNI... AQUELE É ARKHAEDAS??	
VO_LOEA07_MINE_BARREL_FORWARD	A toda velocidade!	
VO_LOEA07_MINE_BOOM	Bombas saltitantes! Pra eles verem o que é bom!	
VO_LOEA07_MINE_BOOMZOOKA	CABUM! Vou carregar pra mandar outro balaço!	
VO_LOEA07_MINE_DETONATE	Tu vais detonar o túnel? ISSO É LOUCURA!	
VO_LOEA07_MINE_DYNAMITE	Ah! Toma cuidado com esse troço! Tu tirastes um pedaço dos trilhos!	
VO_LOEA07_MINE_HUNKER_DOWN	Abaixa!	
VO_LOEA07_MINE_PARROT	Voa, Gini!	
VO_LOEA07_MINE_RAMMING	Haha! Sai da frente!	
VO_LOEA07_MINE_REPAIRS	Um pouco de chiclete de moela e vai ficar novo!	
VO_LOEA07_MINE_SPIKED_DECOY	Ei, troggs burros! Venham me pegar!	
VO_LOEA08_TURN_1_BRANN	Um servo dos antigos titãs. Deve ter muita história para contar.	
VO_LOEA09_1_RESPONSE	Mais para o jantar!	
VO_LOEA09_1_TURN1	Quem ousa invadir a Cidade Arruinada?	
VO_LOEA09_FINLEY_DEATH	Vou recobrar-me dentro em pouco. Vá dar cabo daquela naga!	
VO_LOEA09_HERO_POWER	Hora do jantar! Hoje vai ter sopa de murloc!	
VO_LOEA09_HERO_POWER1	Saudações. Parece que meti-me numa encrenca. Podes ajudar um gajo em apuros?	
VO_LOEA09_HERO_POWER2	Devo dizer que está tremendamente escuro aqui.	
VO_LOEA09_HERO_POWER3	Oh, céus. Está a ficar mais quente?	
VO_LOEA09_HERO_POWER4	Isto aqui é um bocado desagradável.	
VO_LOEA09_HERO_POWER5	Humm, está mesmo muitíssimo quente aqui.	
VO_LOEA09_HERO_POWER6	Uma ajuda aqui seria aceita de muito bom grado.	
VO_LOEA09_QUOTE1	Obrigado, colega! Foi por pouco. Quase virei peixe frito!	
VO_LOEA09_UNSTABLE	Volte para o caldeirão!	
VO_LOEA09_WIN	Tens minha gratidão. Posso levar-te à parte final?	
VO_LOEA10_1_MIDDLEFIN	O que você está fazendo aqui?	
VO_LOEA15_1_LOSS_11	Seu deck é um lixo. Está na hora de usar o meu.	
VO_LOEA15_1_LOW_HEALTH_10	Eu acho que cometi um erro pegando o seu deck.	
VO_LOEA15_1_MAGMA_RAGER_09	Furiante de Magma!? Por quê raios você jogaria esse card?	
VO_LOEA15_1_START_07	Gostei do seu deck. Acho que vou FICAR COM ELE.	
VO_LOEA15_1_TURN1_08	Que maravilha. Essa combinação de cards está INCRÍVEL.	
VO_LOEA15_1_WIN_12	Seu deck é FANTÁSTICO.  Hahaha!	
VO_LOEA15_GOLDEN	Esse deck é TODO DOURADO? Sua coleção é quase tão boa quanto a minha!	
VO_LOEA16_1_CARD_04	Eu tenho artefatos de CENTENAS de mundos!	
VO_LOEA16_1_RESPONSE_03	Sim! SIM!	
VO_LOEA16_1_START_01	Contemple TODO O PODER do Cajado!	
VO_LOEA16_1_TURN1_02	Eu sou invencível! Tenho ao meu lado o poder dos Titãs!	
VO_LOOT_329_Male_Elemental_Attack_01	Murche.	
VO_LOOT_329_Male_Elemental_Death_01	<Death>	
VO_LOOT_329_Male_Elemental_Play_01	Vida mofa. Mofo vive.	
VO_LOOT_541_Male_Kobold_BOSS_AFKay_01	Pega ela! Pula em cima de humana antes que ela presta atenção!	
VO_LOOT_541_Male_Kobold_BOSS_Blackseed_01	Semente Negra anda na profundeza, volta cheio de... eca. Parte que se mexe... 	
VO_LOOT_541_Male_Kobold_BOSS_Brimstone_01	Shhhhh! Estátua tudo tem olho! Olho que pisca. Não acorda!	
VO_LOOT_541_Male_Kobold_BOSS_Candlebeard_01	Barbavela pensa achar tesouro enterrado faz kobold pirata. 	
VO_LOOT_541_Male_Kobold_BOSS_Chronomancer_01	Mago de tempo! Encontra nós de novo! Primeira vez!	
VO_LOOT_541_Male_Kobold_BOSS_Everrot_01	Não toca em esporo! Faz lacaio tocar.	
VO_LOOT_541_Male_Kobold_BOSS_Flurgl_01	Kobolds não entende murlocs. Eles conversam uma conversa sem conversar direito!	
VO_LOOT_541_Male_Kobold_BOSS_GeorgeKarl_01	Um dia esses dois sai andando da selva. 	
VO_LOOT_541_Male_Kobold_BOSS_Gnosh_01	Túnel não é túnel nenhum! Boca grande! Cheia de dente!	
VO_LOOT_541_Male_Kobold_BOSS_Graves_01	Curandeiro perdido cheio de conversa conversada. "Misericórdia." Mata!	
VO_LOOT_541_Male_Kobold_BOSS_Gutmook_01	Troggs. BAH. Fica de boca fechada e deixa lacaios esmagar.	
VO_LOOT_541_Male_Kobold_BOSS_Hamm_01	Hamm melhor cavador de túnel. "Cavar" é eufremismo. 	
VO_LOOT_541_Male_Kobold_BOSS_Jeeru_01	Ah, não, não, não, não! Não esfrega a lâmpada! É cilada.	
VO_LOOT_541_Male_Kobold_BOSS_Lyris_01	Elfa tasca-fogo doida! Cuidado com o pessoal-serpente de fogo que anda com ela.	
VO_LOOT_541_Male_Kobold_BOSS_MagmaRager_01	Kobolds bota tábua em tubo de lava, mas abre de novo ninguém sabe como.	
VO_LOOT_541_Male_Kobold_BOSS_Mothergloop_01	Cuidado com Glub-mãe. Glub que gluba outros glub tudo!	
VO_LOOT_541_Male_Kobold_BOSS_Mushhuckster_01	Max Trocafungo vem da banda podre da masmorra.	
VO_LOOT_541_Male_Kobold_BOSS_Russell_01	Música que bardo canta faz todo mundo atacar direto.	
VO_LOOT_541_Male_Kobold_BOSS_Seriona_01	Dragão de Crepúsculo idiota faz kobolds fraco! Hã... mais fraco!	
VO_LOOT_541_Male_Kobold_BOSS_Sturmi_01	Sturmi faz monte amigo pequeno de cera! Ah, ela diverte muito em festa de kobold. 	
VO_LOOT_541_Male_Kobold_BOSS_TrappedRoom_01	Shhhh... Não... toca... NADA...	
VO_LOOT_541_Male_Kobold_BOSS_TreasureVault_01	Tesouro! Tesouro aqui. Dá porrada e pega tudo!	
VO_LOOT_541_Male_Kobold_BOSS_Troll_01	Dieta de masmorra balanceada obrigatório ter chefe troll.	
VO_LOOT_541_Male_Kobold_BOSS_Whopwhisker_01	Bom e velho Torapelo é mais kobold brabo de tudo. Hehe.	
VO_LOOT_541_Male_Kobold_DefeatPlayer_01	Tanto tesouro! Hehe... Meu, meu, meu, meu, meu.	
VO_LOOT_541_Male_Kobold_EmoteResponse_01	Para com tagarelice.	
VO_LOOT_541_Male_Kobold_LOOT_Backpacks_01	Mochila! Agora não é mais só pra costas!	
VO_LOOT_541_Male_Kobold_LOOT_Boombox_01	Caixa de bomba! A melhor caixa de bomba que foi botada em caixa.	
VO_LOOT_541_Male_Kobold_LOOT_Candle1_01	Não pega vela!	
VO_LOOT_541_Male_Kobold_LOOT_Candle2_01	Eu fala pra você! Eu fala pra cê não pegar, mas cê vai e pega!	
VO_LOOT_541_Male_Kobold_LOOT_CapturedFlag_01	Aliança e Horda têm doidiça por bandeira. 	
VO_LOOT_541_Male_Kobold_LOOT_Cube_01	Ah, cubo maluco! Quando não dá mais para ganhar!	
VO_LOOT_541_Male_Kobold_LOOT_Invisibility_01	Manto de invisibilidez! Eu perdo sempre! É invisível.	
VO_LOOT_541_Male_Kobold_LOOT_QuelDelar_01	Quel'Delar! Espada lendária se parte em duas. Não culpa minha.	
VO_LOOT_541_Male_Kobold_LOOT_QuelDelarForged_01	Tão brilhante! Tão preciosa! Tão... espadosa!	
VO_LOOT_541_Male_Kobold_LOOT_Wand_01	Kobolds adora Bastão de Torrefação. Verdadeiro card de testar perícia.	
VO_LOOT_541_Male_Kobold_LOOT_WaxRager_01	Furiante de cera amigo muito poderoso. Não pergunta de onde vem cera. De ouvido.	
VO_LOOT_541_Male_Kobold_TUT_AdventureSelect_01	Que cheiro é esse? Couro? Aço? Tocha... AVENTUREIROS. Bah! Aventureiros!	
VO_LOOT_541_Male_Kobold_TUT_BossHeroPower_01	Cada monstro faz coisa diferente. Tudo malvado. Clica pra ver!	
VO_LOOT_541_Male_Kobold_TUT_BountyBoard_01	Pare! Vai embora! Pilha de tesouro pra MIM, não VOCÊ.	
VO_LOOT_541_Male_Kobold_TUT_CharacterSelect_01	Quem ousa pegar tesouro de kobolds? Um taca-espada? Um lança-fogo?	
VO_LOOT_541_Male_Kobold_TUT_Final_Boss_Azari_01	O devorador estar solto! Corre, corre! 	
VO_LOOT_541_Male_Kobold_TUT_Final_Boss_Darkness_01	Tem que ter cuidado com as trevas! Por isso que kobolds carregar vela.	
VO_LOOT_541_Male_Kobold_TUT_Final_Boss_KoboldKing_01	Minha vez, heh-hah! Eu saqueia os saque tudo, você traz saque!	
VO_LOOT_541_Male_Kobold_TUT_Final_Boss_Vustrasz_01	Você quer levar tesouro do dragão!? Uuuui... ele ficar com MUITA raiva...	
VO_LOOT_541_Male_Kobold_TUT_Final_Boss_Xol_01	Não bota olho em olho de Xol! Tem olho na cara dela toda. 	
VO_LOOT_541_Male_Kobold_TUT_Game1Begin1_01	Primeiro, tudo monstro fraco e pequeno. Mas você também!	
VO_LOOT_541_Male_Kobold_TUT_Game1Begin2_01	Dá porrada e toma coisa deles pra ficar mais forte! 	
VO_LOOT_541_Male_Kobold_TUT_Game1Defeat_01	Não faz mal. Melhor morrer jovem do que não morrer nunca. 	
VO_LOOT_541_Male_Kobold_TUT_Game1Victory_01	Você ganha! Pega saque tudo agora. Heh-hah! Aventureiro clássico.	
VO_LOOT_541_Male_Kobold_TUT_Game2Begin1_01	Quando você fica mais forte, monstro tudo fica forte também. 	
VO_LOOT_541_Male_Kobold_TUT_Game2Begin2_01	Elasticidade pecuniária é um fator crucial no mercado misto adotado pelo Império Kobold.	
VO_LOOT_541_Male_Kobold_TUT_GeneralDefeat1_01	Que pena. Pra você. Quando aventureiro morre, Rei Kobold ganha os saque tudo!	
VO_LOOT_541_Male_Kobold_TUT_GeneralDefeat2_01	Traz mais aventureiro! Heh-hah! Mais saque pra mim, mais saque, mais saque, mais saque...	
VO_LOOT_541_Male_Kobold_TUT_MainBoss1_01	Muitos monstros você encontra em império kobold. Cada luta deixa você mais forte... ou morto.	
VO_LOOT_541_Male_Kobold_TUT_MainBoss3_01	Cada masmorra tem oito monstros! Um pra cada dedo.	
VO_LOOT_541_Male_Kobold_TUT_TreasureSelect1_01	AHHH! Baita tesouro! Cê escolhe um, só um. Faz escolha direito.	
VO_LOOT_541_Male_Kobold_TUT_TreasureSelect2_01	Cards que você escolhe entra no seu Deck de Masmorra.	
VO_LOOT_541_Male_Kobold_TUT_TreasureSelect3_01	Monta deck pra dar porrada com monstro. Seu deck fica até você morrer!	
VO_LOOT_541_Male_Kobold_TUT_TreasureSelect4_01	Vence mais luta, ganha mais saque! Jeito kobold de viver!	
VO_LOOT_541_Male_Kobold_TUT_Victory1_01	O quê?! Ninguém leva embora tesouro de kobold!	
VO_LOOT_541_Male_Kobold_TUT_Victory2_01	Muito menos nove vezes diferentes!	
VO_LOOT_541_Male_Kobold_TUT_VictoryComplete_01	Você ganha! Você agora maior mestre de masmorra de todos! 	
VO_LOOT_541_Male_Kobold_TUT_VictoryComplete_02	Você ganha! Você agora\nmestre de masmorra!  	
VO_LOOTA_829_Male_Human_Event_01	Maldita seja minha súbita, mas inevitável traição!	
VO_LOOTA_BOSS_04h_Female_Kobold_Death_01	<Morte>	
VO_LOOTA_BOSS_04h_Female_Kobold_DefeatPlayer_01	Fica quieto! Deixa cera esfriar... fica tão, tão, tão bonito...	
VO_LOOTA_BOSS_04h_Female_Kobold_EmoteResponse_01	Eu ceromante, não cerumano.	
VO_LOOTA_BOSS_04h_Female_Kobold_EventWaxOff_01	Sem cera...	
VO_LOOTA_BOSS_04h_Female_Kobold_EventWaxOn_01	Com cera!	
VO_LOOTA_BOSS_04h_Female_Kobold_EventWaxRagerPlay_01	Ah... que lindo!	
VO_LOOTA_BOSS_04h_Female_Kobold_EventWaxRagerRespawn_01	Ah, não para de aparecer, né?	
VO_LOOTA_BOSS_04h_Female_Kobold_Intro1_01	Ah, sim... cera tem olhos...	
VO_LOOTA_BOSS_04h_Female_Kobold_Intro2_01	Eu faz bonitezas bonitas, bonitezas de cera bonitas.	
VO_LOOTA_BOSS_05h_Male_Kobold_Death_01	<Morte>	
VO_LOOTA_BOSS_05h_Male_Kobold_DefeatPlayer_01	"Bam!" faz o Hamm! 	
VO_LOOTA_BOSS_05h_Male_Kobold_EmoteResponse_01	Num pega cabum.	
VO_LOOTA_BOSS_05h_Male_Kobold_EventBoomBots_01	Boa. BOA! Boa! Boa! Boa!	
VO_LOOTA_BOSS_05h_Male_Kobold_EventMadBomberDeath_01	Assim, não...	
VO_LOOTA_BOSS_05h_Male_Kobold_HeroPower1_01	Cabum. Haha! CA-BUM!	
VO_LOOTA_BOSS_05h_Male_Kobold_HeroPower2_01	Hahaha.	
VO_LOOTA_BOSS_05h_Male_Kobold_HeroPower3_01	Hahahaha.	
VO_LOOTA_BOSS_05h_Male_Kobold_Intro_01	Hehehe. Hora de demolição!	
VO_LOOTA_BOSS_06h_Male_Furbolg_Death_01	Há outro... lá embaixo...	
VO_LOOTA_BOSS_06h_Male_Furbolg_DefeatPlayer_01	Eu... Eu matei a coisa? O que foi que eu fiz...?	
VO_LOOTA_BOSS_06h_Male_Furbolg_EmoteResponse_01	Você não passa de... uma das vozes...	
VO_LOOTA_BOSS_06h_Male_Furbolg_EventPlayerEvolves_01	Você tem a dádiva da escuridão.	
VO_LOOTA_BOSS_06h_Male_Furbolg_HeroPower1_01	Estão me chamando...	
VO_LOOTA_BOSS_06h_Male_Furbolg_HeroPower2_01	Essas cavernas são profundas.	
VO_LOOTA_BOSS_06h_Male_Furbolg_HeroPower3_01	As coisas não são o que parecem...	
VO_LOOTA_BOSS_06h_Male_Furbolg_HeroPower4_01	Quem é o monstro aqui?	
VO_LOOTA_BOSS_06h_Male_Furbolg_HeroPower5_01	Você não ver as sombras... mas elas veem você.	
VO_LOOTA_BOSS_06h_Male_Furbolg_Intro_01	Alguma coisa sinistra está alojada aqui...	
VO_LOOTA_BOSS_09h_Female_Furbolg_Death_01	<Morte>	
VO_LOOTA_BOSS_09h_Female_Furbolg_DefeatPlayer_01	É assim que resolvemos as coisas em Hibérnia.	
VO_LOOTA_BOSS_09h_Female_Furbolg_EmoteResponse_01	Que frieza.	
VO_LOOTA_BOSS_09h_Female_Furbolg_EventFrostMagic1_01	Você também reverencia o frio.	
VO_LOOTA_BOSS_09h_Female_Furbolg_EventFrostMagic2_01	<Tremendo.>	
VO_LOOTA_BOSS_09h_Female_Furbolg_EventFrostMagic3_01	Que fria!	
VO_LOOTA_BOSS_09h_Female_Furbolg_HeroPower1_01	Brincando de estátua.	
VO_LOOTA_BOSS_09h_Female_Furbolg_HeroPower2_01	Ah, não. Isso, não.	
VO_LOOTA_BOSS_09h_Female_Furbolg_HeroPower3_01	Não sai daí.	
VO_LOOTA_BOSS_09h_Female_Furbolg_Intro_01	Kobolds! Já falei para vocês... ah... o que temos aqui?	
VO_LOOTA_BOSS_10h_Male_Human_Death_01	Tinha de ser assim...	
VO_LOOTA_BOSS_10h_Male_Human_DefeatPlayer_02	Eu reivindico esses tesouros... Pela Luz! E por mim.	
VO_LOOTA_BOSS_10h_Male_Human_EmoteResponse_01	Pedir misericórdia não lhe servirá de nada.	
VO_LOOTA_BOSS_10h_Male_Human_EventOverdraw_01	Não se faz isso!	
VO_LOOTA_BOSS_10h_Male_Human_HeroPower1_01	Creia!	
VO_LOOTA_BOSS_10h_Male_Human_HeroPower2_01	Você recebeu a cura!	
VO_LOOTA_BOSS_10h_Male_Human_HeroPower3_01	Não se entregue à escuridão!	
VO_LOOTA_BOSS_10h_Male_Human_HeroPower4_01	A Luz concede misericórdia.	
VO_LOOTA_BOSS_10h_Male_Human_HeroPower5_01	Magnífico!	
VO_LOOTA_BOSS_10h_Male_Human_Intro_01	Pare! Em nome da Luz, eu reivindico esses tesouros!	
VO_LOOTA_BOSS_11h_Male_Trogg_Death_01	<Morte>	
VO_LOOTA_BOSS_11h_Male_Trogg_DefeatPlayer_01	Um bom líder sabe o caminho, segue o caminho e mostra o chicote.	
VO_LOOTA_BOSS_11h_Male_Trogg_EmoteResponse_01	Não conversa mole. Só conversa pelo CHICOTE!	
VO_LOOTA_BOSS_11h_Male_Trogg_EventEquality_01	Ahhh... Lacaios pré-chicoteados!	
VO_LOOTA_BOSS_11h_Male_Trogg_HeroPower1_01	Anda logo!	
VO_LOOTA_BOSS_11h_Male_Trogg_HeroPower2_01	Agora vá!	
VO_LOOTA_BOSS_11h_Male_Trogg_HeroPower3_01	Mais rápido! 	
VO_LOOTA_BOSS_11h_Male_Trogg_HeroPower4_01	Acelera!	
VO_LOOTA_BOSS_11h_Male_Trogg_HeroPower5_01	Mete chicotada.	
VO_LOOTA_BOSS_11h_Male_Trogg_Intro_01	Hora da dor!	
VO_LOOTA_BOSS_12h_Male_Kobold_CandleAttack1_01	Você faz vela ficar com muita raiva!	
VO_LOOTA_BOSS_12h_Male_Kobold_CandleAttack2_01	Não provoca vela!	
VO_LOOTA_BOSS_12h_Male_Kobold_CandleAttack3_01	Rakanishu!	
VO_LOOTA_BOSS_12h_Male_Kobold_CandleAttack4_01	Hora de vela!	
VO_LOOTA_BOSS_12h_Male_Kobold_CandleAttack5_01	Não guenta vela!	
VO_LOOTA_BOSS_12h_Male_Kobold_Death_01	Não... pega...	
VO_LOOTA_BOSS_12h_Male_Kobold_Death1_01	Naufrágio!	
VO_LOOTA_BOSS_12h_Male_Kobold_Death2_01	Iaaaar... não...	
VO_LOOTA_BOSS_12h_Male_Kobold_Death3_01	Foi a pique!	
VO_LOOTA_BOSS_12h_Male_Kobold_DefeatPlayer_01	Hahar! Teu canhão explodiu pela culatra, hein!	
VO_LOOTA_BOSS_12h_Male_Kobold_DefeatPlayer_02	Tanto tesouro! Heh-hah. Agora eu mostra tudo a Rafaam...	
VO_LOOTA_BOSS_12h_Male_Kobold_EmoteResponse_01	Bah! Fecha matraca, marujo fajuto!	
VO_LOOTA_BOSS_12h_Male_Kobold_EventCandleStolen_01	Quê?! A regra de pega-vela é MUITO clara!	
VO_LOOTA_BOSS_12h_Male_Kobold_EventChargeBigMinion_01	Yo, ho, Yo	
VO_LOOTA_BOSS_12h_Male_Kobold_EventFindCandle_01	Ah, vela querida! Tá tudo bem... eu pega, eu pega...	
VO_LOOTA_BOSS_12h_Male_Kobold_EventPlayCandle_01	EU JÁ FALÁ... cê NÃO PEGA!	
VO_LOOTA_BOSS_12h_Male_Kobold_EventPlayerPlaysCrab_01	Tira isso daqui! Não!	
VO_LOOTA_BOSS_12h_Male_Kobold_EventPlayerPlaysPatches_01	Não! Eu comando! Eu!	
VO_LOOTA_BOSS_12h_Male_Kobold_EventPlayKoboldKing_01	Ah! Regicida.	
VO_LOOTA_BOSS_12h_Male_Kobold_GetTreasure1_01	Eu ganha tesouro também! Hehe!	
VO_LOOTA_BOSS_12h_Male_Kobold_GetTreasure2_01	Coisa brilhosa pra Rei Kobold...	
VO_LOOTA_BOSS_12h_Male_Kobold_GetTreasure3_01	O que eu ganha? Ah, bom!	
VO_LOOTA_BOSS_12h_Male_Kobold_GetTreasure4_01	Ah... tesouro! 	
VO_LOOTA_BOSS_12h_Male_Kobold_GetTreasure5_01	Minha masmorra! Meu tesouro!	
VO_LOOTA_BOSS_12h_Male_Kobold_Intro_01	Larga os tesouro tudo agora! Eu pega! Meu!	
VO_LOOTA_BOSS_12h_Male_Kobold_Intro1_01	Ah! Lagartos me mordam!	
VO_LOOTA_BOSS_12h_Male_Kobold_Intro2_01	Sargaços me torçam!	
VO_LOOTA_BOSS_12h_Male_Kobold_Intro3_01	Ah... arr... Mormaços me corram!	
VO_LOOTA_BOSS_13h_Female_Undead_Death_01	<Morte>	
VO_LOOTA_BOSS_13h_Female_Undead_DefeatPlayer_01	Agora, vejamos o que você estava levando... Sério que você escolheu esses cards?	
VO_LOOTA_BOSS_13h_Female_Undead_EmoteResponse_01	Primeira vez na masmorra? Aqui ninguém fica de conversa. 	
VO_LOOTA_BOSS_13h_Female_Undead_EventBagOfCoins_01	Ah, um aventureiro abastado...	
VO_LOOTA_BOSS_13h_Female_Undead_EventStealQuest_01	Pega ladrão!	
VO_LOOTA_BOSS_13h_Female_Undead_HeroPower_01	Atrás de mim!	
VO_LOOTA_BOSS_13h_Female_Undead_HeroPower1_01	Afaste-se.	
VO_LOOTA_BOSS_13h_Female_Undead_HeroPower2_01	Depressa. 	
VO_LOOTA_BOSS_13h_Female_Undead_HeroPower3_01	Dentro e fora das sombras...	
VO_LOOTA_BOSS_13h_Female_Undead_HeroPower4_01	Nunca dê chance para eles.	
VO_LOOTA_BOSS_13h_Female_Undead_Intro_01	Entregue o tesouro e será rápido e indolor.	
VO_LOOTA_BOSS_15h_Male_Human_Death_01	<Morte>	
VO_LOOTA_BOSS_15h_Male_Human_DefeatPlayer_01	Mais... se nós formos por ESSE lado, talvez dê para achar o caminho para Un'Goro.	
VO_LOOTA_BOSS_15h_Male_Human_EmoteResponse_01	Será que eu conheço você de Un'Goro?	
VO_LOOTA_BOSS_15h_Male_Human_Intro_01	Pela Luz! Onde viemos parar agora? 	
VO_LOOTA_BOSS_15h_Male_Human_PartnerDeath_01	Pela Luz, você matou o Carlos!	
VO_LOOTA_BOSS_15h_Male_Human_TaggedIn1_01	Sai da frente. Eu assumo agora.	
VO_LOOTA_BOSS_15h_Male_Human_TaggedIn2_01	Que coisa ridícula. Passa os cards pra cá.	
VO_LOOTA_BOSS_15h_Male_Human_TaggedIn3_01	Para trás, é MEU turno!	
VO_LOOTA_BOSS_16h_Male_Troll_Death_01	Agora eu fica falando só!	
VO_LOOTA_BOSS_16h_Male_Troll_DefeatPlayer_01	Aí, não esquenta, pessoinha morta. Azun te faz companhia agora.	
VO_LOOTA_BOSS_16h_Male_Troll_EmoteResponse_01	Eu falo c'os morto. Tu fala c'a mão.	
VO_LOOTA_BOSS_16h_Male_Troll_EventPlayerDeathrattle1_01	Aêêê, essa foi boa.	
VO_LOOTA_BOSS_16h_Male_Troll_EventPlayerDeathrattle2_01	Aqui ninguém descansa em paz.	
VO_LOOTA_BOSS_16h_Male_Troll_EventPlayerDeathrattle3_01	Dexa eu dá uma mãozinha pr'esse aí. 	
VO_LOOTA_BOSS_16h_Male_Troll_EventPlayerDeathrattle4_01	Uh… Melhó matá logo esse.	
VO_LOOTA_BOSS_16h_Male_Troll_EventPlayerDeathrattle5_01	Só se morre duas vez. Hahai!	
VO_LOOTA_BOSS_16h_Male_Troll_Intro_01	Eu falo c'os morto! Tá ligado? Tô ligado. 	
VO_LOOTA_BOSS_17h_Male_Troll_Death_01	<Morte>	
VO_LOOTA_BOSS_17h_Male_Troll_DefeatPlayer_01	Cê tá de treta com Jin'zo? Intão Jin'zo dá o troco pr'ocê.	
VO_LOOTA_BOSS_17h_Male_Troll_EmoteResponse_01	Não é hora de conversa. Agora é hora de CHORAR!	
VO_LOOTA_BOSS_17h_Male_Troll_EventPlayerBattlecry1_01	Hummm... Gostei da ideia desse aí.	
VO_LOOTA_BOSS_17h_Male_Troll_EventPlayerBattlecry2_01	Jin'zo aprova!	
VO_LOOTA_BOSS_17h_Male_Troll_EventPlayerBattlecry3_01	Ah, esse aí fala a língua de Jin'zo!	
VO_LOOTA_BOSS_17h_Male_Troll_EventPlayerBrann_01	Anãozinho pensa que grita mais alto que Jin'zo? TÁ ERRADO!	
VO_LOOTA_BOSS_17h_Male_Troll_Intro_01	Jin'zo tem GRANDES planos pr'ocê!	
VO_LOOTA_BOSS_19h_Male_Trogg_Death_01	<Morte>	
VO_LOOTA_BOSS_19h_Male_Trogg_DefeatPlayer_01	Se vier com truque barato, vai se ferrar.	
VO_LOOTA_BOSS_19h_Male_Trogg_EmoteResponse_01	Gosta de troggs? Eu tenho troggs.	
VO_LOOTA_BOSS_19h_Male_Trogg_EventHandFull_01	Agora, silêncio... Eu... hã, é demais!	
VO_LOOTA_BOSS_19h_Male_Trogg_HeroPower1_01	Vem cá, trogg!	
VO_LOOTA_BOSS_19h_Male_Trogg_HeroPower2_01	Pode continuar. Eu tenho mais.	
VO_LOOTA_BOSS_19h_Male_Trogg_HeroPower3_01	Eles sentem cheiro de magia.	
VO_LOOTA_BOSS_19h_Male_Trogg_HeroPowerHard1_01	Tanto poder.	
VO_LOOTA_BOSS_19h_Male_Trogg_HeroPowerHard2_01	Pode continuar.	
VO_LOOTA_BOSS_19h_Male_Trogg_HeroPowerHard3_01	Ahhhh… magia…	
VO_LOOTA_BOSS_19h_Male_Trogg_Intro_01	AJOELHA diante de TROGG!	
VO_LOOTA_BOSS_20h_Male_Earthen_Death_01	Dormiiiiir...	
VO_LOOTA_BOSS_20h_Male_Earthen_DefeatPlayer_01	O sacrário está seguro.	
VO_LOOTA_BOSS_20h_Male_Earthen_EmoteResponse_01	Não serei dissuadido.	
VO_LOOTA_BOSS_20h_Male_Earthen_EventPlayerSilence_01	Ora... agradeço.	
VO_LOOTA_BOSS_20h_Male_Earthen_EventStatueDestroyed1_01	Apenas adiando o inevitável.	
VO_LOOTA_BOSS_20h_Male_Earthen_EventStatueDestroyed2_01	É somente questão de tempo.	
VO_LOOTA_BOSS_20h_Male_Earthen_EventStatueDestroyed3_01	Você está profanando este lugar.	
VO_LOOTA_BOSS_20h_Male_Earthen_EventStatueDestroyed4_01	Tenho... que proteger... o sacrário...	
VO_LOOTA_BOSS_20h_Male_Earthen_EventStatueDestroyed5_01	Minha determinação é um rochedo...	
VO_LOOTA_BOSS_20h_Male_Earthen_HeroPower_01	DESPERTAR!	
VO_LOOTA_BOSS_20h_Male_Earthen_HeroPowerNoStatues_01	DESPERTAR... Ah.	
VO_LOOTA_BOSS_20h_Male_Earthen_Intro_01	Vá embora. Não há nada aqui para você.	
VO_LOOTA_BOSS_22h_Male_Murloc_Death_01	<Morte>	
VO_LOOTA_BOSS_22h_Male_Murloc_DeathSpecial_01	...!!	
VO_LOOTA_BOSS_22h_Male_Murloc_DefeatPlayer_01	...! ...?	
VO_LOOTA_BOSS_22h_Male_Murloc_EmoteResponse_01	...?!	
VO_LOOTA_BOSS_22h_Male_Murloc_EventFishUpChest_01	...	
VO_LOOTA_BOSS_22h_Male_Murloc_EventSummonCrab_01	...!!	
VO_LOOTA_BOSS_22h_Male_Murloc_FishLarge_02	...!	
VO_LOOTA_BOSS_22h_Male_Murloc_FishMedium_01	...?	
VO_LOOTA_BOSS_22h_Male_Murloc_FishSmall_01	...	
VO_LOOTA_BOSS_22h_Male_Murloc_Intro_01	...!	
VO_LOOTA_BOSS_23h_Male_Furbolg_Death_01	<Morte>	
VO_LOOTA_BOSS_23h_Male_Furbolg_DefeatPlayer_01	Deixe os ossos como alerta para os outros.	
VO_LOOTA_BOSS_23h_Male_Furbolg_EmoteResponse_01	Continue falando... assim minhas feras encontram você...	
VO_LOOTA_BOSS_23h_Male_Furbolg_EventPlayBigMinion1_01	A caçada... termina!	
VO_LOOTA_BOSS_23h_Male_Furbolg_EventPlayBigMinion2_01	Não há como fugir.	
VO_LOOTA_BOSS_23h_Male_Furbolg_EventPlayBigMinion3_01	Elas sentem seu medo!	
VO_LOOTA_BOSS_23h_Male_Furbolg_HeroPower1_01	Sua hora está chegando...	
VO_LOOTA_BOSS_23h_Male_Furbolg_HeroPower2_01	Meu poder continua crescendo.	
VO_LOOTA_BOSS_23h_Male_Furbolg_HeroPower3_01	Minhas feras encontrarão você.	
VO_LOOTA_BOSS_23h_Male_Furbolg_HeroPower4_01	Eu conheço estas cavernas. Você não sabe de nada.	
VO_LOOTA_BOSS_23h_Male_Furbolg_HeroPower5_01	Quem caça aqui sou EU.	
VO_LOOTA_BOSS_23h_Male_Furbolg_Intro_01	Aqui... VOCÊ é a caça!	
VO_LOOTA_BOSS_25h_Male_Dragon_Death_01	<Morte>	
VO_LOOTA_BOSS_25h_Male_Dragon_DefeatPlayer_01	Esses tesouros são antigos e veneráveis. Não sairão daqui. 	
VO_LOOTA_BOSS_25h_Male_Dragon_EmoteResponse_01	Eu levarei isso em consideração.	
VO_LOOTA_BOSS_25h_Male_Dragon_EventMarinTheFox_01	Marin, a Raposa! Você teve a ousadia voltar aqui?	
VO_LOOTA_BOSS_25h_Male_Dragon_HeroPower1_01	Queime, intruso.	
VO_LOOTA_BOSS_25h_Male_Dragon_HeroPower2_01	Saqueador ignóbil!	
VO_LOOTA_BOSS_25h_Male_Dragon_HeroPower3_01	Sofra!	
VO_LOOTA_BOSS_25h_Male_Dragon_HeroPower4_01	Fora daqui!	
VO_LOOTA_BOSS_25h_Male_Dragon_HeroPower5_01	Não dá mais para se esconder.	
VO_LOOTA_BOSS_25h_Male_Dragon_Intro_01	Apareça, ladrão infame. 	
VO_LOOTA_BOSS_25h_Male_Dragon_TreasureDestroy1_01	Isso não é seu!	
VO_LOOTA_BOSS_25h_Male_Dragon_TreasureDestroy2_01	Ladrão!	
VO_LOOTA_BOSS_25h_Male_Dragon_TreasureDestroy3_01	Devolva!	
VO_LOOTA_BOSS_25h_Male_Dragon_TreasureDestroy4_02	Criança gananciosa!	
VO_LOOTA_BOSS_25h_Male_Dragon_TreasureDestroy5_01	Você vai pagar pela sua ganância.	
VO_LOOTA_BOSS_26h_Female_Demon_Death_01	<Morte>	
VO_LOOTA_BOSS_26h_Female_Demon_DefeatPlayer_01	Intruso fraco e farsista. Eu vejo tudo.	
VO_LOOTA_BOSS_26h_Female_Demon_EmoteResponse_01	Eu só tenho olhos... para você.	
VO_LOOTA_BOSS_26h_Female_Demon_EyeStalkConfuse_01	Frustrado.	
VO_LOOTA_BOSS_26h_Female_Demon_EyeStalkDeath_01	Fatalidade.	
VO_LOOTA_BOSS_26h_Female_Demon_EyeStalkDevitalize_01	Fadiga.	
VO_LOOTA_BOSS_26h_Female_Demon_EyeStalkFear_01	Fracasso.	
VO_LOOTA_BOSS_26h_Female_Demon_EyeStalkFire_01	Fogo.	
VO_LOOTA_BOSS_26h_Female_Demon_EyeStalkFrost_01	Frio.	
VO_LOOTA_BOSS_26h_Female_Demon_Intro_01	Deve ser muito sagaz para ter chegado até aqui... quero ver como você é...	
VO_LOOTA_BOSS_32h_Male_Human_Death_01	<Morte>	
VO_LOOTA_BOSS_32h_Male_Human_EmoteResponse_01	Eu não falo com estranhos.	
VO_LOOTA_BOSS_32h_Male_Human_PartnerDeath_01	Ah, não! Jorge, não!	
VO_LOOTA_BOSS_32h_Male_Human_TaggedIn1_01	Deixe eu tentar!	
VO_LOOTA_BOSS_32h_Male_Human_TaggedIn2_01	Eu posso ajudar, Jorge!	
VO_LOOTA_BOSS_32h_Male_Human_TaggedIn3_01	Posso tentar, Jorge? Hein? Posso?	
VO_LOOTA_BOSS_34h_Male_Demon_Death_01	<Morte>	
VO_LOOTA_BOSS_34h_Male_Demon_DefeatPlayer_01	Eu preciso de mais... MAIS!	
VO_LOOTA_BOSS_34h_Male_Demon_EmoteResponse_01	Eu bebo do seu medo e me alimento de sua angústia. 	
VO_LOOTA_BOSS_34h_Male_Demon_HeroPower1_01	Alimento.	
VO_LOOTA_BOSS_34h_Male_Demon_HeroPower2_01	Mais...	
VO_LOOTA_BOSS_34h_Male_Demon_HeroPower3_01	Dê-me mais...	
VO_LOOTA_BOSS_34h_Male_Demon_HeroPower4_01	Eu devorarei este mundo.	
VO_LOOTA_BOSS_34h_Male_Demon_HeroPower5_01	Esse é o seu fim.	
VO_LOOTA_BOSS_34h_Male_Demon_Intro_01	TENHO FOME.	
VO_LOOTA_BOSS_35h_Male_Furbolg_Death_01	Vá embora... há apenas ruína adiante!	
VO_LOOTA_BOSS_35h_Male_Furbolg_DefeatPlayer_01	Seu corpo fica, mas sua alma finalmente está livre.	
VO_LOOTA_BOSS_35h_Male_Furbolg_EmoteResponse_01	Se você procura paz, deixe seus tesouros e parta.	
VO_LOOTA_BOSS_35h_Male_Furbolg_Intro_01	Suma daqui! Sua magia não tem poder aqui!	
VO_LOOTA_BOSS_35h_Male_Furbolg_SpellCountered1_01	Sua magia só faz alimentar a turba.	
VO_LOOTA_BOSS_35h_Male_Furbolg_SpellCountered2_01	Silêncio! 	
VO_LOOTA_BOSS_35h_Male_Furbolg_SpellCountered3_01	Suas forças desvanecem.	
VO_LOOTA_BOSS_35h_Male_Furbolg_SpellCountered4_01	Minha magia é mais forte que a sua...	
VO_LOOTA_BOSS_35h_Male_Furbolg_SpellCountered5_01	Não há como suplantar as antigas tradições.	
VO_LOOTA_BOSS_37h_Female_BloodElf_Death_01	Me queimei!	
VO_LOOTA_BOSS_37h_Female_BloodElf_DefeatPlayer_01	Se dançar na minha masmorra, vai se queimar...	
VO_LOOTA_BOSS_37h_Female_BloodElf_EmoteResponse_01	Você está brincando com fogo! Haha... Entendeu?	
VO_LOOTA_BOSS_37h_Female_BloodElf_EventFireball_01	Fogo... FOGO! 	
VO_LOOTA_BOSS_37h_Female_BloodElf_EventPyroblast_01	Quente! Quente! QUENTE!	
VO_LOOTA_BOSS_37h_Female_BloodElf_EventRagnaros_01	Ah, ESSE é o tipo de luta que eu gosto!	
VO_LOOTA_BOSS_37h_Female_BloodElf_EventTheCandle_01	Então... Foi VOCÊ que pegou a vela?	
VO_LOOTA_BOSS_37h_Female_BloodElf_Flamewakers_01	Que tal uns fogos de artifício?	
VO_LOOTA_BOSS_37h_Female_BloodElf_HeroPower1_01	Preciso de mais poder...	
VO_LOOTA_BOSS_37h_Female_BloodElf_HeroPower2_01	Mais... mais!	
VO_LOOTA_BOSS_37h_Female_BloodElf_HeroPower3_01	Feitiço é legal! Legal demais!	
VO_LOOTA_BOSS_37h_Female_BloodElf_Intro_01	As chamas farão você dançar!	
VO_LOOTA_BOSS_38h_Male_Kobold_Death_01	Maldição!	
VO_LOOTA_BOSS_38h_Male_Kobold_DefeatPlayer_01	Sabia que vodu pra você sai perfeito!	
VO_LOOTA_BOSS_38h_Male_Kobold_EmoteResponse_01	Mandinga pra você!	
VO_LOOTA_BOSS_38h_Male_Kobold_EventBrann_01	Vodu anão é vodu estranho.	
VO_LOOTA_BOSS_38h_Male_Kobold_EventPlayerBattlecries1_01	Esse tem muito grito.	
VO_LOOTA_BOSS_38h_Male_Kobold_EventPlayerBattlecries2_01	Esse grita muito. 	
VO_LOOTA_BOSS_38h_Male_Kobold_EventPlayerBattlecries3_01	Muito grito demais.	
VO_LOOTA_BOSS_38h_Male_Kobold_EventPlayerDeathrattles1_01	Esse tem muito suspiro!	
VO_LOOTA_BOSS_38h_Male_Kobold_EventPlayerDeathrattles3_01	Vodu é tudo peso morto.	
VO_LOOTA_BOSS_38h_Male_Kobold_EventRivendare_01	Vodu morto é pior tipo de vodu.	
VO_LOOTA_BOSS_38h_Male_Kobold_Intro_01	Eu faço vodu também!	
VO_LOOTA_BOSS_39h_Male_Golem_Death_01	Eu estou... quebrado…	
VO_LOOTA_BOSS_39h_Male_Golem_DefeatPlayer_01	O tesouro está a salvo. 	
VO_LOOTA_BOSS_39h_Male_Golem_EmoteResponse_01	Você não é o mestre.	
VO_LOOTA_BOSS_39h_Male_Golem_HeroPower1_01	Esmagar.	
VO_LOOTA_BOSS_39h_Male_Golem_HeroPower2_01	Pisar.	
VO_LOOTA_BOSS_39h_Male_Golem_HeroPower3_01	Ninguém passará!	
VO_LOOTA_BOSS_39h_Male_Golem_HeroPower4_01	Tão... pequenooo...	
VO_LOOTA_BOSS_39h_Male_Golem_HeroPower5_01	Fora daqui!	
VO_LOOTA_BOSS_39h_Male_Golem_Intro_01	Defender... o tesouro...	
VO_LOOTA_BOSS_40h_Female_Dragon_Death_01	<Morte>	
VO_LOOTA_BOSS_40h_Female_Dragon_DefeatPlayer_01	A revoada dragônica do crepúsculo há de se reerguer.	
VO_LOOTA_BOSS_40h_Female_Dragon_EmoteResponse_01	Hmmmm... não adianta discutir.	
VO_LOOTA_BOSS_40h_Female_Dragon_EventPlayTwilightDrake_01	Irmão, não ouse nos trair.	
VO_LOOTA_BOSS_40h_Female_Dragon_EventPlayTwilightWhelp_01	Volte para a revoada, pequenino!	
VO_LOOTA_BOSS_40h_Female_Dragon_HeroPower1_01	Comidaaa...!	
VO_LOOTA_BOSS_40h_Female_Dragon_HeroPower2_01	Sua força me sustenta.	
VO_LOOTA_BOSS_40h_Female_Dragon_HeroPower3_01	Minha raça há de persistir.	
VO_LOOTA_BOSS_40h_Female_Dragon_HeroPower4_01	Entregue-se ao crepúsculo.	
VO_LOOTA_BOSS_40h_Female_Dragon_Intro_01	Sinto um enorme poder. Aproxime-se...	
VO_LOOTA_BOSS_41h_Male_Kobold_Death_01	<Morte>	
VO_LOOTA_BOSS_41h_Male_Kobold_DefeatPlayer_01	EU leva vela. Você leva NADA.	
VO_LOOTA_BOSS_41h_Male_Kobold_EmoteResponse_01	Fecha matraca! Luta!	
VO_LOOTA_BOSS_41h_Male_Kobold_EventHornOfCenarius_01	Quê... QUÊ? Você luta sujo!	
VO_LOOTA_BOSS_41h_Male_Kobold_HeroPower1_01	Todo mundo.. Luta!	
VO_LOOTA_BOSS_41h_Male_Kobold_HeroPower2_01	Contenda!	
VO_LOOTA_BOSS_41h_Male_Kobold_HeroPower3_01	Montinho!	
VO_LOOTA_BOSS_41h_Male_Kobold_Intro_01	Devolve vela! 	
VO_LOOTA_BOSS_42h_Female_Furbolg_Armor10_01	Agradeço aos que vieram antes de mim.	
VO_LOOTA_BOSS_42h_Female_Furbolg_Armor15_01	Quão poderosos são os antigos!	
VO_LOOTA_BOSS_42h_Female_Furbolg_Armor20_01	Entregue seus tesouros para mim. Não há esperança!	
VO_LOOTA_BOSS_42h_Female_Furbolg_Armor5_01	Eu luto sem temor.	
VO_LOOTA_BOSS_42h_Female_Furbolg_Death_01	Hei de me unir... a meus ancestrais...	
VO_LOOTA_BOSS_42h_Female_Furbolg_DefeatPlayer_01	Louvados sejam os espíritos antigos! Meu escudo e livramento. 	
VO_LOOTA_BOSS_42h_Female_Furbolg_EmoteResponse_01	Os espíritos antigos... não gostam nem um pouco de você.	
VO_LOOTA_BOSS_42h_Female_Furbolg_Intro_01	Espíritos antigos! Eu os convoco.	
VO_LOOTA_BOSS_43h_Female_Djinn_Death_01	<Morte>	
VO_LOOTA_BOSS_43h_Female_Djinn_DefeatPlayer_01	Não era tudo o que você desejava...?	
VO_LOOTA_BOSS_43h_Female_Djinn_EmoteResponse_01	Desperdiçar um desejo com isso?	
VO_LOOTA_BOSS_43h_Female_Djinn_HeroAbility1_01	O que você deseja?	
VO_LOOTA_BOSS_43h_Female_Djinn_HeroAbility2_01	Um.. Dois... Três...	
VO_LOOTA_BOSS_43h_Female_Djinn_HeroAbility3_01	Desejo concedido!	
VO_LOOTA_BOSS_43h_Female_Djinn_HeroAbilityHandFull1_01	Heheheh.	
VO_LOOTA_BOSS_43h_Female_Djinn_HeroAbilityHandFull2_01	É demais para você?	
VO_LOOTA_BOSS_43h_Female_Djinn_HeroAbilityHandFull3_01	Cuidado com o que deseja.	
VO_LOOTA_BOSS_43h_Female_Djinn_Intro_01	Seu desejo é uma ordem... por um preço...	
VO_LOOTA_BOSS_44h_Female_Dragon_Death_01	<Morte>	
VO_LOOTA_BOSS_44h_Female_Dragon_DefeatPlayer_01	Já terminou! Tchau, tchau!	
VO_LOOTA_BOSS_44h_Female_Dragon_EmoteResponse_01	Não é a mamãe!	
VO_LOOTA_BOSS_44h_Female_Dragon_Intro_01	Ahh! Hora de comer?	
VO_LOOTA_BOSS_45h_Male_Gnome_Death_01	<Morte>	
VO_LOOTA_BOSS_45h_Male_Gnome_DefeatPlayer_01	É um jogo de toma lá, dá cá. E você é quem dá cá.	
VO_LOOTA_BOSS_45h_Male_Gnome_EmoteResponse_01	Este lugar parece um labirinto de passagens estreitas e sinuosas. Todas iguais!	
VO_LOOTA_BOSS_45h_Male_Gnome_HeroPower1_01	Brilhoso.	
VO_LOOTA_BOSS_45h_Male_Gnome_HeroPower2_01	Heheh...	
VO_LOOTA_BOSS_45h_Male_Gnome_HeroPower3_01	Cara! Ganhei.	
VO_LOOTA_BOSS_45h_Male_Gnome_HeroPower4_01	Coroa! Você perdeu.	
VO_LOOTA_BOSS_45h_Male_Gnome_Intro_01	Seus bolsos parecem estar cheios até demais, xará!	
VO_LOOTA_BOSS_46h_Male_Murloc_Death_01	<Morte>	
VO_LOOTA_BOSS_46h_Male_Murloc_DefeatPlayer_01	... ...? ...!	
VO_LOOTA_BOSS_46h_Male_Murloc_EmoteResponse_01	<Vomita>	
VO_LOOTA_BOSS_46h_Male_Murloc_HeroPower1_01	...	
VO_LOOTA_BOSS_46h_Male_Murloc_HeroPower2_01	...?	
VO_LOOTA_BOSS_46h_Male_Murloc_HeroPower3_01	...	
VO_LOOTA_BOSS_46h_Male_Murloc_Intro_01	...!!	
VO_LOOTA_BOSS_49h_Male_Elemental_Death_01	<Morte>	
VO_LOOTA_BOSS_49h_Male_Elemental_DefeatPlayer_01	Muahahaha...	
VO_LOOTA_BOSS_49h_Male_Elemental_EmoteResponse_01	Eu pego vela. É comigo. É o que eu faço.	
VO_LOOTA_BOSS_49h_Male_Elemental_HeroPower1_01	Escuridão...	
VO_LOOTA_BOSS_49h_Male_Elemental_HeroPower2_01	Fuja...	
VO_LOOTA_BOSS_49h_Male_Elemental_HeroPower3_01	Muahahahaha.	
VO_LOOTA_BOSS_49h_Male_Elemental_Intro_01	Sua luz está definhando, aventureiro...	
VO_LOOTA_BOSS_50h_Male_Kobold_Death_01	<Morte>	
VO_LOOTA_BOSS_50h_Male_Kobold_DefeatPlayer_01	Aí, sim! Troço do bom!	
VO_LOOTA_BOSS_50h_Male_Kobold_EmoteResponse_01	NÃO. Não aceita devolução.	
VO_LOOTA_BOSS_50h_Male_Kobold_EventKazakus_01	Kazakus, quer mais, é?	
VO_LOOTA_BOSS_50h_Male_Kobold_EventMakePotion1_01	Ah, essa... \n Nada bom.	
VO_LOOTA_BOSS_50h_Male_Kobold_EventMakePotion2_01	Essa é marvada, bem marvada, hehe.	
VO_LOOTA_BOSS_50h_Male_Kobold_EventMakePotion3_01	Sim! Hehe. Quer tomar? Hehe. Que pena.	
VO_LOOTA_BOSS_50h_Male_Kobold_EventUsePotion1_01	Ah! Essa ruim. Cheira isso!	
VO_LOOTA_BOSS_50h_Male_Kobold_EventUsePotion2_01	Sim!	
VO_LOOTA_BOSS_50h_Male_Kobold_EventUsePotion3_01	Hmm... \n Essa gosto ruim,\n mas ruim bom.	
VO_LOOTA_BOSS_50h_Male_Kobold_Intro_01	Ei... ei... quer comprar fungo pra provar?	
VO_LOOTA_BOSS_51h_Male_Dwarf_Death_01	Boa-noite, Azeroth!	
VO_LOOTA_BOSS_51h_Male_Dwarf_DefeatPlayer_02	Obrigado pelos teus lacaios, colega!	
VO_LOOTA_BOSS_51h_Male_Dwarf_EmoteResponse_01	Ah... Que inoportuno.	
VO_LOOTA_BOSS_51h_Male_Dwarf_EventBoombox_01	Ei! Abaixa esse troço aí!	
VO_LOOTA_BOSS_51h_Male_Dwarf_Intro_01	Fique um pouco e escute.	
VO_LOOTA_BOSS_51h_Male_Dwarf_KillingBlowReady_01	Kobolds & Catacumbas!	
VO_LOOTA_BOSS_51h_Male_Dwarf_Song1A_01	Você chamou campeões, pra uma série de missões…	
VO_LOOTA_BOSS_51h_Male_Dwarf_Song1B_01	Encontrar tesouros de montão!	
VO_LOOTA_BOSS_51h_Male_Dwarf_Song1C_01	Com perigos e problemas...	
VO_LOOTA_BOSS_51h_Male_Dwarf_Song1D_01	E a estrutura falhou na inspeção!	
VO_LOOTA_BOSS_51h_Male_Dwarf_Song2A_01	Roubou a luz deles, é? Melhor dar no pé!	
VO_LOOTA_BOSS_51h_Male_Dwarf_Song2B_01	Fugindo de armadilhas, saindo no tapa.	
VO_LOOTA_BOSS_51h_Male_Dwarf_Song2C_01	Corra feito uma gazela, com monstros na sua canela...	
VO_LOOTA_BOSS_51h_Male_Dwarf_Song2D_01	E o tempo todo não tire o olho do mapa.	
VO_LOOTA_BOSS_51h_Male_Dwarf_Song3A_01	Eles tão chegando perto. É melhor ficar esperto!	
VO_LOOTA_BOSS_51h_Male_Dwarf_Song3B_01	Senão aqui será a sua tumba.	
VO_LOOTA_BOSS_51h_Male_Dwarf_Song3C_01	Você veio em busca de ouro, mas vai deixar o seu couro?	
VO_LOOTA_BOSS_51h_Male_Dwarf_Song3D_01	Para os Kobolds & Catacumbas!	
VO_LOOTA_BOSS_51h_Male_Dwarf_Steal_01	Venha aqui!	
VO_LOOTA_BOSS_51h_Male_Dwarf_Steal_02	Vem cá!	
VO_LOOTA_BOSS_51h_Male_Dwarf_Steal_03	Hora de festejar!	
VO_LOOTA_BOSS_51h_Male_Dwarf_StealDoomsayer_01	Pior. Roadie. do Mundo!	
VO_LOOTA_BOSS_51h_Male_Dwarf_StealMinstrel_01	Ah! Hora do dueto!	
VO_LOOTA_BOSS_53h2_Female_Undead_Death_01	Paradoxo!	
VO_LOOTA_BOSS_53h2_Female_Undead_DefeatPlayer_01	Eu sabia que ganharia. Eu tinha visto meu futuro. 	
VO_LOOTA_BOSS_53h2_Female_Undead_EmoteResponse_01	Eu ludibriei os dragões de bronze. Você não é ameaça.	
VO_LOOTA_BOSS_53h2_Female_Undead_EventManaDestroyed_01	Você só está adiando o inevitável!	
VO_LOOTA_BOSS_53h2_Female_Undead_EventPlayerTimeWalk_01	Você também esteve na Ilha Perene?	
VO_LOOTA_BOSS_53h2_Female_Undead_Intro_01	O tempo pode ser desfeito. Você pode ser desfeito.	
VO_LOOTA_BOSS_53h2_Female_Undead_RitualPrep1_01	Sua hora chegará...	
VO_LOOTA_BOSS_53h2_Female_Undead_RitualPrep2_01	Meu poder se concentra.	
VO_LOOTA_BOSS_53h2_Female_Undead_RitualPrep3_01	Tique-taque...	
VO_LOOTA_BOSS_53h2_Female_Undead_TimeRewindPlayCard1_01	Eu fico cada vez melhor.	
VO_LOOTA_BOSS_53h2_Female_Undead_TimeRewindPlayCard2_01	Isso não é mais novidade.	
VO_LOOTA_BOSS_53h2_Female_Undead_TimeRewindPlayCard3_01	O tempo está do meu lado.	
VO_LOOTA_BOSS_53h2_Female_Undead_TimeRewindPlayCard4_01	Aquela que controla o tempo controla o infinito!	
VO_LOOTA_BOSS_53h2_Female_Undead_TimeRewindPlayCard5_01	Hora de acabar com isso!	
VO_LOOTA_BOSS_53h2_Female_Undead_TimeRewindStart1_01	Contemple minha descoberta!	
VO_LOOTA_BOSS_53h2_Female_Undead_TimeRewindStart2_01	A hora é agora!	
VO_LOOTA_BOSS_53h2_Female_Undead_TimeRewindStart3_01	De novo! Do começo de novo!	
VO_LOOTA_BOSS_53h2_Female_Undead_TimeRewindStart4_01	Agora é a minha vez!	
VO_LOOTA_BOSS_54h_Female_Human_Death_01	Eu não tava pronta!	
VO_LOOTA_BOSS_54h_Female_Human_DefeatPlayer_01	Ok! Agora eu tô pronta.	
VO_LOOTA_BOSS_54h_Female_Human_EmoteResponse_01	Daqui a pouco eu chego aí. Me avisa quando a luta começar!	
VO_LOOTA_BOSS_54h_Female_Human_Intro_01	<canta coisas desconexas distraída>	
VO_LOOTA_BOSS_54h_Female_Human_Intro_02	<canta coisas desconexas distraída>	
VO_LOOTA_BOSS_54h_Female_Human_Intro_03	<canta coisas desconexas distraída>	
VO_LOOTA_BOSS_54h_Female_Human_Intro_04	<assobio distraído>	
VO_LOOTA_BOSS_54h_Female_Human_Intro_07	<murmúrio distraído>	
VO_LOOTA_BOSS_54h_Female_Human_WakeUp_01	Ah! Estamos lutando?	
VO_Maiden_Female_Titan_FinalMaidenEmoteResponse_01	Seu comportamento não será tolerado.	
VO_Maiden_Female_Titan_FinalMaidenEyeForAnEye_01	A justiça foi feita.	
VO_Maiden_Female_Titan_FinalMaidenHeroPower_01	Lance fora seus pensamentos corruptos.	
VO_Maiden_Female_Titan_FinalMaidenHumility_01	Sim! Ajoelhe-se e talvez você viva!	
VO_Maiden_Female_Titan_FinalMaidenOpen_01	Você evocou um agente dos titãs?	
VO_Maiden_Female_Titan_FinalMaidenTurn5_01	Somos eternos. Você não tem valor!	
VO_Malchezaar_Male_Demon_Brawl_06	Você certamente já sabe que não pode vencer.	
VO_Malchezaar_Male_Demon_EmoteParty_01	Malquezaar gosta de festa também!	
VO_Malchezaar_Male_Demon_FinalAltOpening_01	Reles idiotas!	
VO_Malchezaar_Male_Demon_FinalMalchezaarDeath_01	Não! De novo, não!	
VO_Malchezaar_Male_Demon_FinalMalchezaarEmoteResponse_01	Eu serei a sua ruína!	
VO_Malchezaar_Male_Demon_FinalMalchezaarHeroPower_01	Você não enfrenta apenas Malquezaar, mas as legiões que comando!	
VO_Malchezaar_Male_Demon_FinalMalchezaarJaraxxus_01	Você! Esse convite é meu!	
VO_Malchezaar_Male_Demon_FinalMalchezaarMedivhSkin_01	Veio de fantasia? Hmmm... bem que eu poderia...	
VO_Malchezaar_Male_Demon_FinalMalchezaarSacrificialPact_03	Hahaha! Isso jamais funcionaria num verdadeiro Lorde Eredar!	
VO_Malchezaar_Male_Demon_FinalMalchezaarTurn1_01	O magus é poderoso, mas acha que tem chance de sobreviver a um poder esmagador?	
VO_Malchezaar_Male_Demon_FinalMalchezaarTurn7_01	Estou escutando música! Medivetes! A festa! É hoje que vai rolar!	
VO_Malchezaar_Male_Demon_FinalThirdSequence_01	Evocado de volta para Karazhan? Bem na hora da festa!	
VO_Malchezaar_Male_Demon_FinalThirdSequence_04	Sai da minha frente, idiota!	
VO_Malchezaar_Male_Demon_PrologueEmoteResponse_01	Reles idiota!	
VO_Malchezaar_Male_Demon_PrologueHeroPower_01	Qualquer dimensão ou realidade está aberta a mim!	
VO_Malchezaar_Male_Demon_PrologueOpen_01	Cadê meu convite?	
VO_Malchezaar_Male_Demon_PrologueTurn1_04	Você não me convidou?! Eu sou um príncipe dos Eredar!	
VO_Malchezaar_Male_Demon_PrologueTurn11_02	Você convidou Jaraxxus? O fracote?	
VO_Malchezaar_Male_Demon_PrologueWin_01	Levarei você comigo então!	
VO_Mediva_01_Female_Blood Elf_AranSpell_04	Ahhh... brrrr!	
VO_Mediva_01_Female_Blood Elf_ChessEmoteOops_06	Opa.	
VO_Mediva_01_Female_Blood Elf_PrologueTurn5_06	Medivetes!	
VO_Mediva_02_Female_Draenei_JulianneDeadlyPoison_02	Que trágico!	
VO_Mediva_02_Female_Draenei_PrologueTurn5_05	Sim?	
VO_Mediva_03_Male_Night Elf_AranHeroPower_01	Queima, neném, queima!	
VO_Mediva_03_Male_Night Elf_CuratorBeasts_04	Atchim, neném!	
VO_Mediva_03_Male_Night Elf_PrologueTurn5_01	Chamou?	
VO_Medivas_Multiple_Multiple_CroneLionTigerBear_01	Nossa!	
VO_Medivas_Multiple_Multiple_IllhoofWounded_01	Hmm... tô com medinho!	
VO_Medivas_Multiple_Multiple_NetherspiteTurn1_01	Raios!	
VO_Medivh_Male_Human_EmoteGreetings_01	O que está fazendo aqui?	
VO_Medivh_Male_Human_EmoteOops_01	Esse era o seu plano?	
VO_Medivh_Male_Human_EmoteSorry_01	Ahh, essa não deu certo...	
VO_Medivh_Male_Human_EmoteThanks_01	Você é muito gentil.	
VO_Medivh_Male_Human_EmoteThreaten_01	Você não tem nem chance!	
VO_Medivh_Male_Human_EmoteWellPlayed_01	Boa tentativa, demônio.	
VO_Medivh_Male_Human_EmoteWow_01	Ha ha ha! Essa foi fantástica!	
VO_Medivh_Male_Human_FinalMalchezaarTurn5_01	Excelente trabalho, Tristão – a festa já está a todo vapor!	
VO_Medivh_Male_Human_FinalMalchezaarWin_01	Bom trabalho! Vamos lá, é hora da festa!	
VO_Medivh_Male_Human_FinalMedivhMedivhSkin_01	Ei, espera aí! Você sou eu amanhã? Então me diz... como foi a nossa festa, hein? BOMBOU, não foi?	
VO_Medivh_Male_Human_FinalThirdSequence_01	Ah, um convidado! Cuide desse demônio, por favor. Sou o anfitrião da festa!	
VO_Medivh_Male_Human_FinalThirdSequence_02	Ele deixou você sem cards? Fique à vontade para usar os portais.	
VO_Medivh_Male_Human_FinalThirdSequence_03	Tome, pegue meu cajado. Ele controla os portais. Não vá arranhar, hein!	
VO_Medivh_Male_Human_PrologueDeath_02	Quê? Impossível!	
VO_Medivh_Male_Human_PrologueHeroPower_01	Mas não esta festa!	
VO_Medivh_Male_Human_PrologueOpen_01	Hunf, você de novo?	
VO_Medivh_Male_Human_PrologueTurn1_02	Depois daquela? Ainda estamos consertando o buraco no teto!	
VO_Medivh_Male_Human_PrologueTurn11_01	Já ouviu ele cantar no karaokê? É incrível!	
VO_Medivh_Male_Human_PrologueTurn3_02	Tristão, vá cuidar do xadrez. Os verdadeiros convidados devem estar chegando.	
VO_Medivh_Male_Human_PrologueTurn9_01	Os balões! Tristão, esquecemos os balões!	
VO_Medivh_Male_Human_PrologueWin_01	Volte para casa, demônio!	
VO_Medivh_Male_Human_Wing0Intro_01	Nós já demos vida à prataria, ensaiamos a ópera e deixamos tudo pronto no viveiro. Hoje será uma noite inesquecível!	
VO_Medivh_Male_Human_Wing4Win_01	Venha, camarada! Aproveite a festa!	
VO_Mirror_Male_Mirror_MirrorDeath_01	Ei! Você trapaceou! Quero revanche!	
VO_Mirror_Male_Mirror_MirrorEmoteResponse_01	Não, você!	
VO_Mirror_Male_Mirror_MirrorFirstCard_01	Olha só! Você tem esse card no deck??	
VO_Mirror_Male_Mirror_MirrorMedivhSkin_01	Ah! Senhor Medivh! Está bem alinhado... Quê? Peraí! Você não é Medivh!	
VO_Mirror_Male_Mirror_MirrorMirrorImage_01	Ei, esse é meu card favorito! Qual é o seu? Furiante de Magma?	
VO_Mirror_Male_Mirror_MirrorOpen_02	E AÊEEEE!	
VO_Mirror_Male_Mirror_MirrorTurn1_01	Putz, vocês são feios, hein?	
VO_Mirror_Male_Mirror_MirrorTurn3_01	Espelho, espelho meu, quem é mais belo do que eu?	
VO_Mirror_Male_Mirror_MirrorTurn3_03	Você não, vovô!	
VO_Mirror_Male_Mirror_MirrorTurn5_02	Nefarius? Tá mais pra Ne-feio-rus, não acha? Uhuu-huu-huu!	
VO_Mirror_Male_Mirror_MirrorWellPlayedResponse_01	Queria poder dizer o mesmo! Ba-dum-tss!	
VO_Moroes_Male_Human_AranTurn1_01	*Suspiro* Este é Aran, o fantasma rezingueiro.	
VO_Moroes_Male_Human_AranTurn9_04	Os dragões já devoraram o bufê todo e agora estão de olho nos murlocs!	
VO_Moroes_Male_Human_AranWin_01	O portal fica no próximo aposento! Chegamos a tempo!	
VO_Moroes_Male_Human_ChessForfeit_02	Acabaram-se suas peças. O jogo está perdido.	
VO_Moroes_Male_Human_ChessTurn1_03	Aqui as peças atacarão automaticamente no final do seu turno.	
VO_Moroes_Male_Human_ChessTurn3_01	Se uma peça estiver entre dois inimigos, ela atingirá os dois!	
VO_Moroes_Male_Human_ChessTurn5_01	Posicionamento é a chave da vitória aqui. Use os ataques duplos!	
VO_Moroes_Male_Human_ChessTurn7_01	Os outros convidados estão esperando lá fora! Estamos quase na ópera, mas temos que correr!	
VO_Moroes_Male_Human_ChessTurn7_02	Você não tem muitas peças. Se elas acabarem, você perde.	
VO_Moroes_Male_Human_ChessTurn7_03	O senhor não tem muitas peças. Se elas acabarem, você perde.	
VO_Moroes_Male_Human_ChessWin_01	Excelente! Para a ópera!	
VO_Moroes_Male_Human_CroneTurn5_02	O Senescal Executus está lá embaixo. Digo a ele que chegou cedo demais?	
VO_Moroes_Male_Human_CroneWin_01	Finalmente! Agora podemos libertar o mago!	
VO_Moroes_Male_Human_CuratorTurn3_01	O Curador está confuso! Você tem que detê-lo antes que ele solte tudo que tem lá!	
VO_Moroes_Male_Human_CuratorWin_01	Pois bem... Só um ajuste... e... ele fica novo!	
VO_Moroes_Male_Human_EndWing1_01	Excelente! A ópera fica logo após essa escada! Tenho certeza de que Barnes nos deixará entrar logo!	
VO_Moroes_Male_Human_FinalAltTurn5_01	Hã... Há tantos portais... Será que é este aqui...	
VO_Moroes_Male_Human_FinalMaidenTurn1_01	Desculpe. Cuide desse aqui e tenho certeza que eu posso encontrar os controles certos.	
VO_Moroes_Male_Human_FinalMaidenTurn7_03	Ah, é o mundo dos tentáculos. Esse aí, definitivamente não.	
VO_Moroes_Male_Human_FinalNazraTurn7_02	Lute contra a orquisa para podermos abrir outro portal!	
VO_Moroes_Male_Human_FinalSecondSequence_01	Excelente! Vamos ver se este aqui funciona...	
VO_Moroes_Male_Human_FInalStartSequence_01	Hmmm... Vejamos. Hã, que tal este?	
VO_Moroes_Male_Human_FinalThirdSequence_01	Agora sim!	
VO_Moroes_Male_Human_FinalTurn1_02	Ops! Portal errado. Lute contra a orquisa para eu tentar de novo.	
VO_Moroes_Male_Human_IllhoofKilrekResponse_01	O que eles estão tentando evocar?	
VO_Moroes_Male_Human_JulianneTurn5_01	Barnes, deixe-nos entrar! Temos que achar Medivh antes que acabem com a festa!	
VO_Moroes_Male_Human_JulianneTurn9_02	Illidan chegou! Não estamos preparados!	
VO_Moroes_Male_Human_MedivhSkinResponse_01	Fantasia de Medivh? Bom, a semelhança é impressionante!	
VO_Moroes_Male_Human_MirrorTurn3_01	Hummmm...	
VO_Moroes_Male_Human_MirrorTurn5_01	Lorde Nefarius chegará em breve. Tremo só de pensar como ele vai reagir.	
VO_Moroes_Male_Human_MirrorWin_02	Excelente! A escada para a ópera fica logo adiante.	
VO_Moroes_Male_Human_NetherspiteTurn1_01	Aqueles raios energizam o dragão. Use os lacaios para bloqueá-los!	
VO_Moroes_Male_Human_NetherspiteTurn5_01	Diga-nos em qual deles Medivh está!	
VO_Moroes_Male_Human_NetherspiteTurn7_01	Precisamos dos portais! Os convidados estão jogando livros no poço de mana!	
VO_Moroes_Male_Human_NetherspiteWin_01	Muito bem! Agora, deixe eu lembrar como isso funciona...	
VO_Moroes_Male_Human_NightbaneTurn3_01	Curador, precisamos resgatar Medivh!	
VO_Moroes_Male_Human_NightbaneTurn7_01	A Liga dos Exploradores chegou. RENO, DEVOLVE A PRATARIA!	
VO_Moroes_Male_Human_PrologueTurn11_01	*A-hem* E ele não queimou a biblioteca...	
VO_Moroes_Male_Human_PrologueTurn5_03	Senhor, o trio Medivetes está a postos. Barnes está ensaiando com eles.	
VO_Moroes_Male_Human_PrologueTurn7_01	Já viu como está lá fora, senhor? Os chefes dos raides estão se estapeando por convites.	
VO_Moroes_Male_Human_PrologueTurn9_02	Senhor, murlocs têm pavor de balões. Lembra da outra vez?	
VO_Moroes_Male_Human_PrologueWin_02	Olha, isso é ruim. Isso é ruim demais.	
VO_Moroes_Male_Human_SilverwareResponse_01	Hunf. Esse era de antiquário.	
VO_Moroes_Male_Human_SilverwareTurn3_02	A prataria está trabalhando em grupo! Estamos cercados!	
VO_Moroes_Male_Human_SilverwareWin_01	Ah, que bagunça!	
VO_Moroes_Male_Human_Wing1Intro_02	Eu sou Tristão, o responsável por Karazhan. Preciso da sua ajuda. Medivh sumiu! Vamos usar os portais do topo da torre para salvar ele e a festa!	
VO_Moroes_Male_Human_Wing1Win_01	Muito bem! A esta altura, vamos chegar ao topo da torre a tempo de salvar a festa!	
VO_Moroes_Male_Human_Wing2Win_01	Avante! No próximo andar, fica o Curador que cuida do viveiro. Espero que esteja funcionando...	
VO_Moroes_Male_Human_Wing3Open_02	O Curador cuida do viveiro, o lar das criaturas mais exóticas de Azeroth. Passando dele, ficam os aposentos de Medivh e o portal para salvá-lo.	
VO_Moroes_Male_Human_Wing3Win_02	Quase lá! Temos que salvar Medivh antes que a festa vire uma confusão!	
VO_Moroes_Male_Human_Wing4Intro_01	Enfim! O topo da torre! Encontre o portal certo e traga Medivh de volta!	
VO_Moroes_Male_Human_Wing4Win_01	Você conseguiu. Não acredito que a festa começou na hora. Pode vir de novo semana que vem? É aniversário de Medivh e hã... eu preciso de reforços.	
VO_Moroes_Male_Human_WolfClaws_03	Não há como isso ser verdade.	
VO_NAX1_01_CARD_02	Só um gostinho!	
VO_NAX1_01_DEATH_05	Por que, por quêêê?	
VO_NAX1_01_EMOTE_04	Isso fala!	
VO_NAX1_01_HP_03	Cheguem mais perto, bocadinhos saborosos!	
VO_NAX1_01_START_01	Seja bem-vindo ao meu salão.	
VO_NAX10_01_DEATH_LINE_03	O que... aconteceu com... Reta... aaarhh...	
VO_NAX10_01_EMOTE1_04	É hora de brincar?	
VO_NAX10_01_EMOTE2_05	É! Brincar! Brincar!	
VO_NAX10_01_HP_02	Cabou a brincadeira?	
VO_NAX10_01_START_01	Retalhoso quer brincar!	
VO_NAX11_01_CARD_03	Gosma.	
VO_NAX11_01_DEATH_05	*ugh uh ahoh gowr grrrlrrlrrlaaahhh*	
VO_NAX11_01_EMOTE_04	Sem conversa.	
VO_NAX11_01_HP_02	Fedor.	
VO_NAX11_01_START_01	Carne.	
VO_NAX12_01_CARD_01	*Rugido*	
VO_NAX12_01_DEATH_01	*choraminga*	
VO_NAX12_01_EMOTE_01	*Resmungo*	
VO_NAX12_01_EMOTE_02	*Grrr*	
VO_NAX12_01_EMOTE_03	*Grrroooooo*	
VO_NAX12_01_HP_01	*Rrrrrrrrrr NHAM*	
VO_NAX12_01_START_01	*Rosnado*	
VO_NAX13_01_DEATH_LINE_03	Obrigado...	
VO_NAX13_01_EMOTE_04	Matar!	
VO_NAX13_01_HP_02	Morra agora!	
VO_NAX13_01_START_01	Eu tenho que obedecer.	
VO_NAX14_01_CARD_01	*rrrrrAAAHH*	
VO_NAX14_01_DEATH_01	*rrrrrarrr...*	
VO_NAX14_01_EMOTE_01	*rrrr Rrahhh!*	
VO_NAX14_01_EMOTE_02	*grraaaaah*	
VO_NAX14_01_EMOTE_03	*rrrrraaaaahh*	
VO_NAX14_01_HP_01	*ggraarrr*	
VO_NAX14_01_START_01	*GRROOAARRR*	
VO_NAX15_01_BIGGLES_32	Não!! Maldito seja, invasor!	
VO_NAX15_01_DEATH_LINE_08	Isso não é o fim!!! Ainda tem o modo heroico!	
VO_NAX15_01_DEATH_LINE2_09	NÃÃãããÃÃããÃÃOooOOOoo!!!	
VO_NAX15_01_EMOTE_HELLO_26	Você sempre cumprimenta quem tenta matar você?	
VO_NAX15_01_EMOTE_OOPS_29	Foi mesmo.	
VO_NAX15_01_EMOTE_SORRY_28	Está tudo bem, caro invasor, nós todos cometemos erros.	
VO_NAX15_01_EMOTE_THANKS_27	Ahm... de nada?	
VO_NAX15_01_EMOTE_THREATEN_30	Ooh, que medo!	
VO_NAX15_01_EMOTE_WP_25	É claro que eu joguei bem. Eu sou Kel'Thuzad, em Naxx eu esculacho!	
VO_NAX15_01_HP_07	Congelarei o sangue em suas veias!	
VO_NAX15_01_HP2_05	Sua alma agora é minha.	
VO_NAX15_01_HP3_06	Não haverá escapatória.	
VO_NAX15_01_HURRY_31	Minha paciência tem limites.	
VO_NAX15_01_PHASE2_10	Tolo! Você espalhou demais suas forças!	
VO_NAX15_01_PHASE2_ALT_11	Não! Seu turno acabou. Agora é o *MEU* turno.	
VO_NAX15_01_RESPOND_ANDUIN_24	Não seja ingênuo! Não se lembra do que aconteceu com Uther?	
VO_NAX15_01_RESPOND_GARROSH_15	Sério? Então que seja morte!	
VO_NAX15_01_RESPOND_GARROSH_ALT_16	Isso é uma pegadinha? Porque parece que vai ser morte!	
VO_NAX15_01_RESPOND_GULDAN_22	Bom, estou achando que alguém vai roubar a alma de alguém, HEIINN!	
VO_NAX15_01_RESPOND_JAINA_23	Pedi nada! VOCÊ que veio invadindo a MINHA necrópole flutuante!	
VO_NAX15_01_RESPOND_MALFURION_ALT_21	"A natureza?" Então o que você veio fazer aqui em Naxxramas??	
VO_NAX15_01_RESPOND_REXXAR_19	À vontade.	
VO_NAX15_01_RESPOND_THRALL_17	Você está lutando por causa de um martelo? Tá... tá bom, então.	
VO_NAX15_01_RESPOND_UTHER_14	... e eu lutarei com lacaios enormes e feitiços devastadores. Boa sorte!	
VO_NAX15_01_RESPOND_VALEERA_18	Tá... bem?	
VO_NAX15_01_START_13	Finalmente nos encontramos.	
VO_NAX15_01_SUMMON_ADDS_12	Libertem-se, meus lacaios!	
VO_NAX2_01_CARD_02	Matem-nos em nome do Mestre!	
VO_NAX2_01_CUSTOM_03	Você fracassou!	
VO_NAX2_01_DEATH_LINE_05	O mestre vai me vingar!	
VO_NAX2_01_EMOTE_06	Hahahaha!	
VO_NAX2_01_HP_04	Ajoelhe-se diante de mim, verme!	
VO_NAX2_01_START_01	Meus acólitos me servem sem hesitação!	
VO_NAX3_01_CARD_01	*grghhghgh*	
VO_NAX3_01_DEATH_01	*sibilando*	
VO_NAX3_01_EMOTE_01	*sibilando*	
VO_NAX3_01_EMOTE_02	*sibilando*	
VO_NAX3_01_EMOTE_03	*sibilando*	
VO_NAX3_01_EMOTE_04	*sibilando*	
VO_NAX3_01_EMOTE_05	*sibilando*	
VO_NAX3_01_HP_01	*sibilando*	
VO_NAX3_01_START_01	*rastejando*	
VO_NAX4_01_CARD_03	E não se levante mais!	
VO_NAX4_01_DEATH_LINE_04	Vou servir ao mestre... na morte!	
VO_NAX4_01_EMOTE_06	Morte aos intrusos!	
VO_NAX4_01_HP_02	Ergam-se, meus soldados! Ergam-se e lutem uma vez mais!	
VO_NAX4_01_START_01	Mais uma alma para a... "coleção".	
VO_NAX5_01_CARD_03	Eu vou detonar a sua MENTE!	
VO_NAX5_01_DEATH_LINE_04	Eu devia ter tomado um banho...	
VO_NAX5_01_EMOTE_05	Não tenho tempo para essa bobagem.	
VO_NAX5_01_HP_02	Dancem, seus tolos!	
VO_NAX5_01_START_01	Você acha que está seguro aqui?	
VO_NAX6_01_CARD_03	O fim se aproxima.	
VO_NAX6_01_DEATH_LINE_04	*rruuuhhhh*	
VO_NAX6_01_EMOTE_05	Você desperdiça seu fôlego.	
VO_NAX6_01_HP_02	Você me pertence agora.	
VO_NAX6_01_START_01	Eu vejo você.	
VO_NAX7_01_CARD_03	Vocês deveriam ter ficado em casa!	
VO_NAX7_01_DEATH_LINE_04	Uma morte honrosa...	
VO_NAX7_01_EMOTE_05	Haha! Eu estou só esquentando!	
VO_NAX7_01_HP_02	Iiaaahh!	
VO_NAX7_01_START_01	Não... Não! Meus alunos! Devolvam-nos agora!	
VO_NAX8_01_CARD_02	Pode matar meus lacaios... As almas deles logo visitarão você.	
VO_NAX8_01_CUSTOM_03	Hahaha! Isso é tolice! Eu sou o Ceifador de Almas!	
VO_NAX8_01_CUSTOM2_04	Os mortos retornam!	
VO_NAX8_01_DEATH_LINE_05	Esse... é o meu... fim...	
VO_NAX8_01_EMOTE1_06	Como tolo, você buscou o próprio fim.	
VO_NAX8_01_EMOTE2_07	Com sua petulância, você ignorou poderes além da sua compreensão.	
VO_NAX8_01_EMOTE3_08	Você lutou com afinco para invadir o reino do Ceifador.	
VO_NAX8_01_EMOTE4_09	Agora só há um jeito de sobreviver...	
VO_NAX8_01_EMOTE5_10	... ir no menu de opções e clicar em DESISTIR.	
VO_NAX8_01_START_01	Meus lacaios nunca morrem de verdade.	
VO_NAX9_01_CUSTOM_02	Chega de conversa. Deixe eles virem.	
VO_NAX9_01_DEATH_LINE_03	Não! Eu preciso de mais tempo!	
VO_NAX9_01_EMOTE_04	Está procurando a morte?	
VO_NAX9_01_START_01	Nós vamos triturar seus ossos.	
VO_NAX9_02_CUSTOM_01	Saia daqui enquanto pode!	
VO_NAX9_03_CUSTOM_01	Venha Zeliek, vamos nos divertir.	
VO_NAX9_04_CUSTOM_01	Venha lutar, seu afrouxalhado!	
VO_Nazra_Female_Orc_FinalNazraChogall_02	O clã Martelo do Crepúsculo? Aqui?	
VO_Nazra_Female_Orc_FinalNazraDeath_01	Pela Horda...	
VO_Nazra_Female_Orc_FinalNazraEmoteResponse_01	Nazra vai esmagar você!	
VO_Nazra_Female_Orc_FinalNazraGrom_01	Grommash?! Há quanto tempo!	
VO_Nazra_Female_Orc_FinalNazraHeroPower_01	Nazra dominará este mundo medíocre!	
VO_Nazra_Female_Orc_FinalStartSequence_01	Curve-se ante a Horda!	
VO_NEFARIAN_ATRAMEDES_DEATH_76	Você matou um dragão cego. Você devia ter vergonha.	
VO_NEFARIAN_BARON_GEDDON_DEAD_40	Estamos perto. Sim. Sim!	
VO_NEFARIAN_CHROMAGGUS_DEAD_63	Na verdade, Cromaggus era meu lacaio mais fraco. Você já estava se achando, não é?	
VO_NEFARIAN_CHROMAGGUS1_59	Eu deixei ele com duas cabeças porque pensei: "Opa, duas mordidas!"	
VO_NEFARIAN_CHROMAGGUS2_60	Eu infundi nele os poderes de todas as revoadas. Ele é perfeito.	
VO_NEFARIAN_CHROMAGGUS3_61	Bom trabalho, Cromaggus. Bom garoto.	
VO_NEFARIAN_CHROMAGGUS4_62	Sua mão está ficando meio lotada? Bom cachorrinho.	
VO_NEFARIAN_COREN_DEAD_28	O Glutão Implacável. Que engraçado.	
VO_NEFARIAN_DRAKKISATH_DEAD_50	Estou começando a me irritar.	
VO_NEFARIAN_DRAKKISATH_RESPOND_48	Sim, Drakkisath. Aventureiro — você continua do lado errado da montanha!	
VO_NEFARIAN_DRAKKISATH1_49	Escuta, vai lá jogar uma partida ranqueada. Essa aventura não é para o seu bico.	
VO_NEFARIAN_GARR_DEAD1_38	Pegue uma pedrinha do Garr e atire na poça de lava do Ragnaros. Ele iria gostar.	
VO_NEFARIAN_GARR2_35	Cuidado com aquelas criaturas de pedra, viu?	
VO_NEFARIAN_GARR3_36	Cuidado pra não explodir. Você ainda precisa expulsar o lorde elemental.	
VO_NEFARIAN_GARR4_37	Sabe, eu gosto de ver você trabalhando.	
VO_NEFARIAN_GRIMSTONE_DEAD1_30	Continue assim e Ragnaros em breve será expulso desta montanha!	
VO_NEFARIAN_HEROIC_BLOCK_77	Não no Modo Heroico.	
VO_NEFARIAN_MALORIAK_DEATH_PT1_72	Meus parabéns! Que conquista incríííííível.	
VO_NEFARIAN_MALORIAK_DEATH_PT2_73	Acho que vou dar um nome novo para você, para comemorar este momento.	
VO_NEFARIAN_MALORIAK_DEATH_PT3_74	Matador de Lacaios Burros, Incompetentes e Decepcionantes. Sim. Acho que tem tudo a ver.	
VO_NEFARIAN_MALORIAK_TURN2_71	Maloriak, tente não perder para esse mortal.	
VO_NEFARIAN_NEF_MISSION_66	Isso é trapaça! Eu não vou tolerar isso!	
VO_NEFARIAN_NEF2_65	Não! Não! Eu vou destruir você!	
VO_NEFARIAN_OMNOTRON_DEAD_69	Você me fez economizar uma boa grana em consertos. Obrigado.	
VO_NEFARIAN_OMOKK_DEAD_46	Isso não faz o menor sentido!	
VO_NEFARIAN_OMOKK1_44	Por que você está aqui? Ragnaros está morto. Você devia estar comemorando com seus amigos.	
VO_NEFARIAN_OMOKK2_45	Estou confuso. Aqui não tem Ragnaros. Você cumpriu sua missão. Vá para casa.	
VO_NEFARIAN_RAZORGORE_DEAD_55	Aqueles ovos eram para experiências gloriosas!	
VO_NEFARIAN_REND_DEAD_53	Muito bem, mortal. Você está mexendo com o dragão errado.	
VO_NEFARIAN_REND1_52	Até o orc sabe que você tá errado!	
VO_NEFARIAN_THAURISSAN_DEAD_32	Você devia ter matado aquele outro anão! Não deixe ninguém vivo!	
VO_NEFARIAN_THAURISSAN_DEAD2_33	Você matou os dois anões? Impressionante, aventureiro.	
VO_NEFARIAN_VAEL_DEAD_57	Hah! Você matou um dos mocinhos! Isso te deixou triste?	
VO_Netherspite_Male_Dragon_NetherspiteAngryChicken_01	Você de novo? Por que está sempre nos meus portais?!	
VO_Netherspite_Male_Dragon_NetherspiteDeath_01	Meu trabalho...	
VO_Netherspite_Male_Dragon_NetherspiteEmoteResponse_01	Você desafia um dragão em seu laboratório?	
VO_Netherspite_Male_Dragon_NetherspiteEmpowerment_01	Tantos mundos! Tanto a aprender!	
VO_Netherspite_Male_Dragon_NetherspiteOpen_01	Quem perturba a minha pesquisa?	
VO_Netherspite_Male_Dragon_NetherspiteShadowBreath_01	Vá embora!	
VO_Netherspite_Male_Dragon_NetherspiteTurn12_01	Hmm... Se 12 murlocs saem do portal vermelho às 4 horas, e CThun chega às 5 horas... Hmmm... Calculo que...	
VO_Netherspite_Male_Dragon_NetherspiteTurn3_02	Meus experimentos! Deixe-os em paz!	
VO_Netherspite_Male_Dragon_NetherspiteTurn5_01	Pare de tocar nos portais! As modulações de fluxo são muito precisas!	
VO_Netherspite_Male_Dragon_NetherspiteTurn7_01	A festa parece divertida. Vá para lá e deixe meus portais em paz!	
VO_Netherspite_Male_Dragon_NetherspiteUnstablePortal_01	Interessante. Flutuações ressonantes revelam instabilidades fundamentais.	
VO_Netherspite_Male_Dragon_NetherspiteUnstablePortal_02	Interessante... Instabilidades fundamentais...	
VO_Nightbane_Roar	*RUGIDO*	
VO_PrinceKeleseth_Male_Vampire_ResponseLanaThel_01	Minha Rainha!	
VO_PrinceTaldaram_Male_Vampire_ResponseLanaThel_01	Minha Rainha... Tenho sede.	
VO_PrinceValanar_Male_Vampire_ResponseLanaThel_01	Rainha Lana'thel!	
VO_RAGNAROS_GRIMSTONE_DEAD2_66	EU VOU TRITURAR VOCÊ, SEU FRACOTE ESCAMOSO!	
VO_RAGNAROS_NEF1_71	AVENTUREIRO! PARECE QUE VOCÊ PRECISA DE AJUDA!	
VO_RAGNAROS_NEF3_72	A VINGANÇA SERÁ MINHA! SEJA PURIFICADO PELO FOGO!	
VO_RAGNAROS_NEF4_73	VOU MANDAR MEUS LACAIOS PARA DESTRUIR VOCÊ, ASA NEGRA!	
VO_RAGNAROS_NEF5_74	TRANSFORME ESSE DRAGÃO POMPOSO EM CINZAS!	
VO_RAGNAROS_NEF6_75	UM PRESENTE DAS TERRAS DO FOGO!	
VO_RAGNAROS_NEF7_76	É IMPOSSÍVEL APAGAR AS CHAMAS DO SENHOR DO FOGO!	
VO_RAGNAROS_NEF8_77	EU TEREI MINHA VINGANÇA, DRAGÃO!	
VO_Rakanishu_Male_Elemental_CastSpell1_01	Não pega... EU!	
VO_Rakanishu_Male_Elemental_CastSpell2_01	Seja purificado pelo fogo!	
VO_Rakanishu_Male_Elemental_CastSpell3_01	Morra, aventureiro!	
VO_Rakanishu_Male_Elemental_CastSpell4_01	Por Rafaam!	
VO_Rakanishu_Male_Elemental_CastSpell5_01	Tudo vai queimar!	
VO_Rakanishu_Male_Elemental_EventRagnaros_02	Meu herói!	
VO_Rakanishu_Male_Elemental_Intro_01	Destrua! Pegue o tesouro!	
VO_SilverwareGolem_Male_SilverwareGolem_SilverwareDeath_02	Em pratos limpos...	
VO_SilverwareGolem_Male_SilverwareGolem_SilverwareEmoteResponse_01	Hora de polir!	
VO_SilverwareGolem_Male_SilverwareGolem_SilverwareForkedLightning_01	Gosta de garfos? Eu tenho garfos!	
VO_SilverwareGolem_Male_SilverwareGolem_SilverwareHeroPower_01	Prato cheio! Vira a mesa!	
VO_SilverwareGolem_Male_SilverwareGolem_SilverwareKnifeJuggler_01	Uuuh, arremesso de faca!	
VO_SilverwareGolem_Male_SilverwareGolem_SilverwareOpen_01	Dançar é legal!	
VO_SilverwareGolem_Male_SilverwareGolem_SilverwarePlateTossing_01	Pegue um prato! Pegue um prato! Todo mundo pega um prato!	
VO_TB_MEDIVA1_001	Queime...	
VO_TB_MEDIVA1_002	Cuidado!	
VO_TB_MEDIVA1_003	Ah, Tito!	
VO_TB_MEDIVA1_004	Bendito seja...	
VO_TB_MEDIVA1_005	Feroz!	
VO_TB_MEDIVA1_006	Peludinha fofinha	
VO_TB_MEDIVA1_007	Não! Veneno, não.	
VO_TB_MEDIVA1_008	Brilhante!	
VO_TB_MEDIVA1_009	Chamou?	
VO_TB_MEDIVA2_001	Quente!	
VO_TB_MEDIVA2_002	Bizarro!	
VO_TB_MEDIVA2_003	Uuh, frio!	
VO_TB_MEDIVA2_004	Essa não, uma armadilha!	
VO_TB_MEDIVA2_005	Ai, não posso nem ver.	
VO_TB_MEDIVA2_006	Bonitinho	
VO_TB_MEDIVA2_007	Adoro diabretes.	
VO_TB_MEDIVA2_008	Brilhante!	
VO_TB_MEDIVA2_009	Atchim! ATCHÔ!	
VO_TB_MEDIVA2_010	Você ligou?	
VO_TB_MEDIVA3_001	Quente!	
VO_TB_MEDIVA3_002	Gelado, boneco de neve!	
VO_TB_MEDIVA3_003	Escuro bizarro!	
VO_TB_MEDIVA3_004	Armadilha!	
VO_TB_MEDIVA3_005	Isso que são feras!	
VO_TB_MEDIVA3_006	Ele tem mascotes!	
VO_TB_MEDIVA3_007	Ah, não, tudo triste.	
VO_TB_MEDIVA3_008	Isso que é veneno...	
VO_TB_MEDIVA3_009	E agora... Medivetes!	
VO_TB_MEDIVA3_010	Sim - aaaaahh!	
VO_Terenas_Male_Human_ICCDruidVictory_01	No passado, ele costumava nutrir a vida protegendo a natureza de Azeroth. Agora, Malfurion, o Pestilento, mantém o equilíbrio natural cultivando um jardim de morte.	
VO_Terenas_Male_Human_ICCHunterVictory_01	Rexxar libertou as almas aprisionadas pelo Lich Rei e sacou uma flecha negra da aljava. "Venha, Misha!" , disse ele. "A caçada começa..."	
VO_Terenas_Male_Human_ICCMageVictory_01	A recém-coroada Lich do Gelo contemplou seus domínios. Legiões de mortos-vivos somavam seu poder ao dela. Seu sangue congelava, mas ela nem sequer percebeu.	
VO_Terenas_Male_Human_ICCPaladinVictory_01	O outrora nobre paladino abraçou seu novo destino. Aqueles que viveram uma vida digna nada teriam a temer. Mas, na morte, os tortuosos enfrentariam seu julgamento... 	
VO_Terenas_Male_Human_ICCPriestVictory_01	O corpo do jovem príncipe se dissolveu nas sombras. "Agora eu posso ver", disse ele, os olhos ardendo em chamas azuladas. "Quanta inocência, eu tive..."	
VO_Terenas_Male_Human_ICCRogueVictory_01	Valira, a Nefasta, desapareceu noite adentro. Suas sombras a tudo enxergam, e ninguém está a salvo de sua lâmina gélida...	
VO_Terenas_Male_Human_ICCShamanVictory_01	A mente do xamã foi inundada por vozes, uma cacofonia dos mortos. O Necrovidente fechou os olhos e pronunciou uma palavra: "Durmam..."	
VO_Terenas_Male_Human_ICCWarlockVictory_01	Enfim Gul'dan se sentava no Trono de Gelo. O Portal Negro se abriu novamente, e incontáveis mundos estremeceram diante dele.	
VO_Terenas_Male_Human_ICCWarriorVictory_01	Aquele que uma vez fora Chefe Guerreiro da Horda abraçou o novo poder com o qual se deparara. As vítimas enregeladas de seu exército se ergueriam para servi-lo, até ele se tornar o único senhor de tudo que seus olhos viam.	
VO_TIRION_INTRO_03	Qual desses valentes cavaleiros se tornará Campeão hoje?	
VO_WhiteKing_Male_ChessPiece_ChessDeath_01	Xeque-mate...	
VO_WhiteKing_Male_ChessPiece_ChessEmoteGreetings_01	Vai uma jogatina?	
VO_WhiteKing_Male_ChessPiece_ChessEmoteOops_01	Ah, que equívoco.	
VO_WhiteKing_Male_ChessPiece_ChessEmoteSorry_01	Um resultado indesejável.	
VO_WhiteKing_Male_ChessPiece_ChessEmoteThanks_01	Que gentileza.	
VO_WhiteKing_Male_ChessPiece_ChessEmoteThinking_01	Torre na casa A3...	
VO_WhiteKing_Male_ChessPiece_ChessEmoteThinking_02	Cavalo na casa F6...	
VO_WhiteKing_Male_ChessPiece_ChessEmoteThinking_03	Rainha na casa E5... Não, não...	
VO_WhiteKing_Male_ChessPiece_ChessEmoteThreaten_01	Xeque-mate em 4.	
VO_WhiteKing_Male_ChessPiece_ChessEmoteWellPlayed_01	Xeque-mate.	
VO_WhiteKing_Male_ChessPiece_ChessEmoteWow_01	Ah, excepcional!	
VO_WhiteKing_Male_ChessPiece_ChessOpen_02	En garde!	
VOX_Nightbane_Start_01	Raaargh!	
