TAG	TEXT	COMMENT
MISSION_PRE_TUTORIAL_WANTED	Wanted	
MISSION_NEFARIAN_TITLE	Slayer of Stupid, Incompetent, and Disappointing Minions
MISSION_DEFAULTCOUNTERNAME	|4(Turn,Turns) to Escape
MISSION_GLOWING_POOL	A Glowing Pool	
MISSION_PIT_OF_SPIKES	A Pit of Spikes	
MISSION_STATUES_EYE	The Statue's Eye	
MISSION_TAKE_THE_SHORTCUT	Take the Shortcut?	
TB_DECKBUILDING_FIRSTPICKTHREE	Pick a new card for your hand.
TB_DECKBUILDING_FIRSTCARDPLAYED	After you play a card, shuffle a copy into your deck.
TB_DECKBUILDING_FIRSTENDTURN	Now return your hand to your deck and redraw.
TB_DECKBUILDING_STARTOFGAME	Build your team as you play! Good luck!
TB_DECKBUILDING_STARTOFGAME_START	Start!
TB_GIFTEXCHANGE_GIFTSPAWNED	If your side has no crate, then one's delivered.
TB_GIFTEXCHANGE_GIFTSTOLEN	You got a gift! What could it be...
TB_GIFTEXCHANGE_START	Happy Winter's Veil! Grab those gifts!
TB_PICKYOURFATE_RANDOM_NEWFATE	You need a new fate!
TB_PICKYOURFATE_RANDOM_OPPONENTFATE	Your opponent needs a new fate!
TB_PICKYOURFATE_RANDOM_FIRSTFATE	Chosen fates affect both players!
TB_PICKYOURFATE_BUILDAROUND_NEWFATE	Remember, this bonus is only for you.
TB_PICKYOURFATE_BUILDAROUND_OPPONENTFATE	Remember, this bonus is only for your opponent.
TB_PICKYOURFATE_BUILDAROUND_FIRSTFATE	Chosen fates affect both players!
TB_PICKYOURFATE_BUILDAROUND_OPPONENT_FIRSTFATE	Your opponent's fate affects you as well!
TB_SHADOWTOWERS_SHADOWSPAWNED	If a side has no tower, then one is summoned.
TB_SHADOWTOWERS_SHADOWSPAWNEDNEXT	Missing towers are replaced at the start of their owner's turn.
TB_SHADOWTOWERS_ADJACENTMINIONS	Minions next to a tower are <b>Stealthed</b> and Can't Attack.
TB_DECKRECIPE_OG_DRUID	Use the Druid’s Mana-generating spells to summon the servants of the Old Gods way ahead of schedule.  
TB_DECKRECIPE_OG_HUNTER	Do not fear death, hero; your minions are useful to you both alive and dead. Keep trading your minions for theirs; you will eventually overwhelm them.
TB_DECKRECIPE_OG_MAGE	Cast as many spells as possible. Each one will fuel the reawakening of Yogg-Saron!
TB_DECKRECIPE_OG_PALADIN	Protect your minions with Divine Shield and they’ll be able to take on two enemies at a time!
TB_DECKRECIPE_OG_PRIEST	Heal your minions to keep them alive long enough to see the rise of the horrific C’Thun!
TB_DECKRECIPE_OG_ROGUE	Trade your minions aggressively! Most of them give you an advantage when they're killed, so sacrifice away.
TB_DECKRECIPE_OG_SHAMAN	Summon as many minions as possible before evolving them! Evolve minions that have already done work for you to maximize your value!
TB_DECKRECIPE_OG_WARLOCK	Bolster your armies with the innumerable minions of the Old Gods. Swarm the board with smaller minions to overwhelm your opponent.
TB_DECKRECIPE_OG_WARRIOR	Protect yourself as your devotion to C’Thun grows. Amass enough armor that your opponent’s efforts become futile before the Old Gods!
TB_LETHALPUZZLES_SUCCESS	You did it!
TB_LETHALPUZZLES_START	Each round, you must defeat your opponent... good luck!
TB_LETHALPUZZLES_FAILURE	 Try again!

TB_DECKRECIPE_MSG_DRUID	Deck recipe: <b>The Lotus’ Golems</b>.
TB_DECKRECIPE_MSG_HUNTER	Deck recipe: <b>Band of Beasts</b>.
TB_DECKRECIPE_MSG_MAGE	Deck recipe: <b>Kabalist Mixology</b>.
TB_DECKRECIPE_MSG_PALADIN	Deck recipe: <b>The Black Market</b>.
TB_DECKRECIPE_MSG_PRIEST	Deck recipe: <b>Dragonheart</b>.
TB_DECKRECIPE_MSG_ROGUE	Deck recipe: <b>Gadgetzan Dockside</b>.
TB_DECKRECIPE_MSG_SHAMAN	Deck recipe: <b>Murloc Association</b>.
TB_DECKRECIPE_MSG_WARLOCK	Deck recipe: <b>Demons of the Kabal</b>.
TB_DECKRECIPE_MSG_WARRIOR	Deck recipe: <b>The Goons’ Empire</b>.

TB_DPROMO_2NDHERO	The Cow King
TB_DPROMO_2NDHEROPOPUP	You made it to the Secret Level!
TB_DPROMO_COWKINGEMOTES	Moo

TB_MP_CROSSROADS	Wait, who's that guy?

TB_MP_STORMWIND_SUCCESS	You did it! How much more can you go?
TB_MP_BOSS	Decorated Stormwind
TB_MP_BOSS2	Partytown
TB_MP_BOSS3	Party Capital

TB_MP_CROSSROADS_CRASHER	What's he doing here??

TB_MP_COOP_TEXT_START	Use your Hero Power to decorate the Tavern with the other player! 
TB_MP_COOP_FIRST_CRASHER	Watch out! Those guys are trying to crash the party. Get rid of them!
TB_MP_COOP_PINATA	You did it! Time to hit the Piñata! But the Party Crashers are getting out of hand....
TB_MP_COOP_CRASHER_DISCARD	The Party Crasher gets bored of sitting in the player's hand and leaves.
TB_MP_COOP_ENDING	Success! Thanks for celebrating the Year of the Mammoth with us!
TB_MP_COOP_1STSPELL	Uh oh, the Kabal may have gotten into the punch....
TB_MP_COOP_2NDSPELL	Please don't light the fireworks inside!

TB_100TH_RAVENIDOL_YOU	You are playing the brawl Idols of Azeroth, which debuted as the 45th brawl on April 20th, 2016.
TB_100TH_RAVENIDOL_OPP	Your opponent is playing the brawl Idols of Azeroth, which debuted as the 45th brawl on April 20th, 2016.
TB_100TH_RANDOMONIUM_YOU	You are playing the brawl Randomonium, which debuted as the 18th brawl on October 14th, 2015.
TB_100TH_RANDOMONIUM_OPP	Your opponent is playing the brawl Randomonium, which debuted as the 18th brawl on October 14th, 2015.
TB_100TH_BANANA_YOU	You are playing the brawl Banana Brawl!, which debuted as the 2nd brawl on June 24th, 2015.
TB_100TH_BANANA_OPP	Your opponent is playing the brawl Banana Brawl!, which debuted as the 2nd brawl on June 24th, 2015.
TB_100TH_YOGG_YOU	You are playing the brawl Servant of Yogg-Saron Tryouts, which debuted as the 57th brawl on July 13th, 2016.
TB_100TH_YOGG_OPP	Your opponent is playing the brawl Servant of Yogg-Saron Tryouts, which debuted as the 57th brawl on July 13th, 2016.
TB_100TH_PARTYPORTAL_YOU	You are playing the brawl Party Portals!, which debuted as the 64th brawl on August 31st, 2016.
TB_100TH_PARTYPORTAL_OPP	Your opponent is playing the brawl Party Portals!, which debuted as the 64th brawl on August 31st, 2016.
TB_100TH_CLONEBALL_YOU	You are playing the brawl Cloneball!, which debuted as the 52nd brawl on June 8th, 2016.
TB_100TH_CLONEBALL_OPP	Your opponent is playing the brawl Cloneball!, which debuted as the 52nd brawl on June 8th, 2016.
TB_100TH_SPELLBAG_YOU	You are playing the brawl Valeera's Bag of Burgled Spells, which debuted as the 76th brawl on November 23rd, 2016.
TB_100TH_SPELLBAG_OPP	Your opponent is playing the brawl Valeera's Bag of Burgled Spells, which debuted as the 76th brawl on November 23rd, 2016.
TB_100TH_PORTALS_YOU	You are playing the brawl Too Many Portals!, which debuted as the 7th brawl on July 29th, 2015.
TB_100TH_PORTALS_OPP	Your opponent is playing the brawl Too Many Portals!, which debuted as the 7th brawl on July 29th, 2015.
TB_100TH_SHIFTER_YOU	You are playing the brawl ShiftCon, which debuted as the 55th brawl on June 29th, 2016.
TB_100TH_SHIFTER_OPP	Your opponent is playing the brawl ShiftCon, which debuted as the 55th brawl on June 29th, 2016.

TB_100TH_RAVENIDOL_INFO_YOU	Your deck is made up of 30 Raven Idols. 
TB_100TH_RAVENIDOL_INFO_OPP	Your opponent's deck is made up of 30 Raven Idols. 
TB_100TH_RANDEMONIUM_INFO_YOU	Your deck is made up of random cards that switch their costs every turn. 
TB_100TH_RANDEMONIUM_INFO_OPP	Your opponent's deck is made up of random cards that switch their costs every turn. 
TB_100TH_BANANA_INFO_YOU	Your deck is made up of random cards. Whenever one of your minions dies, you get a banana. 
TB_100TH_BANANA_INFO_OPP	Your opponent's deck is made up of random cards. Whenever one of their minions dies, they get a banana. 
TB_100TH_YOGG_INFO_YOU	Your deck is made up of random minions that each cast a random spell when played. 
TB_100TH_YOGG_INFO_OPP	Your opponent's deck is made up of random minions that each cast a random spell when played. 
TB_100TH_PARTYPORTAL_INFO_YOU	This player's deck is made up of random portal cards. 
TB_100TH_PARTYPORTAL_INFO_OPP	This player's deck is made up of random portal cards. 
TB_100TH_CLONEBALL_INFO_YOU	Your deck is made up of multiple copies of a few random legendaries. 
TB_100TH_CLONEBALL_INFO_OPP	Your opponent's deck is made up of multiple copies of a few random legendaries. 
TB_100TH_SPELLBAG_INFO_YOU	Your deck is made up of 30 random spells that each summon a minion when played. 
TB_100TH_SPELLBAG_INFO_OPP	Your opponent's deck is made up of 30 random spells that each summon a minion when played. 
TB_100TH_PORTALS_INFO_YOU	Your deck is made mostly of Unstable Portals, as well as a few extra cards. 
TB_100TH_PORTALS_INFO_OPP	Your opponent's deck is made mostly of Unstable Portals, as well as a few extra cards. 
TB_100TH_SHIFTER_INFO_YOU	Your deck is made mostly of Shifter Zerus, as well as a few extra cards. 
TB_100TH_SHIFTER_INFO_OPP	Your opponent's deck is made mostly of Shifter Zerus, as well as a few extra cards. 

LOEA16_2_STAFF_TEXT_CHARGE_0	<b>Passive Hero Power</b>\nYour hero is <b>Immune</b>. Three turns to go.	
LOEA16_2_STAFF_TEXT_CHARGE_1	<b>Passive Hero Power</b>\nYour hero is <b>Immune</b>. Two turns to go.	
LOEA16_2_STAFF_TEXT_CHARGE_2	<b>Passive Hero Power</b>\nYour hero is <b>Immune</b>. One turn left!	
LOEA16_2_STAFF_TEXT_CHARGE_EXPLODED	<b>Passive Hero Power</b>\nSummoned a boss but lost <b>Immunity</b>.

TB_FIREFEST_FIRST	Mini-Rag gains attack when he incinerates a minion!
TB_FIREFEST_SECOND	Well done! Incinerate as many as you can for a special reward!

TB_LETHAL_NAME	One Turn to Burn
ICC_05_LANATHEL_01	You <b>must</b> bite a minion! Even if it's not yours!	
ICC_01_TIRIONTURNS_01	Turns until Tirion arrives: 1
ICC_01_TIRIONTURNS_02	Turns until Tirion arrives: 2
ICC_01_TIRIONTURNS_03	Turns until Tirion arrives: 3
ICC_01_LICH_KING_SUBTEXT	Legendary
ICC_01_TIRION_SUBTEXT	Not so Legendary

FB_LK_INTRO_01	This Brawl is best played by two players seated\n side-by-side!
FB_LK_INTRO_02	Player 1 goes first,\n work together to defeat\n The Lich King!
FB_LK_HEROSWITCH	Player 2's Turn! Keep it up!
FB_LK_BOSSSWITCH	Defeat The Lich King's Lieutenant and force him to return!
FB_LK_DEAD_01	Congratulation Champions!\nThe Lich King has been defeated!
FB_LK_DEAD_02	Contact your Fireside Innkeeper to challenge him again!

ICCWarriorVictory_01	The one-time Warchief of the Horde embraced his newfound power. The frozen victims of his army would rise up to serve, until he was master of all he surveyed.
ICCShamanVictory_01	The shaman’s mind was overwhelmed with voices, a cacophony of the dead. The Deathseer closed his eyes and uttered a single word: “Sleep…”
ICCRogueVictory_01	Valeera the Hollow disappeared into the night. Her shades and shadows see all, and none are safe from her icy blade…
ICCPaladinVictory_01	The once-noble Paladin embraced his new destiny. Those who lived a worthy life would have nothing to fear. But in death, the wicked would face his judgement... 
ICCHunterVictory_01	Rexxar released the souls once trapped by the Lich King. He drew a black arrow from his quiver. “Come Misha!” he said. “The hunt begins…”
ICCDruidVictory_01	Once, he nurtured life by tending the wilds of Azeroth. Now Malfurion the Pestilent ensures the balance of nature by tending a garden of death.
ICCMageVictory_01	The newly-crowned frost lich surveyed her domain. Legions of undead added their power to her own. She didn’t even notice her blood freezing.
ICCPriestVictory_01	The young Prince’s body dissolved into shadow. “I see it all now,” he said, his eyes burning with blue flame. “I have been so naive…”
ICCWarlockVictory_01	At last Gul’dan sat upon the Frozen Throne. The Dark Portal yawned open once more, and worlds uncounted trembled before him.
FB_LK_HERO_01	Supreme Lich King
FB_LK_HERO_02	Blood-Queen Lana'thel
FB_LK_HERO_03	Professor Putricide
FB_LK_HERO_04	Lord Marrowgar
FB_LK_HERO_05	Sindragosa
FB_JUGGERNAUT_UNKNOWN	Unknown
FB_JUGGERNAUT_DRUID	Druid
FB_JUGGERNAUT_HUNTER	Hunter
FB_JUGGERNAUT_MAGE	Mage
FB_JUGGERNAUT_PALADIN	Paladin
FB_JUGGERNAUT_PRIEST	Priest
FB_JUGGERNAUT_ROGUE	Rogue
FB_JUGGERNAUT_SHAMAN	Shaman
FB_JUGGERNAUT_WARLOCK	Warlock
FB_JUGGERNAUT_WARRIOR	Warrior
FB_JUGGERNAUT_CHOOSE_OPPONENT	Choose your rival Captain...
FB_JUGGERNAUT_FIRSTLINE	Fire away!
FB_IKC_SETUP	Innkeeper! A question...
FB_IKC_NEWCARD	Keep the old card, or use the new?
FB_IKC_ENDGAME	The new card's chosen! Let's end the game.
FB_IKC_CHOSE_SETUP	Play a new card, and it will become the Innkeeper's Choice.

TB_HEADLESS_HORSEMAN_POISON	You can't poison this undead, he's too powerful!

TB_HEADLESSREDUX_01	You're the Headless Horseman, protect your Graveyard!
TB_HEADLESSREDUX_02	Destroy the costumed adventurers Hazel, Johnny and Flynn to win!
TB_HEADLESSREDUX_03	You've wandered into the Headless Horseman's Graveyard! 
TB_HEADLESSREDUX_04	Protect the costumed adventurers Hazel, Johnny and Flynn or you'll lose!

FB_ELO_FAVORED	You're Favored to win, your opponent will receive a greater bonus.
FB_ELO_UNDERDOG	You're the Underdog, you'll get to choose a greater bonus!
FB_ELO_EVEN	You're evenly matched with your opponent! You'll both get to choose a greater bonus!

TB_MARIN_QUEST	Whoever completes their quest first will get a head start on getting the treasure!
TB_KOBOLDGIFTS_01	"Look in the sky! It's Greatfather Kobold!"
TB_KOBOLDGIFTS_02	"Greatfather Kobold will return next turn! Make some room!"

FB_CHAMPS_PAVEL_DRUID	Pavel beat DrHippi in a mirror match with this deck. Watch out for big minions!
FB_CHAMPS_PAVEL_MAGE	Pavel's Mage had multiple close calls in the 2016 Championship with this deck. How about you?
FB_CHAMPS_PAVEL_SHAMAN	Pavel's Shaman was always banned by his opponents. But it's not banned here!
FB_CHAMPS_PAVEL_ROGUE	Pavel's Rogue can struggle against aggressive decks, but it still packs a big punch!
FB_CHAMPS_PAVEL_WARRIOR	Pavel played this C'thun Warrior twice in the Finals, losing to DrHippi's Warrior but winning against his Druid.
FB_CHAMPS_OSTKAKA_ROGUE	In the last match of the 2015 Finals, Ostkaka beat Hotform's Druid and was welcomed into the Hall of Champions!
FB_CHAMPS_OSTKAKA_WARRIOR	Grim Patrons helped Ostkaka win... even without Warsong Commander. That's playing with style!
FB_CHAMPS_OSTKAKA_MAGE	Ostkaka played this Freeze Mage against Hotform's Tempo Mage, burning it down with fireballs. Irony!
FB_CHAMPS_FIREBAT_ROGUE	Firebat soundly beat DTwo's Priest in 2014, achieving lethal with a miracle 12/4 Auctioneer!
FB_CHAMPS_FIREBAT_HUNTER	Firebat chose this Hunter to counter DTwo's Warlock, as payback for losing his Rogue deck...
FB_CHAMPS_FIREBAT_DRUID	Firebat started the Finals with his Druid... and never lost! He's the 2014 Champion!
FB_CHAMPS_FIREBAT_WARLOCK	Firebat's Warlock was banned in the finals by Tiddler Celestial. How will it do now?

FB_BUILDABRAWL_INTRO	The Current Brawl is:
FB_BUILDABRAWL_001	By The Power of the Summoner's Competition!
FB_BUILDABRAWL_002	By The Mask of Ragnaros!
FB_BUILDABRAWL_003	By The Power of Yogg-Saron!
FB_BUILDABRAWL_004	By The Power of Minions!
FB_BUILDABRAWL_005	Random-ummoner's Competitions
FB_BUILDABRAWL_006	The Random-masked Ball
FB_BUILDABRAWL_007	Random-ogg-Saron Tryouts
FB_BUILDABRAWL_008	Randominions
FB_BUILDABRAWL_009	The Battle of The Summoner's Competition 
FB_BUILDABRAWL_010	The Battle of The Masked Ball
FB_BUILDABRAWL_011	The Battle of Yogg-Saron's Tryouts
FB_BUILDABRAWL_012	The Battle of the Clash of the Minions
FB_BUILDABRAWL_013	Blood Summoner's Competition
FB_BUILDABRAWL_014	The Masked Bloody Ball
FB_BUILDABRAWL_015	Yogg-Saron's Blood
FB_BUILDABRAWL_016	Blood of the Minions
FB_BUILDABRAWL_NOTSTARTED	The Fireside Brawl has not been started, contact your Innkeeper to Build-A-Brawl!
