TAG	TEXT	COMMENT
ChromaggusBoss_Death_1	Graooooor !	
ChromaggusBoss_EmoteResponse_1	*Grognement*	
ChromaggusBoss_Start_1	Graor !	
GiantRat_LOOTA_BOSS_18h_DefeatPlayer	<Couine.>	
GiantRat_LOOTA_BOSS_18h_EmoteResponse	<Couine.>	
GILA_BOSS_65h_Gobbles_DefeatPlayer	Reeaaoo !	
GILA_BOSS_65h_Gobbles_EmoteResponse	Bahauaooor !	
GILA_BOSS_65h_Gobbles_Intro	Ouhauoooo !	
LOE_07_MINE_CART_EMOTES	CLANG	
LOOTA_BOSS_21h_GnoshTheGreatWorm_EmoteResponse	<Rugit.>	
LOOTA_BOSS_47h_Lava_FilledRoom_Emote	<Enrage.>	
LOOTA_BOSS_52h_TreasureVault_Emote	<Jackpot !>	
OnyxiaBoss_Death_1	Graooooor !	
OnyxiaBoss_EmoteResponse_1	*Grognement*	
OnyxiaBoss_Start_1	Graor !	
POPUP_FROST_BRAWL	Fatigue_! Celui qui a le plus de points de vie à la fin du prochain tour gagne la partie.	
POPUP_FROST_BRAWL_ARMOR	Dans ce Bras de fer, impossible de se cacher derrière son armure_!	
TheMothergloop_LOOTA_BOSS_24h_EmoteResponse	<Rote.>	
TrappedRoom_LOOTA_BOSS_48h_EmoteResponse	<Grince.>	
VO_Ahune_Male_Elemental_Brawl_01	OUI_! ÉCRASEZ RAGNAROS_!	
VO_Ahune_Male_Elemental_Brawl_02	QUI A LE POUVOIR MAINTENANT, IMBÉCILE DE FEU_?!	
VO_Ahune_Male_Elemental_Brawl_03	VOILÀ MA REVANCHE_!	
VO_Ahune_Male_Elemental_Brawl_04	QUI EST LE PLUS SUSCEPTIBLE D’ÊTRE TUÉ PAR UN AVENTURIER, MAINTENANT_?	
VO_Ahune_Male_Elemental_Brawl_05	C’EST QUI L’INSECTE, MAINTENANT_?!	
VO_Ahune_Male_Elemental_Brawl_07	LA PIERRE DE GLACE A FONDU_!	
VO_Ahune_Male_Elemental_Brawl_08	QUI DÉTRUIRA LE PLUS D’IMBÉCILES_?	
VO_Ahune_Male_Elemental_Brawl_11	UN EXCELLENT RÉSULTAT_!	
VO_Ahune_Male_Elemental_Brawl_15	VOUS DEVEZ TUER RAGNAROS PLUS MORT QUE MORT_!	
VO_Ahune_Male_Elemental_Brawl_16	OUAH_! VOUS DÉTESTEZ VRAIMENT RAGNAROS_!	
VO_Aran_Male_Shade_AranCrackle_01	Humpff. À mon époque, Crépitement infligeait 6 points de dégâts.	
VO_Aran_Male_Shade_AranDeath_02	Pas encore...	
VO_Aran_Male_Shade_AranEmoteResponse_01	Sortez_! Sortez_!	
VO_Aran_Male_Shade_AranHeroPower_01	Brûlez, voyous_!	
VO_Aran_Male_Shade_AranMedivhSkin_01	Medivh_? Non, non… Je n’étais pas en train d’embêter les invités…	
VO_Aran_Male_Shade_AranOpen_01	Je vais vous apprendre le respect_!	
VO_Aran_Male_Shade_AranSpell_03	Retournez dans les ténèbres glaciales_!	
VO_Aran_Male_Shade_AranSpell_04	Le maître est puissant, mais j’ai des pouvoirs, moi aussi_!	
VO_Aran_Male_Shade_AranTrons_02	NON_! NON_! Quel vacarme infernal_! Assez de ces bonjours_!	
VO_Aran_Male_Shade_AranTurn1_01	Tapage interdit dans ma tour_!	
VO_Aran_Male_Shade_AranTurn5_01	Je ne suis pas un simple bouffon_! Je suis Nielas Aran_!	
VO_Barnes_Male_Human_FinalNazraTurn5_02	À l’aide_! Nous n’avons plus de bananes_! Mukla est en train de détruire le garde-manger_!	
VO_Barnes_Male_Human_JulianneTurn5_01	Pour une fête réussie, il faut une pièce de théâtre_! Et pour une pièce réussie, il faut un public_!	
VO_Barnes_Male_Human_JulianneWin_01	Premier acte terminé_! Encore deux_!	
VO_Barnes_Male_Human_Wing2Intro_02	Bienvenue au théâtre_! Je suis Barnes, le régisseur. Les portails pour sauver Medivh se trouvent plus haut, mais vous devez d’abord assister à notre spectacle_!	
VO_Barnes_Male_Human_WolfBigMinion_01	Oh mère-grand, que vous avez de grands serviteurs_!	
VO_Barnes_Male_Human_WolfClaws_01	Ne vous inquiétez pas_! Ces énormes griffes ne sont que des accessoires_!	
VO_Barnes_Male_Human_WolfTurn5_01	J’adore quand le public participe_! Courez, cher invité, courez_!	
VO_Barnes_Male_Human_WolfTurn9_01	Ha ha_! Quel beau spectacle_! Encore meilleur que celui de l’ogre qu’on a pourchassé la semaine dernière_!	
VO_Barnes_Male_Human_WolfWin_01	Aha_! Le finale nous attend_!	
VO_BigBadWolf_Male_Worgen_WolfBigMinion_01	C’est pour mieux t’écraser_!	
VO_BigBadWolf_Male_Worgen_WolfDeath_01	Chassé_? Non…	
VO_BigBadWolf_Male_Worgen_WolfDireWolfAlpha_01	*Grognement*	
VO_BigBadWolf_Male_Worgen_WolfDireWolfAlpha_02	*Gémissement*	
VO_BigBadWolf_Male_Worgen_WolfEmoteResponse_01	Mmmm…\nDélicieux…	
VO_BigBadWolf_Male_Worgen_WolfOpen_01	Cours, petite fille, cours_!	
VO_BigBadWolf_Male_Worgen_WolfScarletCrusader_01	Oh, petit capuchon rouge, où vas-tu_?	
VO_BigBadWolf_Male_Worgen_WolfTurn1_01	Regardez vos serviteurs. Voyez comme ils se ratatinent devant moi_?	
VO_BlackKing_Male_ChessPiece_ChessEmoteGreetings_01	Toujours.	
VO_BlackKing_Male_ChessPiece_ChessEmoteOops_01	Ou un piège_?	
VO_BlackKing_Male_ChessPiece_ChessEmoteSorry_01	Un sacrifice nécessaire.	
VO_BlackKing_Male_ChessPiece_ChessEmoteThanks	C’était avec plaisir.	
VO_BlackKing_Male_ChessPiece_ChessEmoteThanks_01	C’était avec plaisir.	
VO_BlackKing_Male_ChessPiece_ChessEmoteThreaten_01	En 3 coups pour moi.	
VO_BlackKing_Male_ChessPiece_ChessEmoteWellPlayed_01	Pas encore.	
VO_BlackKing_Male_ChessPiece_ChessEmoteWow_01	Naturellement.	
VO_BlackKing_Male_ChessPiece_ChessOpen_01	On ne passe pas_!	
VO_BOSS_AYA_Female_Pandaren_BC_0_Jade_Golem_02	Plus de golems_? Génial_!	
VO_BOSS_AYA_Female_Pandaren_BC_0_Jade_Golem_03	 Hi hi hi hi_! Soldats, en avant, marche_!	
VO_BOSS_AYA_Female_Pandaren_BC_0_Jade_Golem_04	Un autre_! UN AUTRE_!	
VO_BOSS_AYA_Female_Pandaren_BC_2_1st_Turn_Start_01	Dans vos rêves… Je veux Gadgetzan pour moi toute seule_!	
VO_BOSS_AYA_Female_Pandaren_BC_2_2nd_Turn_Start_01	Gadgetzan appartient au Lotus de jade, et le Lotus de jade est à moi_!	
VO_BOSS_AYA_Female_Pandaren_BC_2_Arms_Dealing1_01	Encore des armes, comme c’est original…	
VO_BOSS_AYA_Female_Pandaren_BC_2_Fill1_01	Oooooh, vous allez adorer ça…	
VO_BOSS_AYA_Female_Pandaren_BC_2_Fill2_01	Nan, je suis bien ici_! Je crois que je vais rester_!	
VO_BOSS_AYA_Female_Pandaren_BC_2_Goons_Win_01	Non non non non_! J’irai nulle part_!	
VO_BOSS_AYA_Female_Pandaren_BC_2_Goons_Winning_02	Et si vous vous TAISIEZ_?	
VO_BOSS_AYA_Female_Pandaren_BC_2_Jade_Win_01	Encore une victoire pour le Lotus de jade_! C’est moi la plus forte_!	
VO_BOSS_AYA_Female_Pandaren_BC_2_Lotus_Winning_01	Hi hi, vous jouez trop bien, continuez comme ça_!	
VO_BOSS_AYA_Female_Pandaren_BC_3_1st_Turn_Start_01	Gadgetzan est TROP GÉNIALE_! Je la veux_!	
VO_BOSS_AYA_Female_Pandaren_BC_3_1st_Turn_Start_02	*Hi hi hi*… Avec plaisir…	
VO_BOSS_AYA_Female_Pandaren_BC_3_2nd_Turn_Start_01	*Soupir* Vous autres de la Kabale, vous êtes vraiment pas drôles…	
VO_BOSS_AYA_Female_Pandaren_BC_3_Fill1_01	Belle journée, pas vrai, Kazzy_?	
VO_BOSS_AYA_Female_Pandaren_BC_3_Fill2_01	Oh là là, détends-toi, Kazzy. Essaie de t’amuser un peu.	
VO_BOSS_AYA_Female_Pandaren_BC_3_Jade_Golem3_01	Hii hii hii_!	
VO_BOSS_AYA_Female_Pandaren_BC_3_Kabal_Winning_01	C’est toi qui me fatigues, Kazzy…	
VO_BOSS_AYA_Female_Pandaren_BC_3_Kabal_Wins_01	JE VAIS ME RÉVEILLER, C’EST PAS POSSIBLE_! NON NON NON_!	
VO_BOSS_AYA_Female_Pandaren_BC_3_Lotus_Winning_01	Oh, mais qu’est-ce qui se passe, Kazzy_? T’as l’air tout bizarre_!	
VO_BOSS_AYA_Female_Pandaren_BC_3_Lotus_Wins_01	C’était trop marrant. Merci d’avoir joué avec moi, Kazzy_!	
VO_BOSS_AYA_Female_Pandaren_BC_3_Potion1_02	Blah blah, potions, blah blah blah, VIENS TE BATTRE_!	
VO_BOSS_AYA_Female_Pandaren_BC_3_Potion3_01	Aaaah_! Dégueu_!	
VO_BOSS_AYA_Female_Pandaren_Concede_01	Ahh, t’es pas drôle…	
VO_BOSS_AYA_Female_Pandaren_Greetings_01	[x]Coucou !	
VO_BOSS_AYA_Female_Pandaren_Oops_01	[x]Oups !	
VO_BOSS_AYA_Female_Pandaren_START_01	Préparez les golems_!	
VO_BOSS_AYA_Female_Pandaren_Thanks_02	[x]Merci !	
VO_BOSS_AYA_Female_Pandaren_Threaten_02	Je pense que vous allez mourir maintenant.	
VO_BOSS_AYA_Female_Pandaren_Well_Played_01	C’était cool_!	
VO_BOSS_AYA_Female_Pandaren_Wow_02	[x]Waouh !	
VO_BOSS_CHO_Male_Ogre_BC_1_1st_Turn_Start_01	C’EST À CAUSE DES DESSOUDEURS_!	
VO_BOSS_CHO_Male_Ogre_BC_1_Fill2_01	CHOPEZ-LE, LES GARS_!	
VO_BOSS_CHO_Male_Ogre_BC_2_Fill1_01	ELLE A DES YEUX DE FOLLE.	
VO_BOSS_CHO_Male_Ogre_Concede_01	LA MIENNE_? NON, LA TIENNE_!	
VO_BOSS_CHO_Male_Ogre_Oops_02	ERREUR.	
VO_BOSS_CHO_Male_Ogre_Thanks_01	MERCI.	
VO_BOSS_HAN_Male_Ogre_BC_0_Arms_Dealing_01	Quelque chose est tombé du camion, hé hé…	
VO_BOSS_HAN_Male_Ogre_BC_0_Arms_Dealing_02	Dessoudeurs, rassemblement_!	
VO_BOSS_HAN_Male_Ogre_BC_0_Arms_Dealing_03	Filez une arme à ce dessoudeur et faites-lui faire un tour du quartier_!	
VO_BOSS_HAN_Male_Ogre_BC_0_Arms_Dealing_04	Les Dessoudeurs se serrent les coudes_!	
VO_BOSS_HAN_Male_Ogre_BC_1_1st_Turn_Start_01	Ces rues sont dangereuses, Kazakus.	
VO_BOSS_HAN_Male_Ogre_BC_1_2nd_Turn_Start_01	Gadgetzan appartient aux Dessoudeurs.	
VO_BOSS_HAN_Male_Ogre_BC_1_2nd_Turn_Start_02	Tout ça, c’est bien beau, mais Gadgetzan appartient aux Dessoudeurs.	
VO_BOSS_HAN_Male_Ogre_BC_1_Fill1_01	Remballez vos potions et barrez-vous_!	
VO_BOSS_HAN_Male_Ogre_BC_1_Fill2_01	Hé Cho, rassemble les Dessoudeurs. Ce troll a besoin d’une bonne leçon.	test
VO_BOSS_HAN_Male_Ogre_BC_1_Goons_Win_01	Désolé, Kazakus. Mais les affaires sont les affaires.	
VO_BOSS_HAN_Male_Ogre_BC_1_Goons_Winning_01	Ohh, on dirait que tu as eu un petit accident, Kazakus…	
VO_BOSS_HAN_Male_Ogre_BC_1_Kabal_Win_02	On en a pas… encore… fini… Kazakus.	
VO_BOSS_HAN_Male_Ogre_BC_1_Kabal_Winning_02	Hé. Pas mal, pour un vieillard.	
VO_BOSS_HAN_Male_Ogre_BC_1_Potion1_01	J’ai toujours détesté les potions…	
VO_BOSS_HAN_Male_Ogre_BC_1_Potion2_01	Oh_! Regarde un peu où tu lances tes machins_!	
VO_BOSS_HAN_Male_Ogre_BC_2_1st_Turn_Start_01	Gadgetzan est à nous_! Tire-toi, petite_!	
VO_BOSS_HAN_Male_Ogre_BC_2_1st_Turn_Start_04	Ouais, eh bien, les Dessoudeurs ont peut-être leur mot à dire sur le sujet…	
VO_BOSS_HAN_Male_Ogre_BC_2_Fill1_01	J’aime pas ce regard, Aya.	
VO_BOSS_HAN_Male_Ogre_BC_2_Goons_Win_01	Va jouer ailleurs, Aya, hé hé, ça vaut mieux pour toi_!	
VO_BOSS_HAN_Male_Ogre_BC_2_Goons_Winning_01	Et dis-moi, si tu lâchais l’affaire_?	
VO_BOSS_HAN_Male_Ogre_BC_2_Jade_Golem2_01	Ces types du Lotus de jade, je peux vraiment plus les encaisser.	
VO_BOSS_HAN_Male_Ogre_BC_2_Lotus_Win_01	Argh. Gadgetzan sera… à nous…	
VO_BOSS_HAN_Male_Ogre_BC_2_Lotus_Winning_01	Argh, dégagez-moi cette gosse d’ici.	
VO_BOSS_HAN_Male_Ogre_Concede_01	Tout ça, c’est ta faute, hein…	
VO_BOSS_HAN_Male_Ogre_Greetings_01	Bienvenue à Gadgetzan.	
VO_BOSS_HAN_Male_Ogre_INTRO_PACK_OPEN_7	Hé hé hé… C’est qui, ce beau gosse_? Hé hé hé.	
VO_BOSS_HAN_Male_Ogre_Oops_01	C’est pas bon.	
VO_BOSS_HAN_Male_Ogre_START_01	Z’êtes sur notre territoire, maintenant_!	
VO_BOSS_HAN_Male_Ogre_Thanks_01	Vous nous avez rendu un grand service.	test
VO_BOSS_HAN_Male_Ogre_Threaten_01	C’est une offre qui se refuse pas…	
VO_BOSS_HAN_Male_Ogre_Well_Played_02	Je dois avouer, je suis impressionné.	
VO_BOSS_HAN_Male_Ogre_WOW_01	Pas mal.	
VO_BOSS_KAZAKUS_Male_Troll_BC_0_Potion_01	Ah. Tellement rafraîchissant.	
VO_BOSS_KAZAKUS_Male_Troll_BC_0_Potion_02	Voila pour vous_!	
VO_BOSS_KAZAKUS_Male_Troll_BC_0_Potion_04	Buvez tout… Mouahahaha_!	
VO_BOSS_KAZAKUS_Male_Troll_BC_0_Potion_05	Alors, ça vous a plu_?	
VO_BOSS_KAZAKUS_Male_Troll_BC_1_1st_Turn_Start_01	Gadgetzan m’appartiendra, Han’Cho_!	
VO_BOSS_KAZAKUS_Male_Troll_BC_1_2nd_Turn_Start_01	La Kabale est partout. Gadgetzan s’incline devant nous.	
VO_BOSS_KAZAKUS_Male_Troll_BC_1_Arms_Dealing1_01	Pff, ces Dessoudeurs, toujours aussi lâches. ARRÊTEZ DE VOUS CACHER DANS LA MAIN_!	
VO_BOSS_KAZAKUS_Male_Troll_BC_1_Fill1_01	La puissance de la Kabale est infinie.	
VO_BOSS_KAZAKUS_Male_Troll_BC_1_Goons_Win_01	Je reviendrai, plus puissant que jamais_!	
VO_BOSS_KAZAKUS_Male_Troll_BC_1_Goons_Winning_01	Vous allez souffrir, Han’Cho…	
VO_BOSS_KAZAKUS_Male_Troll_BC_1_Kabal_Win_01	Et pourtant, ça m’en a tout l’air.	
VO_BOSS_KAZAKUS_Male_Troll_BC_1_Kabal_Winning_01	Votre fin est proche, Han’Cho_!	
VO_BOSS_KAZAKUS_Male_Troll_BC_3_1st_Turn_Start_01	<Rire> Vous devrez me vaincre pour ça.	
VO_BOSS_KAZAKUS_Male_Troll_BC_3_Fill1_01	NE M’APPELEZ PAS COMME ÇA, PETITE EFFRONTÉE_!	
VO_BOSS_KAZAKUS_Male_Troll_BC_3_Fill2_01	Inclinez-vous devant la puissance de la Kabale_!	
VO_BOSS_KAZAKUS_Male_Troll_BC_3_Jade_Golem2_01	Petite arrogante, comment osez-vous vous moquer du plus puissant chef de Gadgetzan_?	
VO_BOSS_KAZAKUS_Male_Troll_BC_3_Jade_Golem3_01	Petite insolente_! J’en ai assez de ces golems.	
VO_BOSS_KAZAKUS_Male_Troll_BC_3_Kabal_Winning_01	Alors, jeune fille, on fatigue_? <Rire>	
VO_BOSS_KAZAKUS_Male_Troll_BC_3_Kabal_Winning_02	Quoi_? Petite insolente_! Je serai votre PERTE_!	test
VO_BOSS_KAZAKUS_Male_Troll_BC_3_Kabal_Wins_01	Ha ha_! Encore un adversaire qui plie devant la puissance de la Kabale_!	
VO_BOSS_KAZAKUS_Male_Troll_BC_3_Lotus_Winning_01	Sale gosse…	
VO_BOSS_KAZAKUS_Male_Troll_BC_3_Lotus_Wins_01	Stupide gamine, ce n’est pas terminééééé_!	
VO_BOSS_KAZAKUS_Male_Troll_BC_3_Potion1_01	Goûtez à la fureur des potions de la Kabale_!	
VO_BOSS_KAZAKUS_Male_Troll_Concede_01	Ces rues… m’appartiennent…	
VO_BOSS_KAZAKUS_Male_Troll_Greetings_02	Salutations, bande d’imbéciles_!	test
VO_BOSS_KAZAKUS_Male_Troll_Mirror_Start_01	Vous avez du potentiel.	
VO_BOSS_KAZAKUS_Male_Troll_Oops_01	Une erreur de calcul…	
VO_BOSS_KAZAKUS_Male_Troll_START_01	Vous entendez l’appel du mana_?	
VO_BOSS_KAZAKUS_Male_Troll_Thanks_01	J’apprécie, péon.	
VO_BOSS_KAZAKUS_Male_Troll_Threaten_01	JE CONTRÔLE GADGETZAN_!	
VO_BOSS_KAZAKUS_Male_Troll_Well_Played_02	Vous avez beaucoup de potentiel…	
VO_BOSS_KAZAKUS_Male_Troll_Wow_01	Quelle puissance_!	
VO_BRANN_MITHRIL_ALT_02	Fascinant. Ces runes de mithril contiennent un code de gardien. Il doit remonter à l’époque des titans !	
VO_BRANN_WIN_07_ALT_07	Semez-les ! Le pommeau est dans la salle suivante !	
VO_BRM_027h_Death_63	Non ! NON ! NOOOOOOOOOON !!!	
VO_BRMA01_1_CARD_05	Hé, faisons-leur un « accueil chaleureux » !	
VO_BRMA01_1_DEATH_09	Ouah, ho ho. Quoi ? Ah ? Oh, je n’aime pas ça, mais je n’ai pas vraiment le choix.	
VO_BRMA01_1_ETC_06	C’est l’heure de se faire un petit bœuf ! Un concert d’applaudissements pour Elite Tauren Chieftain !	
VO_BRMA01_1_HERO_POWER_04	Hahaha ! Mêlée générale !	
VO_BRMA01_1_RESPONSE_03	Hahaha… oh, hic ! Oups, excusez-moi !	
VO_BRMA01_1_START_01	Bienvenue au Sinistre écluseur.	
VO_BRMA01_1_SUCCUBUS_08	Nagmara ! Je crois que notre « ami » voudrait un coup… à boire !	
VO_BRMA01_1_TURN1_02	Hé, les gars !  Ha ha, regardez… nous avons un invité.	
VO_BRMA01_1_WARGOLEM_07	Oh ho ho ! Vous allez avoir des ennuis ! Phalange ! Attrape-les !	
VO_BRMA02_1_ALAKIR_34	Voici le seigneur élémentaire qui adore chasser les insectes, Al’akir !	
VO_BRMA02_1_ALEXSTRAZA_32	Lieuse-de-vie, reine-dragon, combattante dans l’arène sombrefer… voici Alexstrasza !	
VO_BRMA02_1_BEAST_22	Sa nourriture préférée est le gnome, mais il est prêt à faire une exception, voici la Bête !	
VO_BRMA02_1_BOOM_28	J’espère qu’il n’y a personne dans la zone d’effet car votre prochain adversaire est le Dr Boum !	
VO_BRMA02_1_CAIRNE_20	Il élève son fils pour qu’il suive sa trace, faites du bruit pour Cairne Sabot-de-Sang !	
VO_BRMA02_1_CHO_07	Préparez-vous pour une jolie histoire du plus doux des pandarens : le chroniqueur Cho !	
VO_BRMA02_1_DEATH_38	Ho ! Euh ? Ouah ! *Dernier soupir*	
VO_BRMA02_1_DEATHWING_35	OOOOOoh ! Mes bien chers naines et nains ! Voici le seul, l’unique… AILE DE MORT !	
VO_BRMA02_1_ETC_18	Et maintenant, le tauren, le mythe, la légende, Elite Tauren Chieftain !	
VO_BRMA02_1_FEUGEN_15	Faites une ovation à Feugen !	
VO_BRMA02_1_FOEREAPER_29	Sa mécanique a été améliorée pour une destruction maximum : c’est le Faucheur 4000 !	
VO_BRMA02_1_GEDDON_13	Oh, ça va chauffer dans l’Arène ! Veuillez accueillir le baron Geddon !	
VO_BRMA02_1_GELBIN_21	Tout droit venu de la Nouvelle Brikabrok, accueillons le dirigeant des gnomes, Gelbin Mekkanivelle !	
VO_BRMA02_1_GRUUL_31	On ne le surnomme pas le Tue-Dragon pour rien ! Applaudissez bien fort GRUUL !	
VO_BRMA02_1_HERO_POWER_05	Les spectateurs commencent à s’impatienter ! Haha !	
VO_BRMA02_1_HOGGER_27	Et maintenant, un gnoll niveau 11 devenu une légende en son temps : Lardeur !	
VO_BRMA02_1_ILLIDAN_23	À quoi bon avoir des yeux quand on a deux glaives de guerre ! Accueillez ILLIDAN HURLORAGE !	
VO_BRMA02_1_LEVIATHAN_12	Récemment rénové et prêt à faire de votre vie un enfer, le léviathan des flammes !	
VO_BRMA02_1_LOATHEB_16	Bouchez-vous le nez et couvrez-vous la bouche pour accueillir la pourriture incarnée, Horreb !	
VO_BRMA02_1_MAEXXNA_24	Voilà l’araignée géante ! Son nom ? MAEXXNA !	
VO_BRMA02_1_MILLHOUSE_09	Oh, c’est pas vrai. Qui l’a laissé entrer dans l’arène ?	
VO_BRMA02_1_MOGOR_25	Son vocabulaire est limité, mais pas sa rage. Voici Mogor l’ogre !	
VO_BRMA02_1_MUKLA_10	Votre prochain adversaire, le maître des bananes en personne, le roi Mukla !	
VO_BRMA02_1_NOZDORMU_36	Mesdames et… Oh là là ! On a plus le temps !	
VO_BRMA02_1_ONYXIA_33	Elle arrive tout droit du marécage d’Âprefange et du donjon de Hurlevent : tenez-vous prêts pour Onyxia !	
VO_BRMA02_1_PAGLE_08	De retour de sa dernière partie de pêche, le maître pêcheur Nat Pagle !	
VO_BRMA02_1_RESPONSE_04	Personne ne peut survivre à de telles légendes !	
VO_BRMA02_1_SNEED_30	Votre prochain adversaire se cache derrière les commandes d’un vieux déchiqueteur ! De qui s’agit-il ???	
VO_BRMA02_1_STALAGG_14	Stalagg survivra-t-il à l’Arène ? Nous allons vite le savoir !	
VO_BRMA02_1_START_01	Un nouvel adversaire !	
VO_BRMA02_1_SYLVANAS_19	Elle brûle d’une haine éternelle rien que pour vous, souhaitons la bienvenue à Sylvanas Coursevent !	
VO_BRMA02_1_THALNOS_06	Faites du bruit pour le squelette en jupette : le mage de sang Thalnos !	
VO_BRMA02_1_THAURISSAN_37	Venu directement de la mission suivante, c’est l’empereur Thaurissan !	
VO_BRMA02_1_TINKMASTER_11	Un tonnerre d’applaudissements pour le grand inventeur, le maître-bricoleur Suprétincelle !	
VO_BRMA02_1_TOSHLEY_26	Voici un gnome bien loin de chez lui, faites un accueil chaleureux à Toshley !	
VO_BRMA02_1_TURN1_02	Mes très chers nains et naines ! Nous avons un sacré spectacle pour vous aujourd’hui !	
VO_BRMA02_1_TURN1_PT2_03	Les plus grandes légendes d’Azeroth contre un aventurier solitaire !	
VO_BRMA02_1_VOLJIN_17	Silence dans la salle ! Nous avons un invité spécial, le chef de guerre Vol’jin en personne !	
VO_BRMA03_1_CARD_04	Par le pouvoir de Ragnaros, je détiens la force toute-puissante !	
VO_BRMA03_1_DEATH_09	Aaaaaaaaaah !	
VO_BRMA03_1_HERO_POWER_06	MOUREZ !!!	
VO_BRMA03_1_MOIRA_DEATH_05	NON !!! MOIRA !!! VOUS ALLEZ LE PAYER !!!	
VO_BRMA03_1_RESPONSE_03	Fermez votre clapet, avant que je m’en charge !	
VO_BRMA03_1_START_01	Les nains Sombrefer ne tomberont jamais !	
VO_BRMA03_1_TURN1_02	Hé ! Laissez ma femme tranquille !	
VO_BRMA03_1_VS_RAG_07	Non ! Ragnaros ??? PAS ENCORE !!!	
VO_BRMA04_1_CARD_04	Liges du feu, éclatez-vous !	
VO_BRMA04_1_DEATH_06	Rrrrrrrrrrrrh !	
VO_BRMA04_1_HERO_POWER_05	Magma !	
VO_BRMA04_1_RESPONSE_03	J’ai un cœur de pierre.	
VO_BRMA04_1_START_01	Je serai votre pierre tombale.	
VO_BRMA04_1_TURN1_02	Garr à vous.	
VO_BRMA05_1_CARD_05	Tic tac, mortel !	
VO_BRMA05_1_DEATH_04	Un dernier service…	
VO_BRMA05_1_HERO_POWER_06	Brûlez !	
VO_BRMA05_1_RESPONSE_03	Armageddon !	
VO_BRMA05_1_START_01	Vous allez brûler !	
VO_BRMA05_1_TURN1_02	Ragnaros vous consumera !	
VO_BRMA06_1_DEATH_04	Je me rends ! Je me rends !	
VO_BRMA06_1_RESPONSE_03	Vous croyez avoir déjà gagné ? Vous avez sans doute besoin que je vous inflige quelques douleurs supplémentaires !	
VO_BRMA06_1_START_01	Nul ne défie la Flamme vivante !	
VO_BRMA06_1_SUMMON_RAG_05	Contemplez Ragnaros ! Celui qui était ancien quand ce monde était jeune !	
VO_BRMA06_1_TURN1_02_ALT	Traquez-les !	
VO_BRMA06_3_INTRO_01	TROP TÔT ! TU M’AS ÉVEILLÉ TROP TÔT, EXECUTUS !	
VO_BRMA06_3_RESPONSE_03	QUE SIGNIFIE CETTE INTRUSION ???	
VO_BRMA06_3_TURN1_02	INSECTES MORTELS ! VOUS OSEZ PÉNÉTRER DANS *MON* DOMAINE ?	
VO_BRMA07_1_CARD_04	Détruire maintenant !	
VO_BRMA07_1_DEATH_06	Rrrnoooooo !	
VO_BRMA07_1_HERO_POWER_05	Moi détruire ! Vous mourir !	
VO_BRMA07_1_RESPONSE_03	Raaar !!! Moi détruire !	
VO_BRMA07_1_START_01	Moi écraser vous !	
VO_BRMA07_1_TURN1_02	Écraser, ou détruire ? QUOI MOI FAIRE !	
VO_BRMA08_1_CARD_05	Je protégerai le pic !	
VO_BRMA08_1_DEATH_06	Rrh. Aah ! Noooooon !	
VO_BRMA08_1_RESPONSE_04	Pourquoi ? POURQUOI ??? Et moi qui vous aimais bien !	
VO_BRMA08_1_START_01	Vous ! Qu’est-ce que vous faites ici ???	
VO_BRMA08_1_TURN1_03	Seigneur Nefarian ! Ce n’est pas la personne qui s’est débarrassée de Ragnaros pour nous ?	
VO_BRMA08_1_TURN1_ALT_02	Êtes-vous venu m’aider à détruire les mortels de ce monde ?	
VO_BRMA09_1_CARD_05	Le pic est à NOUS !	
VO_BRMA09_1_DEATH_11	Gaaahhhhh !	
VO_BRMA09_1_HERO_POWER1_06	Ouvrez les portes !	
VO_BRMA09_1_HERO_POWER2_07	Tuez celui qui se planque derrière !	
VO_BRMA09_1_HERO_POWER3_08	Concentrez-vous sur le héros, idiots !	
VO_BRMA09_1_HERO_POWER4_09	Ensemble, rien ne peut nous arrêter !	
VO_BRMA09_1_RESPONSE_04	Hahahahaha.	
VO_BRMA09_1_START_01	Nous sommes la véritable Horde !	
VO_BRMA09_1_TURN1_03	Vous vous trompez de montagne !	
VO_BRMA09_1_TURN1_ALT_02	Personne ne peut se mettre en travers de notre route ! MOUREZ !!!	
VO_BRMA10_1_DEATH_08	Rrrrrrrrrrrh !	
VO_BRMA10_1_EGG_DEATH_1_05	Imbéciles ! Ces œufs sont plus précieux que vous le croyez !	
VO_BRMA10_1_EGG_DEATH_2_06	Non, pas un autre ! Vous allez payer ces atrocités de votre tête !	
VO_BRMA10_1_EGG_DEATH_3_07	Vous allez le payer !	
VO_BRMA10_1_HERO_POWER_04	Éloignez-vous de ces œufs !	
VO_BRMA10_1_RESPONSE_03	On va finir brouillés !	
VO_BRMA10_1_START_01	Contemplez les œufs corrompus de notre nouveau vol draconique !	
VO_BRMA10_1_TURN1_02	Ces œufs causeront votre perte !	
VO_BRMA11_1_ALEXSTRAZA_07	Aidez-moi, Lieuse-de-vie !!! À l’aide !	
VO_BRMA11_1_CARD_04	La fureur de Rochenoire coule dans mes veines !	
VO_BRMA11_1_DEATH_ALT_08	C’est la fin de mon agonie…	
VO_BRMA11_1_HERO_POWER_05	AAAAH ! DESTRUCTION !!!	
VO_BRMA11_1_KILL_PLAYER_06	Pardonnez-moi mon ami, j’ai échoué.	
VO_BRMA11_1_RESPONSE_03	Vous auriez dû fuir tant qu’il en était encore temps, mortel !	
VO_BRMA11_1_START_01	Partez, avant que je perde tout contrôle !	
VO_BRMA11_1_TURN1_02	Trop tard… La corruption de Nefarian s’est emparée de moi !	
VO_BRMA13_1_DEATH_ALT_23	Noon ! NOOON ! JE REVIENDRAI !	
VO_BRMA13_1_DEATHWING_19	Papa ???	
VO_BRMA13_1_HP_DRUID_14	Druide, la Nature est sous mon contrôle !	
VO_BRMA13_1_HP_GENERIC_18	Votre magie m’appartient !	
VO_BRMA13_1_HP_HUNTER_12	Le chasseur devient la proie !	
VO_BRMA13_1_HP_MAGE_11	Mage, vous devriez faire plus attention quand vous utilisez la magie.	
VO_BRMA13_1_HP_PALADIN_07	Paladin, la Lumière vous a-t-elle abandonné ?	
VO_BRMA13_1_HP_PRIEST_08	Prêtre, la Lumière me sert, désormais !	
VO_BRMA13_1_HP_ROGUE_15	Voleur ! Arrêtez de vous cacher et affrontez-moi !	
VO_BRMA13_1_HP_SHAMAN_13	Chaman, les éléments m’obéissent maintenant.	
VO_BRMA13_1_HP_WARLOCK_10	Démoniste, vous jouez avec des forces au-delà de votre compréhension !	
VO_BRMA13_1_HP_WARRIOR_09	Guerrier, votre force est votre faiblesse !	
VO_BRMA13_1_RESPONSE_05	Je suis le maître ici !	
VO_BRMA13_1_START_01	Bienvenue dans mon sanctum personnel, héros !	
VO_BRMA13_1_TURN1_PT1_02	Contemplez la véritable puissance de NEFARIAN !	
VO_BRMA13_1_TURN1_PT2_03	Mana infini ! Écailles de dragon cuirassées !	
VO_BRMA14_1_CARD_09	Dérive de l’excès d’énergie.	
VO_BRMA14_1_DEATH_08	Oblitération des systèmes de défense. Extinction…	
VO_BRMA14_1_HP1_03	Unité Électron activée.	
VO_BRMA14_1_HP2_04	Unité Toxitron activée.	
VO_BRMA14_1_HP3_05	Unité Arcanotron activée.	
VO_BRMA14_1_HP4_06	Unité Magmatron activée.	
VO_BRMA14_1_HP5_07	Unité de défense en ligne.	
VO_BRMA14_1_RESPONSE1_10	Bip boup bip.	
VO_BRMA14_1_RESPONSE2_11	Tentative de connexion…	
VO_BRMA14_1_RESPONSE3_12	Connexion réussie. Téléchargement des mises à jour système.	
VO_BRMA14_1_RESPONSE4_13	Mise à jour installée. BONJOUR BONJOUR BONJOUR.	
VO_BRMA14_1_RESPONSE5_14	BONJOUR BONJOUR BONJOUR !	
VO_BRMA14_1_START_01	Intrus détectés.	
VO_BRMA14_1_TURN1_02	Initialisation de la matrice de défense primaire.	
VO_BRMA15_1_CARD_05	Mes échecs seront votre perte !	
VO_BRMA15_1_DEATH_04	Aaaaaaaahhhhh !	
VO_BRMA15_1_HERO_POWER_06	Mélanger, touiller, faire chauffer !	
VO_BRMA15_1_RESPONSE_03	Rien ne se perd…	
VO_BRMA15_1_START_01	Aucune interruption !	
VO_BRMA15_1_TURN1_02	Il ne faut pas faire attendre le maître ! Ne pas échouer encore !	
VO_BRMA16_1_CARD_04	Vous ne pouvez pas m’échapper !	
VO_BRMA16_1_DEATH_06	Rrrraaaaaaaah !	
VO_BRMA16_1_GONG1_10	AHH ! CE BRUIT !!!	
VO_BRMA16_1_GONG2_11	NON ! C’EST TROP PRÈS !!!	
VO_BRMA16_1_GONG3_12	MES OREILLES !!!	
VO_BRMA16_1_HERO_POWER_05	Le bruit de vos pas et votre mauvaise odeur vous trahissent !	
VO_BRMA16_1_RESPONSE_03	Oui, parlez encore, je me rapproche !	
VO_BRMA16_1_START_01	J’entends votre cœur battre !	
VO_BRMA16_1_TRIGGER1_07	Ah ! Je vous entends…	
VO_BRMA16_1_TRIGGER2_08	J’entends des pas.	
VO_BRMA16_1_TRIGGER3_09	J’entends votre cœur battre… Vous ne pouvez pas m’échapper !	
VO_BRMA16_1_TURN1_02	La mort attend dans l’ombre !	
VO_BRMA17_1_CARD_86	J’espère que vous savez nager… dans la lave en fusion !	
VO_BRMA17_1_DEATH_97	Aaaaaaaaaaah !	
VO_BRMA17_1_DEATH_HEROIC_98	NOOOOOOOOOON !	
VO_BRMA17_1_DEATHWING_88	PAPA ???	
VO_BRMA17_1_HERO_POWER_87	Mon ombreflamme anime leurs os !	
VO_BRMA17_1_NEF_AIR1_89	Regardez-moi, je crache du feu depuis les cieux ! 1 point de dégâts, et ce n’est que le début !	
VO_BRMA17_1_NEF_AIR2_90	Deux boules de feu ! Je les crache sur vous depuis tout là-haut !	
VO_BRMA17_1_NEF_AIR3_91	Cette fois, je n’en ai craché qu’une, parce que je me prépare pour un tour GLORIEUX.	
VO_BRMA17_1_NEF_AIR4_92	OH HO ! TROIS BOULES DE FEU ! PRENEZ ÇA ! D’EN HAUT !	
VO_BRMA17_1_NEF_AIR5_93	À partir de maintenant, je ne vais cracher qu’une boule de feu !	
VO_BRMA17_1_NEF_AIR6_94	JE BLAGUAIS !!! *QUATRE* BOULES DE FEU ! HAHAHAHA !	
VO_BRMA17_1_NEF_AIR7_95	Je ne vais lancer aucune boule de feu cette fois. Mais préparez-vous…	
VO_BRMA17_1_NEF_AIR8_96	VINGT BOULES DE FEU ! BAHAHAHAHA !	
VO_BRMA17_1_RESPONSE_85	Les esprits mortels… si facilement manipulables.	
VO_BRMA17_1_RESURRECT1_82	Je vais faire pleuvoir la destruction sur vous depuis les cieux !	
VO_BRMA17_1_RESURRECT2_83	Tant que j’y suis, j’ai une petite surprise pour vous en bas !	
VO_BRMA17_1_RESURRECT3_84	Contemplez ma toute dernière création ! Lève-toi, ma sœur ! Lève-toi, Onyxia !	
VO_BRMA17_1_START_78	Vous êtes parvenu jusqu’à la glorieuse finale !	
VO_BRMA17_1_TRANSFORM1_80	J’ai essayé d’être un hôte accommodant, mais vous ne voulez VRAIMENT PAS MOURIR !	
VO_BRMA17_1_TRANSFORM2_81	Il est temps d’arrêter de se chercher des excuses et de… VOUS TUER TOUS !	
VO_BRMA17_1_TURN1_79	Ma dernière création vous attend, mortel.	
VO_COOP02_00	Je vais vous libérer de la malédiction de la chair !	
VO_COOP02_02	Battez ensemble le maître des rouages Mécazod pour gagner !	
VO_COOP02_ABILITY_05	Augmentez la vitesse du moteur !	
VO_COOP02_ABILITY_06	Arrêtez les rotatives, chroniqueur Cho !	
VO_COOP03_01	Je suis le maître ici !	
VO_COOP03_02	Non_! NON_! Je vais vous détruire_!	
VO_COOP03_03	Les esprits mortels… si facilement manipulables…	
VO_COOP03_04	J’ai essayé d’être un hôte accommodant, mais vous ne voulez vraiment pas MOURIR_!	
VO_COOP03_05	Il est temps d’arrêter de se chercher des excuses et de… VOUS TUER TOUS_!	
VO_COOP03_06	Prêtre, la Lumière me sert, désormais_!	
VO_COOP03_07	Chaman, les éléments m’obéissent maintenant_!	
VO_COOP03_08	Hahahaaa_! Contemplez la véritable puissance de Nefarian_!	
VO_COOP03_09	Hahaha ! Vous êtes parvenu jusqu’à la glorieuse finale !	
VO_Crone_Female_Troll_CroneDeath_02	Non_! Je vous aurai_! Je vous…	
VO_Crone_Female_Troll_CroneEmoteResponse_02	Ah hahahahaha_!	
VO_Crone_Female_Troll_CroneFlyingMonkeys_01	Amenez-moi cette fille_!	
VO_Crone_Female_Troll_CroneHeroPower_02	Hé hé hé hé_!	
VO_Crone_Female_Troll_CroneOpen_01	Ha hahahaha_! Fuyez, mes mignons_!	
VO_Curator_Male_ArcaneGolem_CuratorArcaneGolem_01	Curieux. Une ressemblance remarquable.	
VO_Curator_Male_ArcaneGolem_CuratorBeasts_01	Le conservateur est allergique aux bêtes.	
VO_Curator_Male_ArcaneGolem_CuratorDemons_01	Les démons n’ont rien à faire dans la Ménagerie.	
VO_Curator_Male_ArcaneGolem_CuratorDragons_01	Fini, les crottes de dragon.	
VO_Curator_Male_ArcaneGolem_CuratorEmoteResponse_01	Impossible de traiter votre requête.	
VO_Curator_Male_ArcaneGolem_CuratorHarrison_02	Voleur détecté_! Harrison Jones est interdit d’accès.	
VO_Curator_Male_ArcaneGolem_CuratorMechs_01	Reprogrammation des assistants.	
VO_Curator_Male_ArcaneGolem_CuratorMedivhSkin_01	Medivh imposteur. Ses yeux de fou le trahissent.	
VO_Curator_Male_ArcaneGolem_CuratorMurlocs_01	Minuscules créatures-poissons libres de partir.	
VO_Curator_Male_ArcaneGolem_CuratorPirates_01	Les pirates devraient faire la fête.	
VO_Curator_Male_ArcaneGolem_CuratorReno_02	Voleur détecté_! Reno Jackson est interdit d’accès.	
VO_Curator_Male_ArcaneGolem_CuratorTurn1_01	Le conservateur est équipé pour la gestion de la Ménagerie.	
VO_Curator_Male_ArcaneGolem_CuratorTurn5_01	Veuillez respecter les procédures en vigueur dans la galerie.	
VO_Curator_Male_ArcaneGolem_CuratorTurn9_01	Les invités doivent rester à l’intérieur de la Ménagerie.	
VO_Curator_Male_ArcaneGolem_IllhoofKilrekResponse_01	Cela importe peu au conservateur. Les invocations sont interdites.	
VO_Curator_Male_ArcaneGolem_IllhoofSenseDemons_01	Nombreux démons détectés.	
VO_Curator_Male_ArcaneGolem_IllhoofTurn1_01	Les rituels d’invocation ne sont pas autorisés.	
VO_Curator_Male_ArcaneGolem_IllhoofTurn5_01	Les rituels blessent les habitants. Le démon ne doit pas continuer.	
VO_Curator_Male_ArcaneGolem_IllhoofWin_01	Le conservateur vous remercie. La Ménagerie sera restaurée.	
VO_Curator_Male_ArcaneGolem_NightbaneCorruption_01	Non_! La Ménagerie ne doit pas être corrompue_!	
VO_Curator_Male_ArcaneGolem_NightbaneTour_01	Le dragon Plaie-de-nuit. Autrefois appelé Arcanagos, son esprit a été corrompu par un déchaînement de magie.	
VO_Curator_Male_ArcaneGolem_NightbaneTour_02	Sur votre gauche, un buste d’Aran. À votre droite, la Lanterne de puissance.	
VO_Curator_Male_ArcaneGolem_NightbaneTurn1_01	Les œuvres qui se sont échappées peuvent se blesser. Elles doivent être reconduites dans la Ménagerie.	
VO_Curator_Male_ArcaneGolem_NightbaneTurn3_01	Les créatures doivent être sauvées. Ensuite, vous pourrez y aller.	
VO_Curator_Male_ArcaneGolem_NightbaneUnstablePortal_01	L’invité doit être plus doux. Ce dragon craint la magie instable.	
VO_Curator_Male_ArcaneGolem_NightbaneWin_01	Une aide supplémentaire est nécessaire.	
VO_Curator_Neither_ArcaneGolem_CuratorDeath_04	Ex-tinc-tiooooon…	
VO_Curator_Neither_ArcaneGolem_CuratorOpen_01	Ne touchez pas les vitrines.	
VO_ELISE_LOE16_ALT_1_FIRST_HALF_02	Rafaam est invulnérable tant que le bâton se charge.	
VO_ELISE_LOE16_ALT_1_SECOND_HALF_03	Une fois chargé, nous pourrons l’attaquer, mais il faudra s’occuper des créatures qu’il invoquera !	
VO_ELISE_WEIRD_DECK_05	Désolée pour ce deck. Nous l’avons créé l’année dernière pour un tournoi et il n’a pas changé depuis.	
VO_EMOTE_HERO_TBKTRAF_KT_DRAWING_BOARD	Il va falloir que je reprenne tout depuis le début…	
VO_EMOTE_HERO_TBKTRAF_KT_GLOAT	Faites vos prières.	
VO_EMOTE_HERO_TBKTRAF_KT_MINIONS_SERVANTS	Serviteurs, valets et soldats des ténèbres glaciales !	
VO_FP1_014t_EnterPlay_01	Maintenant, tu connais la souffrance !	
VO_FP1_031_Attack_07	Comme des moutons à l’abattoir…	
VO_FP1_031_EnterPlay_06	Le Fléau va vous consumer !	
VO_GIL_504_Female_Orc_TUT_LootSelect2_01	Qui ose s’en prendre à mes petits monstres_?	
VO_GIL_504_Female_Orc_TUT_Victory_Generic_01	Une victoire insignifiante. Je ne fais qu’un avec ces bois, vous ne m’arrêterez pas si facilement.	
VO_GIL_504_Female_Orc_TUT_Victory1_01	Le bois Maudit n’est pas si facile à maîtriser. Les autres réussiront-ils aussi bien que vous_?	
VO_GIL_504_Female_Orc_TUT_Victory2_01	Deux héros ont maîtrisé le bois Maudit, mais vous ne m’avez pas encore trouvée, MOI.	
VO_GIL_504_Female_Orc_TUT_Victory3_01	En suivant cette voie, vous vous rapprochez de moi. Votre dernier champion triomphera-t-il lui aussi_?	
VO_GIL_504_Female_Orc_TUT_Victory4_01	Nous allons en finir ce soir. Trouvez-moi et découvrez les horreurs au cœur du bois_!	
VO_GIL_504_Female_Orc_UI_Monster_Azlina_02	Oh, pauvre petite Azalina perdue. Elle finira par s’en sortir. D’une façon ou d’une autre.	
VO_GIL_504_Female_Orc_UI_Monster_Baran_01	L’âme de Baran était noble… Hélas, j’avais besoin de ses yeux.	
VO_GIL_504_Female_Orc_UI_Monster_Brushwood_Cent_01	Je n’ai eu aucun mal à détourner la rage de cet ancien druide tout-puissant. 	
VO_GIL_504_Female_Orc_UI_Monster_Chupacabran_01	Le chupacabran. Oh_! Ce fut une bataille de haute lutte pour le faire mien.	
VO_GIL_504_Female_Orc_UI_Monster_Cragtorr_01	Affrontez la colère de cette terre tourmentée_! Malgermé, lève-toi_!	
VO_GIL_504_Female_Orc_UI_Monster_Crowskin_01	Glinda, achève-le. Le culte tout entier est à tes ordres.	
VO_GIL_504_Female_Orc_UI_Monster_DrSezavo_01	Vous êtes la maladie. Et Sezavo le remède.	
VO_GIL_504_Female_Orc_UI_Monster_Experiment3C_01	Hmmm… Ce n’est pas l’un des miens.	
VO_GIL_504_Female_Orc_UI_Monster_Face_Collector_01	Votre visage fera merveille dans sa collection.	
VO_GIL_504_Female_Orc_UI_Monster_Gnarlroot_01	Esprits antiques, entendez mon appel_! Prêtez-moi racines et lianes pour écraser ces mortels.	
VO_GIL_504_Female_Orc_UI_Monster_Griselda_01	Griselda m’a mise en colère et elle en a payé le prix.	
VO_GIL_504_Female_Orc_UI_Monster_Groddo_01	Ce cher Groddo… Quand on m’a laissé pour morte, c’est lui qui a veillé sur moi.	
VO_GIL_504_Female_Orc_UI_Monster_Grubb_01	Même moi, j’ai du mal à contrôler Salcrass.	
VO_GIL_504_Female_Orc_UI_Monster_Grum_01	Sol ancien, fange torturée, lève-toi et rase cette terre désolée_!	
VO_GIL_504_Female_Orc_UI_Monster_Gustave_01	Gustave, mon cher familier_! Laisses-en quelques-uns pour ta maîtresse.	
VO_GIL_504_Female_Orc_UI_Monster_Hannigul_01	Hannigul a autrefois débarrassé la ville de vermines telles que vous.	
VO_GIL_504_Female_Orc_UI_Monster_Havnixx_01	Hav’nixx peut entendre vos pensées. Il se nourrit de vos peurs.	
VO_GIL_504_Female_Orc_UI_Monster_Infinite_Toki_01	Sale fouineuse. C’est la fin pour toi. Mais vous vous connaissez peut-être déjà, toutes les deux_?	
VO_GIL_504_Female_Orc_UI_Monster_Ivan_01	Autrefois, Ivan faisait partie des vôtres. Il est à moi, désormais.	
VO_GIL_504_Female_Orc_UI_Monster_Lord_Godfrey_01	Godfrey_! Nous avions un accord.\nCelui-ci est tout à toi.	
VO_GIL_504_Female_Orc_UI_Monster_Lovers_01	C’est un roman d’amour. Une histoire de fantôme. Et le récit de votre fin.	
VO_GIL_504_Female_Orc_UI_Monster_Mistwraith_01	Au cœur de la nuit, dans l’obscurité du bois, les murmures vous répondent.	
VO_GIL_504_Female_Orc_UI_Monster_Mute_01	Silencieuse. Mortelle.	
VO_GIL_504_Female_Orc_UI_Monster_Niira_01	On ne joue plus cette fois, Niira. Achève-le_!	
VO_GIL_504_Female_Orc_UI_Monster_Raeth_01	Les Réprouvés n’ont pas tous quitté ce bois. Certains me servent encore.	
VO_GIL_504_Female_Orc_UI_Monster_Rancel_01	Les poisons de Rancel m’ont aidée à façonner ce bois corrompu.	
VO_GIL_504_Female_Orc_UI_Monster_Sazzmi_01	Restez pour l’éternité, et écoutez-moi.	
VO_GIL_504_Female_Orc_UI_Monster_Sephira_01	Par leurs ailes et leurs serres, mes sœurs harpies maintiennent la paix dans mon bois.	
VO_GIL_504_Female_Orc_UI_Monster_Shivers_01	Lève-toi, Latremble_! L’heure de ta vengeance est proche. Je t’offre la princesse gilnéenne.	
VO_GIL_504_Female_Orc_UI_Monster_Shudderwock_01	Le Carniflore_! Une créature terrible à affronter… mais une merveille à contempler.	
VO_GIL_504_Female_Orc_UI_Monster_Splintergraft_01	Peur et malheur, hurle mon bois_; branches et rameaux, des ennemis débarrassez-moi…	
VO_GIL_504_Female_Orc_UI_Monster_Sthara_01	Le peuple gilnéen va m’adorer… dès qu’il sera sous l’emprise de S’thara.	
VO_GIL_504_Female_Orc_UI_Monster_Vitus_01	L’un des vôtres, un banni_! C’est dans mes bois qu’il a trouvé un foyer…	
VO_GIL_504_Female_Orc_UI_Monster_Wharrgarbl_01	J’adore les Murlocs. Ils ressemblent à des grenouilles… en plus désarticulé.	
VO_GIL_598_Female_Human_SpecialSylvanas_01	Sale sorcière. Tu as tué mon frère_!	
VO_GIL_692_Male_Worgen_TUT_AdventureSelect_01	Héros_! Qui parmi vous est assez courageux pour s’aventurer dans le bois Maudit_?	
VO_GIL_692_Male_Worgen_TUT_BossReveal1_01	De terribles monstres hantent les bois autour de Gilnéas. Traquez-les,\njusqu’au dernier.	
VO_GIL_692_Male_Worgen_TUT_BossReveal2_01	Plus vous vous enfoncez dans les bois, plus les créatures sont dangereuses.	
VO_GIL_692_Male_Worgen_TUT_BossReveal3_01	«_Hagatha_» est la force maléfique qui anime le bois Maudit. Trouvez-la et arrêtez-la_!	
VO_GIL_692_Male_Worgen_TUT_BossReveal3ALT_01	Ces monstres sont l’œuvre d’Hagatha. Occupez-vous d’eux jusqu’à ce qu’on la retrouve_!	
VO_GIL_692_Male_Worgen_TUT_CharacterSelect_01	J’ai constitué une équipe d’experts, dotés chacun de compétences uniques.	
VO_GIL_692_Male_Worgen_TUT_Defeat1_01	Si vous succombez dans le bois Maudit, vous perdrez le deck que vous avez créé.	
VO_GIL_692_Male_Worgen_TUT_FightBegin1Crowley_01	Crowley_! Manœuvrez votre canon pour optimiser sa puissance de feu.	
VO_GIL_692_Male_Worgen_TUT_FightBegin1Shaw_01	La chasse est ouverte, Shaw. Utilisez vos chiens pour prendre l’avantage sur nos adversaires.	
VO_GIL_692_Male_Worgen_TUT_FightBegin1Tess_01	Tu vas devoir te débrouiller seule. N’hésite pas à fouiller le champ de bataille pour y trouver des sorts.	
VO_GIL_692_Male_Worgen_TUT_FightBegin1Tess_02	Je n’ai plus d’autre enfant que toi, Tess. Sois prudente.	
VO_GIL_692_Male_Worgen_TUT_FightBegin1Toki_01	Toki, votre pouvoir de manipulation du temps vous rend plus chanceuse que la plupart.	
VO_GIL_692_Male_Worgen_TUT_FightBegin2_01	Ces… créatures… n’ont rien de naturel. Quelque chose retourne les bois contre nous_!	
VO_GIL_692_Male_Worgen_TUT_LootSelect1_01	Créez un deck vous permettant de vous aventurer sans danger dans le bois Maudit.	
VO_GIL_692_Male_Worgen_TUT_LootSelect2_02	Vous_! Êtes-vous la créature à l’origine de ces choses_?	
VO_GIL_692_Male_Worgen_TUT_TreasureSelect1_01	Tuez des monstres pour obtenir de puissants butins. Choisissez bien vos récompenses_!	
VO_GIL_692_Male_Worgen_TUT_Victory_Final_01	C’est fini_! Les bois s’apaisent déjà et la lumière revient dans notre ville.	
VO_GILA_400h_Male_Human_EVENT_HAGATHA_ALMOSTDEAD_02	Je ne partirai pas sans me battre.	
VO_GILA_400h_Male_Human_EVENT_HAGATHA_INTRO_01	Mes molosses l’ont repérée_! Hagatha est ici_!	
VO_GILA_400h_Male_Human_EVENT_HAGATHA_LOWHEALTH_01	Elle est blessée. Suivez sa piste, mes petits.	
VO_GILA_400h_Male_Human_EVENT_HAGATHA_TURN4_01	Moi, j’ai des molosses.	
VO_GILA_400h_Male_Human_EVENT_IVAN_INTRO_01	Vous étiez l’un des nôtres, Ivan_!	
VO_GILA_400h_Male_Human_EVENT_NEMESIS_INTRO_01	Je vous tiens enfin, Glinda_!	
VO_GILA_400h_Male_Human_EVENT_NEMESIS_TURN2_01	Pourquoi_? Pourquoi avoir pris le parti d’Hagatha_?	
VO_GILA_500h3_Female_Human_EVENT_HAGATHA_SUB_IN_01	À couvert_! Je vais en finir.	
VO_GILA_500h3_Female_Human_EVENT_HAGATHA_TURN2_01	Gilnéas a affronté pire que vous, Hagatha.	
VO_GILA_500h3_Female_Human_EVENT_HAGATHA_TURN4_01	Quittez ces lieux, sorcière_!	
VO_GILA_500h3_Female_Human_EVENT_HAGATHA_WOUNDED_01	Quittez ces bois et je vous laisserai la vie.	
VO_GILA_500h3_Female_Human_EVENT_IVAN_INTRO_01	Ivan_! Vous venez avec moi.	
VO_GILA_500h3_Female_Human_EVENT_NEMESIS_INTRO_01	Latremble. Je vous croyais mort.	
VO_GILA_500h3_Female_Human_EVENT_NEMESIS_TURN2_01	Je vais finir ce que mon père a commencé.	
VO_GILA_600h_Male_Worgen_EVENT_HAGATHA_SUB_IN_01	Je vous tiens dans ma ligne de mire, Hagatha.	
VO_GILA_600h_Male_Worgen_EVENT_HAGATHA_TURN2_01	Ces terres appartiennent aux Gilnéens.	
VO_GILA_600h_Male_Worgen_EVENT_HAGATHA_TURN4_01	Moi au moins, j’ai des compagnons.	
VO_GILA_600h_Male_Worgen_EVENT_HAGATHA_WOUNDED_01	J’abattrai jusqu’au dernier arbre. Il ne restera de ces bois qu’un cratère fumant.	
VO_GILA_600h_Male_Worgen_EVENT_IVAN_INTRO_01	Je vous ai trouvé, sale traître.	
VO_GILA_600h_Male_Worgen_EVENT_NEMESIS_INTRO_01	Godfrey, espèce de traître_! Vous allez payer.	
VO_GILA_600h_Male_Worgen_EVENT_NEMESIS_TURN02_01	Vous étiez déjà pourri avant de mourir, Godfrey.	
VO_GILA_900h_Female_Gnome_EVENT_HAGATHA_ALMOST_DEAD_01	Le temps guérit toutes les blessures.	
VO_GILA_900h_Female_Gnome_EVENT_HAGATHA_SUB_IN_01	Fais une pause, c’est à moi de jouer.	
VO_GILA_900h_Female_Gnome_EVENT_HAGATHA_TURN2_01	J’ai remué ciel et terre pour vous débusquer.	
VO_GILA_900h_Female_Gnome_EVENT_HAGATHA_WOUNDED_01	Votre heure est proche, sorcière.	
VO_GILA_900h_Female_Gnome_EVENT_IVAN_INTRO_01	Ivan, vous êtes fini. J’ai vu ce qui allait se passer.	
VO_GILA_900h_Female_Gnome_EVENT_NEMESIS_INTRO_B_01	Est-ce que… ça s’est déjà produit avant_?	
VO_GILA_900h_Female_Gnome_EVENT_NEMESIS_TURN2_02	Mais pour qui je me prends_?	
VO_GILA_900h_Female_Gnome_EVENT_NEMESIS_TURN6_01	Tu viens du futur_? Alors laquelle de nous deux va l’emporter_?	
VO_GILA_BOSS_20h_MangyWolf_DefeatPlayer	Grrouh-rouu !	
VO_GILA_BOSS_20h_MangyWolf_Emote	Grrouraaah !	
VO_GILA_BOSS_20h_MangyWolf_Intro	Rohouaou !	
VO_GILA_BOSS_21h_Rottooth_Emote	ROOooah !	
VO_GILA_BOSS_21h_Rottooth_Intro	Nrgruhh… HOOOO !	
VO_GILA_BOSS_21h_Rottooth_PlayerDefeat	Pff pff... RoOOoar !	
VO_GILA_BOSS_22h_Male_Undead_Death_01	<Meurt.>	
VO_GILA_BOSS_22h_Male_Undead_DefeatPlayer_01	Génial_! Je vais enfin pouvoir offrir un fourreau à ma dague.	
VO_GILA_BOSS_22h_Male_Undead_EmoteResponse_01	Continuez à causer, le temps que le reste de l’équipage rapplique.	
VO_GILA_BOSS_22h_Male_Undead_EmoteResponseTess_01	Gardez vos prières pour le cap’taine Latremble, princesse_!	
VO_GILA_BOSS_22h_Male_Undead_EventPlaysCoin_01	J’savais que vous aviez de la monnaie sur vous_!	
VO_GILA_BOSS_22h_Male_Undead_EventPlaysShiv_01	J’aime votre façon de travailler.	
VO_GILA_BOSS_22h_Male_Undead_Intro_01	Le cap’taine veut que j’vous fasse disparaître_!	
VO_GILA_BOSS_22h_Male_Undead_IntroCrowley_01	Z’avez besoin d’un commandant_? Ça paye bien_?	
VO_GILA_BOSS_22h_Male_Undead_IntroTess_01	Le cap’taine a une dent contre vous, princesse.	
VO_GILA_BOSS_23h_Male_Ettin_DefeatPlayer_01	Moi gagner_!\n(<i>Où partis tous mes serviteurs_!</i>)	
VO_GILA_BOSS_23h_Male_Ettin_EmoteResponse_02	Moi pas aimer vous_!\n(<i>Moi aimer vous un peu_!</i>)	
VO_GILA_BOSS_23h_Male_Ettin_HeroPower_01	Vous partir_!	
VO_GILA_BOSS_23h_Male_Ettin_HeroPower_02	Et hop_!	
VO_GILA_BOSS_23h_Male_Ettin_HeroPower_03	[x]Ouah !	
VO_GILA_BOSS_23h_Male_Ettin_HeroPower_04	[x]VOLER !	
VO_GILA_BOSS_23h_Male_Ettin_HeroPower_05	Les attraper_!	
VO_GILA_BOSS_23h_Male_Ettin_Intro_01	Vous avoir l’air facile à lancer\n(<i>Trop facile_!</i>)	
VO_GILA_BOSS_24h_Male_Bogbeast_DefeatPlayer_01	Ils commencent par flotter, puis finissent tout boursouflés… 	
VO_GILA_BOSS_24h_Male_Bogbeast_EmoteResponse_01	Bulles et putréfaction, bulles et putréfaction…	
VO_GILA_BOSS_24h_Male_Bogbeast_EventPlaysSmallMinion_01	Bouahéhéha.	
VO_GILA_BOSS_24h_Male_Bogbeast_EventPlaysSmallMinion_02	Houahahaha.	
VO_GILA_BOSS_24h_Male_Bogbeast_EventPlaysSmallMinion_03	Mouhouhahah.	
VO_GILA_BOSS_24h_Male_Bogbeast_EventPlaysSmallMinion_04	Une erreur.	
VO_GILA_BOSS_24h_Male_Bogbeast_HeroPower_01	Je ne suis jamais seul.	
VO_GILA_BOSS_24h_Male_Bogbeast_HeroPower_02	Le marais regorge de secrets.	
VO_GILA_BOSS_24h_Male_Bogbeast_HeroPower_04	Regardez qui vient.	
VO_GILA_BOSS_24h_Male_Bogbeast_Intro_01	C’est MON marais_! Seuls les morts vivent ici.	
VO_GILA_BOSS_25h_Male_Dwarf_DefeatPlayerALT_01	Hagatha a mis votre tête à prix, vous savez.	
VO_GILA_BOSS_25h_Male_Dwarf_EmoteResponse_01	Continuez à jacasser, moi je pose mes pièges.	
VO_GILA_BOSS_25h_Male_Dwarf_EventPlayCompass_01	Jolie boussole_! Je vais la prendre.	
VO_GILA_BOSS_25h_Male_Dwarf_EventPlaysSecret_01	On peut être deux à ce petit jeu.	
VO_GILA_BOSS_25h_Male_Dwarf_EventPlaysSecret_02	Je l’ai déjà vu, celui-là.	
VO_GILA_BOSS_25h_Male_Dwarf_EventPlaysSecret_03	Vous pensez me piéger, hein_?	
VO_GILA_BOSS_25h_Male_Dwarf_EventPlayToolsOfTheTrade_01	Certaines de ces armes m’appartenaient autrefois.	
VO_GILA_BOSS_25h_Male_Dwarf_EventPlayTrapper_01	Bah_! C’est tout un art_!	
VO_GILA_BOSS_25h_Male_Dwarf_EventTokiAbility_01	J’avais dit «_plus de tours_», Gnome_!	
VO_GILA_BOSS_25h_Male_Dwarf_HeroPower_01	Attention où vous mettez les pieds.	
VO_GILA_BOSS_25h_Male_Dwarf_HeroPower_02	Prudence. Avancez à pas de loup.	
VO_GILA_BOSS_25h_Male_Dwarf_HeroPower_03	J’ai toujours un coup d’avance.	
VO_GILA_BOSS_25h_Male_Dwarf_HeroPower_04	Personne n’est à l’abri.	
VO_GILA_BOSS_25h_Male_Dwarf_Intro_01	Il y a une grosse récompense pour votre tête.	
VO_GILA_BOSS_25h_Male_Dwarf_IntroDarius_01	Vous feriez moins le fier sans votre gros canon, Crowley.	
VO_GILA_BOSS_25h_Male_Dwarf_IntroShaw_01	Je ne suis pas comme vous, Shaw. Les causes perdues ne m’intéressent pas.	
VO_GILA_BOSS_25h_Male_Dwarf_IntroTess_02	Vous êtes sur ma liste, Grisetête. Et votre père après vous_!	
VO_GILA_BOSS_25h_Male_Dwarf_IntroToki_01	N’essayez pas de me jouer un de vos tours, Gnome_!	
VO_GILA_BOSS_26h_Male_Tauren_Death_01	Mes… Gnomes…	
VO_GILA_BOSS_26h_Male_Tauren_DeathToki_01	Quelle ironie_!	
VO_GILA_BOSS_26h_Male_Tauren_DefeatPlayer_01	Je ne crois pas que vous rentrerez dans mon sac.	
VO_GILA_BOSS_26h_Male_Tauren_DefeatPlayerToki_01	Génial, une Gnome rare pour ma collection_!	
VO_GILA_BOSS_26h_Male_Tauren_EmoteResponse_01	Je ne partage pas_!	
VO_GILA_BOSS_26h_Male_Tauren_EmoteResponseToki_01	Hmm… Encore une pipelette…	
VO_GILA_BOSS_26h_Male_Tauren_EventBurgle_01	Vous avez des Gnomes là-dedans_?	
VO_GILA_BOSS_26h_Male_Tauren_EventBurgle_03	C’est un Gnome dans votre poche_?	
VO_GILA_BOSS_26h_Male_Tauren_EventPlayClockworkAssistant_01	C’est une copie de mauvaise qualité.	
VO_GILA_BOSS_26h_Male_Tauren_EventPlayGattlingGunner_01	Où avez-vous trouvé celui-là_?	
VO_GILA_BOSS_26h_Male_Tauren_EventPlaysClockwork_02	C’est un ancien modèle, difficile à trouver de nos jours.	
VO_GILA_BOSS_26h_Male_Tauren_EventPlaysGnome_01	J’en ai un comme ça_! Quelque part…	
VO_GILA_BOSS_26h_Male_Tauren_EventPlaysGnome_02	Celui-ci est vraiment rare_!	
VO_GILA_BOSS_26h_Male_Tauren_EventPlaysGnome_05	Vous avez bon goût.	
VO_GILA_BOSS_26h_Male_Tauren_EventPlaysGnome_06	Je vais l’ajouter à ma collection.	
VO_GILA_BOSS_26h_Male_Tauren_EventPlaysLeper_01	Celui-ci est assez dégoûtant.	
VO_GILA_BOSS_26h_Male_Tauren_EventPlaysMillhouse_02	Il ne se tait jamais_!	
VO_GILA_BOSS_26h_Male_Tauren_EventPlaysThermaplugg_02	Il a une vraie valeur ajoutée.	
VO_GILA_BOSS_26h_Male_Tauren_EventSackOfGnomes_01	J’ai oublié ce que j’ai mis là-dedans.	
VO_GILA_BOSS_26h_Male_Tauren_EventSackOfGnomes_03	J’en ai trop pour les compter_!	
VO_GILA_BOSS_26h_Male_Tauren_EventSackOfGnomes_04	Qu’est-ce qu’on a là_?	
VO_GILA_BOSS_26h_Male_Tauren_EventSackOfGnomes_05	Il ne me reste que ceux-là.	
VO_GILA_BOSS_26h_Male_Tauren_EventSilence_03	Un peu de silence…	
VO_GILA_BOSS_26h_Male_Tauren_Intro_02	Vous venez pour mes Gnomes_?	
VO_GILA_BOSS_26h_Male_Tauren_IntroToki_02	Oh, une nouveauté pour ma collection…	
VO_GILA_BOSS_27h_Male_Construct_Death_02	Nous… lui échappons enfin_!	
VO_GILA_BOSS_27h_Male_Construct_DefeatPlayer_01	Vous n’étiez… pas ma cible_!	
VO_GILA_BOSS_27h_Male_Construct_EmoteResponse_01	Excusez-moi, ça m’arrive parfois.	
VO_GILA_BOSS_27h_Male_Construct_EventPlayDrBoom_02	Dr Boum_? Je ne veux pas retourner au laboratoire_!	
VO_GILA_BOSS_27h_Male_Construct_EventPlaySparePart_01	Il y avait tellement de pièces similaires… dans le laboratoire…	
VO_GILA_BOSS_27h_Male_Construct_EventPlayUnstablePortal_01	Le laboratoire… de Raz-de-Néant…	
VO_GILA_BOSS_27h_Male_Construct_HeroPowerBeast_02	… une bête en moi…	
VO_GILA_BOSS_27h_Male_Construct_HeroPowerDemon_01	… si sombre…	
VO_GILA_BOSS_27h_Male_Construct_HeroPowerDragon_01	… quelle magnifique créature…	
VO_GILA_BOSS_27h_Male_Construct_HeroPowerGeneric_01	… un autre…	
VO_GILA_BOSS_27h_Male_Construct_HeroPowerMech_02	… un cœur mécanique_!	
VO_GILA_BOSS_27h_Male_Construct_HeroPowerMurloc_01	… du poisson…	
VO_GILA_BOSS_27h_Male_Construct_HeroPowerPirate_01	… yarr_?	
VO_GILA_BOSS_27h_Male_Construct_Intro_01	Ravi de vous encombrer.	
VO_GILA_BOSS_29h_Female_Satyr_DefeatPlayer_01	Ces bois ont leur propre mélodie.	
VO_GILA_BOSS_29h_Female_Satyr_EmoteResponse_01	Vous faites preuve\nd’une incroyable\nhardiesse.	
VO_GILA_BOSS_29h_Female_Satyr_EventPlaysEnchantingTune_01	Est-ce que ma mélodie vous plaît_?	
VO_GILA_BOSS_29h_Female_Satyr_EventPlaysEnchantingTune_02	Ne pourrions-nous pas nous entendre_?	
VO_GILA_BOSS_29h_Female_Satyr_EventPlaysEnchantingTune_03	Asseyez-vous près de moi_! Je ne mords pas.	
VO_GILA_BOSS_29h_Female_Satyr_EventPlaysOldMilitiaHorn_01	On fait un duo_?	
VO_GILA_BOSS_29h_Female_Satyr_EventPlaysSmallMinion_01	Oh, il est trop mignon_!	
VO_GILA_BOSS_29h_Female_Satyr_EventPlaysSmallMinion_02	Presque aussi adorable que moi_! Enfin…	
VO_GILA_BOSS_29h_Female_Satyr_EventPlaysSmallMinion_03	À croquer_!	
VO_GILA_BOSS_29h_Female_Satyr_HeroPower_01	Venez à moi, mes petits.	
VO_GILA_BOSS_29h_Female_Satyr_HeroPower_02	Un, deux, trois_! Suivez-moi_!	
VO_GILA_BOSS_29h_Female_Satyr_HeroPower_03	Par ici_! Suivez-moi.	
VO_GILA_BOSS_29h_Female_Satyr_HeroPower_04	Laissez ma flûte vous guider.	
VO_GILA_BOSS_29h_Female_Satyr_HeroPower_05	Je prendrai soin de vous. Faites-moi confiance_!	
VO_GILA_BOSS_29h_Female_Satyr_Intro_01	Enfin, du public_!	
VO_GILA_BOSS_30h_Female_Gnome_DefeatPlayer_01	Rien n’est gratuit en ce bas monde.	
VO_GILA_BOSS_30h_Female_Gnome_EmoteResponse_01	Oh, c’est trop tard.	
VO_GILA_BOSS_30h_Female_Gnome_EventBloodMagic_01	Tellement fragile. Et faible.	
VO_GILA_BOSS_30h_Female_Gnome_EventBloodMagic_02	Croquez à pleines dents.	
VO_GILA_BOSS_30h_Female_Gnome_EventBloodMagic_04	À la revoyure_!	
VO_GILA_BOSS_30h_Female_Gnome_EventBloodMagic_05	Tous sont égaux face à ma magie.	
VO_GILA_BOSS_30h_Female_Gnome_EventBloodMagic_06	Délicieux, non_?	
VO_GILA_BOSS_30h_Female_Gnome_Intro_01	Vous voulez goûter_?	
VO_GILA_BOSS_31h_Male_Treant_Death_01	<Meurt.>	
VO_GILA_BOSS_31h_Male_Treant_DefeatPlayer_01	Qui craint les feuilles ne doit pas aller au bois.	
VO_GILA_BOSS_31h_Male_Treant_Emote Response_01	Écouter la forêt plutôt que l’arbre qui tombe.	
VO_GILA_BOSS_31h_Male_Treant_HeroPower_01	Ma puissance se ramifie.	
VO_GILA_BOSS_31h_Male_Treant_HeroPower_02	Tant qu’il y a de la sève…	
VO_GILA_BOSS_31h_Male_Treant_HeroPower_03	À toi de jouer, petite pousse.	
VO_GILA_BOSS_31h_Male_Treant_HeroPower_05	Un morceau de moi.	
VO_GILA_BOSS_31h_Male_Treant_Intro_01	Je vais vous abattre.	
VO_GILA_BOSS_32h_Female_Sprite_Death_01	Pas drôle_!	
VO_GILA_BOSS_32h_Female_Sprite_DefeatPlayer_01	Allez, on joue encore un peu_! Oh oh… oups.	
VO_GILA_BOSS_32h_Female_Sprite_EmoteResponse_01	Ouais, ouais. On pourra jouer à ça après.	
VO_GILA_BOSS_32h_Female_Sprite_EventPlaysAoEBuff_01	Vous êtes doué à ce jeu_!	
VO_GILA_BOSS_32h_Female_Sprite_EventPlaysAoEBuff_02	Vous avez déjà joué à ce jeu.	
VO_GILA_BOSS_32h_Female_Sprite_EventPlaysBigMinion_01	Ouah_! C’est de la triche_!	
VO_GILA_BOSS_32h_Female_Sprite_EventPlaysBigMinion_02	Ouh là là_!	
VO_GILA_BOSS_32h_Female_Sprite_HeroPower_01	Grandissez_! Grandissez, plus vite_!	
VO_GILA_BOSS_32h_Female_Sprite_HeroPower_02	Plus grand_! Allez_!	
VO_GILA_BOSS_32h_Female_Sprite_HeroPower_03	Ça monte, ça monte_!	
VO_GILA_BOSS_32h_Female_Sprite_HeroPower_04	Hé hé, je suis en train de gagner_!	
VO_GILA_BOSS_32h_Female_Sprite_Intro_01	Vous voulez jouer_?	
VO_GILA_BOSS_33h_Male_Mech_Attack_01	Déclenchement des hostilités.	
VO_GILA_BOSS_33h_Male_Mech_Death_01	Erreur de segmentation…	
VO_GILA_BOSS_33h_Male_Mech_DefeatPlayer_01	Erreur_: plus aucune cible. Retour au mode patrouille.	
VO_GILA_BOSS_33h_Male_Mech_EmoteResponse_01	Avec moi, pas de faux-semblants.	
VO_GILA_BOSS_33h_Male_Mech_EventPlayHarvestGolem_01	Avertissement_: la cible n’a pas d’âme.	
VO_GILA_BOSS_33h_Male_Mech_EventWeaponKill_01	Fauché.	
VO_GILA_BOSS_33h_Male_Mech_EventWeaponKill_02	Mise à jour.	
VO_GILA_BOSS_33h_Male_Mech_EventWeaponKill_03	Effacé.	
VO_GILA_BOSS_33h_Male_Mech_HeroPower_01	Récolte.	
VO_GILA_BOSS_33h_Male_Mech_HeroPower_02	Nourriture spirituelle.	
VO_GILA_BOSS_33h_Male_Mech_HeroPower_03	Reconstitution des ressources.	
VO_GILA_BOSS_33h_Male_Mech_HeroPower_04	Recyclé.	
VO_GILA_BOSS_33h_Male_Mech_Intro_01	La moisson va commencer.	
VO_GILA_BOSS_34h_Male_Demon_DefeatPlayer_01	Votre âme est… puissante. Je vais m’en délecter pendant des semaines_!	
VO_GILA_BOSS_34h_Male_Demon_EmoteResponse_01	J’espère que votre âme est moins… bavarde.	
VO_GILA_BOSS_34h_Male_Demon_HeroPower_01	Hmm… Quel délice_!	
VO_GILA_BOSS_34h_Male_Demon_HeroPower_02	Exquis.	
VO_GILA_BOSS_34h_Male_Demon_HeroPower_03	Vous me semblez un peu pâle.	
VO_GILA_BOSS_34h_Male_Demon_HeroPower_04	Laissez-moi vous soulager du poids qui pèse sur vos épaules.	
VO_GILA_BOSS_34h_Male_Demon_HeroPower_05	Votre âme n’est qu’un fardeau.	
VO_GILA_BOSS_34h_Male_Demon_Intro_01	Bientôt, vous ne serez plus qu’une coquille vide.	
VO_GILA_BOSS_35h_Male_Beast_DefeatPlayer	Aaagheaa !	
VO_GILA_BOSS_35h_Male_Beast_EmoteResponse	Aoor aagh harahrahgh !	
VO_GILA_BOSS_35h_Male_Beast_Intro	Rgagaogh !	
VO_GILA_BOSS_36h_Female_Human_Death_01	Oh coâ_!	
VO_GILA_BOSS_36h_Female_Human_DefeatPlayer_01	Vous n’êtes clairement pas mon prince_!	
VO_GILA_BOSS_36h_Female_Human_Emote Response_01	Assez parlé. Venez m’embrasser, mon chou_!	
VO_GILA_BOSS_36h_Female_Human_EventHex_01	Ça alors_! Comme c’est… charmant_!	
VO_GILA_BOSS_36h_Female_Human_EventHex_02	Mon chou, je sais ce que ça fait.	
VO_GILA_BOSS_36h_Female_Human_HeroPower_01	Bisous ! 	
VO_GILA_BOSS_36h_Female_Human_HeroPower_02	<Bisou>	
VO_GILA_BOSS_36h_Female_Human_HeroPower_03	[x]Mouah !	
VO_GILA_BOSS_36h_Female_Human_Intro_01	Oh non, pas encore.	
VO_GILA_BOSS_37h_Male_Murloc_DefeatPlayer_01	…	
VO_GILA_BOSS_37h_Male_Murloc_EmoteResponse_01	… !	
VO_GILA_BOSS_37h_Male_Murloc_EventPlayMurlocHolmes_02	…_? …_!	
VO_GILA_BOSS_37h_Male_Murloc_EventPlayPlague_01	… !	
VO_GILA_BOSS_37h_Male_Murloc_EventPlayPlague_02	… !	
VO_GILA_BOSS_37h_Male_Murloc_EventPlayPlague_07	… !	
VO_GILA_BOSS_37h_Male_Murloc_HeroPower_01	…	
VO_GILA_BOSS_37h_Male_Murloc_HeroPower_02	…	
VO_GILA_BOSS_37h_Male_Murloc_HeroPower_03	… !	
VO_GILA_BOSS_37h_Male_Murloc_HeroPower_04	…	
VO_GILA_BOSS_37h_Male_Murloc_Intro_01	…	
VO_GILA_BOSS_38h_Male_Goblin_Death_01	Jamais… plus_!	
VO_GILA_BOSS_38h_Male_Goblin_DefeatPlayer_01	Le corbeau dit_: croa_!	
VO_GILA_BOSS_38h_Male_Goblin_EmoteResponse_01	Quel horrible cri d’oiseau_!	
VO_GILA_BOSS_38h_Male_Goblin_EventBirdDead_01	Espèce… de monstre_!	
VO_GILA_BOSS_38h_Male_Goblin_EventBirdDead_02	Qu’est-ce qu’ils vous ont fait_?	
VO_GILA_BOSS_38h_Male_Goblin_EventBirdDead_03	Pourquoi_? Ce ne sont que des oiseaux_!	
VO_GILA_BOSS_38h_Male_Goblin_EventPlayBird_01	Envole-toi, tu es libre_!	
VO_GILA_BOSS_38h_Male_Goblin_EventPlayBird_02	Je me sens pousser des ailes_!	
VO_GILA_BOSS_38h_Male_Goblin_EventPlayBird_03	Quel bel oiseau_!	
VO_GILA_BOSS_38h_Male_Goblin_EventPlayBird_04	Parfois, j’aimerais être un oiseau.	
VO_GILA_BOSS_38h_Male_Goblin_EventPlayerPlayBird_01	Quel drôle d’oiseau.	
VO_GILA_BOSS_38h_Male_Goblin_EventPlayerPlayBird_02	C’est une vraie prise de bec.	
VO_GILA_BOSS_38h_Male_Goblin_EventPlayNestingRoc_01	Je… ne voulais pas appeler celui-là.	
VO_GILA_BOSS_38h_Male_Goblin_EventPlayNestingRoc_02	Arf… presque.	
VO_GILA_BOSS_38h_Male_Goblin_HeroPower_01	Crôa_! Crôa_!	
VO_GILA_BOSS_38h_Male_Goblin_HeroPower_02	Crôa… Kof… Blargh.	
VO_GILA_BOSS_38h_Male_Goblin_HeroPower_03	Crôa. Cröa. Crôa_!	
VO_GILA_BOSS_38h_Male_Goblin_Intro_01	Leur voler dans les plumes ou voler vers d’autres cieux_? Et pourquoi pas les deux_?	
VO_GILA_BOSS_40h_Female_Treant_Death_01	Abattu…	
VO_GILA_BOSS_40h_Female_Treant_DefeatPlayer_01	Ma moisson ne fait que commencer.	
VO_GILA_BOSS_40h_Female_Treant_EmoteResponse_01	Ça va couper.	
VO_GILA_BOSS_40h_Female_Treant_EventPlaysAxe_01	Tant des miens, abattus dans la fleur de l’âge.	
VO_GILA_BOSS_40h_Female_Treant_EventPlaysAxe_02	Combien des miens devront encore subir ça_?	
VO_GILA_BOSS_40h_Female_Treant_EventPlaysWoodsmansAxe_01	Quelle horreur_!	
VO_GILA_BOSS_40h_Female_Treant_HeroPower_01	La forêt les emportera tous.	
VO_GILA_BOSS_40h_Female_Treant_HeroPower_02	Ces bois sont vivants.	
VO_GILA_BOSS_40h_Female_Treant_HeroPower_03	Notre heure est venue.	
VO_GILA_BOSS_40h_Female_Treant_HeroPower_04	Vous allez comprendre ce que signifie la haine.	
VO_GILA_BOSS_40h_Female_Treant_Intro_01	Votre espèce va payer.	
VO_GILA_BOSS_41h_Female_HumanGhost_Death_01	Mon amour…	
VO_GILA_BOSS_41h_Female_HumanGhost_DefeatPlayer_01	Rien ne peut nous séparer.	
VO_GILA_BOSS_41h_Female_HumanGhost_EmoteResponse_01	Laissez-nous tranquilles.	
VO_GILA_BOSS_41h_Female_HumanGhost_EventFatigue_01	Mon amour_? Où es-tu_?	
VO_GILA_BOSS_41h_Female_HumanGhost_EventFatigue_02	Je ne sens plus sa présence…	
VO_GILA_BOSS_41h_Female_HumanGhost_EventFatigueDeath_01	Sommes-nous… enfin libres_? Merci_!	
VO_GILA_BOSS_41h_Female_HumanGhost_EventPlayRin_01	Sera-t-elle celle qui nous libérera_?	
VO_GILA_BOSS_41h_Female_HumanGhost_EventShuffle_01	Vous… nous comprenez… n’est-ce pas_?	
VO_GILA_BOSS_41h_Female_HumanGhost_EventShuffle_02	Ensemble… pour l’éternité.	
VO_GILA_BOSS_41h_Female_HumanGhost_EventShuffle_03	Vous êtes comme nous.	
VO_GILA_BOSS_41h_Female_HumanGhost_HeroPower_01	Je n’abandonnerai jamais.	
VO_GILA_BOSS_41h_Female_HumanGhost_HeroPower_02	Reviens-moi_!	
VO_GILA_BOSS_41h_Female_HumanGhost_HeroPower_03	Ne pars pas…	
VO_GILA_BOSS_41h_Female_HumanGhost_HeroPower_04	Reste là.	
VO_GILA_BOSS_41h_Female_HumanGhost_Intro_01	Je te rejoindrai bientôt, mon amour.	
VO_GILA_BOSS_41h_Male_NightElf_Death_01	Non…	
VO_GILA_BOSS_41h_Male_NightElf_DefeatPlayer_01	Le bois Maudit n’a pas besoin de vous.	
VO_GILA_BOSS_41h_Male_NightElf_EmoteResponse_02	Vos paroles ne m’impressionnent pas.	
VO_GILA_BOSS_41h_Male_NightElf_EventHack_01	Quarante coups_!	
VO_GILA_BOSS_41h_Male_NightElf_EventHack_02	Votre châtiment.	
VO_GILA_BOSS_41h_Male_NightElf_EventHack_03	Quittez… ce… bois_!	
VO_GILA_BOSS_41h_Male_NightElf_HeroPower_01	Seul le plus fort survit.	
VO_GILA_BOSS_41h_Male_NightElf_HeroPower_02	Par les racines et les tiges.	
VO_GILA_BOSS_41h_Male_NightElf_HeroPower_03	Testez votre force_!	
VO_GILA_BOSS_41h_Male_NightElf_HeroPower_04	Prenez ça.	
VO_GILA_BOSS_41h_Male_NightElf_Intro_01	Demi-tour, intrus.	
VO_GILA_BOSS_42h_Male_Ogre_DefeatPlayer_01	Vous n’avez rien vu venir. Et moi non plus.	
VO_GILA_BOSS_42h_Male_Ogre_EmoteResponse_01	Continuez de parler et je vous trouverai_!	
VO_GILA_BOSS_42h_Male_Ogre_EventHeroPowerEnemy_01	Dans le mille_!	
VO_GILA_BOSS_42h_Male_Ogre_EventHeroPowerEnemy_02	[x]Paf !	
VO_GILA_BOSS_42h_Male_Ogre_EventHeroPowerEnemy_03	Je ne rate jamais_!	
VO_GILA_BOSS_42h_Male_Ogre_EventHeroPowerFriendly_01	Oh, j’ai mal visé.	
VO_GILA_BOSS_42h_Male_Ogre_EventHeroPowerFriendly_02	Je crois que j’ai marché sur un truc.	
VO_GILA_BOSS_42h_Male_Ogre_Intro_01	Qui est là_? Je sens une présence_!	
VO_GILA_BOSS_43h_Male_HumanGhost_DefeatPlayer_01	C’est l’heure de creuser.	
VO_GILA_BOSS_43h_Male_HumanGhost_EmoteResponse_01	Partez.	
VO_GILA_BOSS_43h_Male_HumanGhost_EventPlaysDeathrattle_01	Le bruit des ossements.	
VO_GILA_BOSS_43h_Male_HumanGhost_EventPlaysDeathrattle_02	Les morts ont des histoires à raconter.	
VO_GILA_BOSS_43h_Male_HumanGhost_EventPlaysDeathrattle_03	Nous ne sommes pas si différents.	
VO_GILA_BOSS_43h_Male_HumanGhost_EventPlaysDeathrattle_04	Grimpez dans votre cercueil, trouvez le repos.	
VO_GILA_BOSS_43h_Male_HumanGhost_EventPlaysDeathrattle_05	Une tombe peu profonde suffira pour celui-ci.	
VO_GILA_BOSS_43h_Male_HumanGhost_EventPlayStrokeOfMidnight_01	Le son du glas m’avait manqué. 	
VO_GILA_BOSS_43h_Male_HumanGhost_Intro_01	Vous ne devriez pas sortir si tard.	
VO_GILA_BOSS_44h_Male_Troll_Death_01	<Meurt.>	
VO_GILA_BOSS_44h_Male_Troll_DefeatPlayer_02	Mieux vaut cogner que guérir_!	
VO_GILA_BOSS_44h_Male_Troll_EmoteResponse_01	Le docteur a toujours raison.	
VO_GILA_BOSS_44h_Male_Troll_EventHeals_01	Ahhhh…	
VO_GILA_BOSS_44h_Male_Troll_EventHeals_02	C’est bon, ça…	
VO_GILA_BOSS_44h_Male_Troll_EventHeals_04	Hahaha. Mmmm…	
VO_GILA_BOSS_44h_Male_Troll_EventPlayerHeals_03	Eh, vous ne savez pas y faire.	
VO_GILA_BOSS_44h_Male_Troll_EventPlayerHeals_04	Laissez-moi m’occuper de ça.	
VO_GILA_BOSS_44h_Male_Troll_EventPlaysBandages_01	C’est du tissu de bonne qualité_!	
VO_GILA_BOSS_44h_Male_Troll_HeroPower_01	Ça risque de piquer…	
VO_GILA_BOSS_44h_Male_Troll_HeroPower_02	Vous avez peur des aiguilles_?	
VO_GILA_BOSS_44h_Male_Troll_HeroPower_03	Rapide et sans douleur. Enfin, presque.	
VO_GILA_BOSS_44h_Male_Troll_HeroPower_04	Le vaudou_? Euh, j’ai ma licence.	
VO_GILA_BOSS_44h_Male_Troll_HeroPower_05	Ça fait du bien, non_?	
VO_GILA_BOSS_44h_Male_Troll_HeroPower_06	Ça risque de piquer un peu.	
VO_GILA_BOSS_44h_Male_Troll_Intro_01	Approchez_! Asseyez-vous. Montrez-moi où je vais vous faire mal.	
VO_GILA_BOSS_45h_Female_Human_Death_02	<Meurt.>	
VO_GILA_BOSS_45h_Female_Human_DefeatPlayer_01	Vous auriez fait une magnifique recrue.	
VO_GILA_BOSS_45h_Female_Human_EmoteResponse_01	Allons en discuter. Autour d’un verre.	
VO_GILA_BOSS_45h_Female_Human_EventDrawsExtraCards_01	Oui. Buvez_!	
VO_GILA_BOSS_45h_Female_Human_EventDrawsExtraCards_02	Le goût vous plaît_?	
VO_GILA_BOSS_45h_Female_Human_EventDrawsExtraCards_03	Buvez tout. Allez-y.	
VO_GILA_BOSS_45h_Female_Human_EventFirstDamage_01	Est-ce que ça veut dire que vous n’êtes pas avec nous_?	
VO_GILA_BOSS_45h_Female_Human_EventPlayHallowedWater_01	De l’eau bénite_? Oh_! Même le goût est infect.	
VO_GILA_BOSS_45h_Female_Human_EventPlaysAcolyte_01	Oh… Je l’aime bien, lui.	
VO_GILA_BOSS_45h_Female_Human_EventPlaysHoarder_01	Vous pourrez boire quand il sera parti.	
VO_GILA_BOSS_45h_Female_Human_EventPlaysNovice_01	Notre toute dernière recrue arrive. À sa santé_!	
VO_GILA_BOSS_45h_Female_Human_Intro_01	Baissez vos armes. Rejoignez-nous.	
VO_GILA_BOSS_46h_Male_Worgen_DefeatPlayer_01	Seuls les plus forts survivent.	
VO_GILA_BOSS_46h_Male_Worgen_EmoteResponse_01	Vous sentez ça_? C’est la peur.	
VO_GILA_BOSS_46h_Male_Worgen_EventPlayBloodMoon_01	AHOUUU !	
VO_GILA_BOSS_46h_Male_Worgen_EventPlaysWorgen_01	Pitoyable.	
VO_GILA_BOSS_46h_Male_Worgen_EventPlaysWorgen_03	Vous êtes faible.	
VO_GILA_BOSS_46h_Male_Worgen_EventPlaysWorgen_06	Vous n’êtes rien.	
VO_GILA_BOSS_46h_Male_Worgen_EventPlayTrapper_02	Succombez à votre rage_!	
VO_GILA_BOSS_46h_Male_Worgen_Intro_01	Vous osez me donner la chasse_?	
VO_GILA_BOSS_47h_Male_Monster_Death_01	Mon tour… est terminé_!	
VO_GILA_BOSS_47h_Male_Monster_DefeatPlayer_01	Chaque héros dévoré renforce ces bois damnés.	
VO_GILA_BOSS_47h_Male_Monster_EmoteResponse_01	Ça parle_! Ça larmoie_! Si faible que l’on redoute de simples bêtes qui festoient.	
VO_GILA_BOSS_47h_Male_Monster_HeroPower_01	Criez, recommencez_!	
VO_GILA_BOSS_47h_Male_Monster_HeroPower_02	Entendez leur cri et par deux fois, payez le prix.	
VO_GILA_BOSS_47h_Male_Monster_HeroPower_03	Arriver, saluer. Par politesse, recommencer.	
VO_GILA_BOSS_47h_Male_Monster_IntroALT_01	Qui ose fouler ces terres, et du Carniflore le repaire_?	
VO_GILA_BOSS_48h_Female_Gnome_Death_01	Je ne suis pas celle qui souffrira le plus_!	
VO_GILA_BOSS_48h_Female_Gnome_DefeatPlayer_01	Eh bien, me voilà débarrassée de MOI. Minute, ça ne serait pas un paradoxe temporel_?	
VO_GILA_BOSS_48h_Female_Gnome_EmoteResponse_01	Je savais que j’allais dire ça.	
VO_GILA_BOSS_48h_Female_Gnome_EventAlt_01	Non_! On recommence.	
VO_GILA_BOSS_48h_Female_Gnome_EventAlt_02	Je pense que ça s’est plutôt passé comme… ça_!	
VO_GILA_BOSS_48h_Female_Gnome_EventAlt_03	Arrêtez_! Revenons en arrière.	
VO_GILA_BOSS_48h_Female_Gnome_EventPlayerAltTime_01	Eh bien, ça c’est une première.	
VO_GILA_BOSS_48h_Female_Gnome_EventPlayerAltTime_02	Ouh là, on a VRAIMENT mis la pagaille dans la ligne temporelle.	
VO_GILA_BOSS_48h_Female_Gnome_EventPlayerTimeWarp_01	C’est de plus en plus confus.	
VO_GILA_BOSS_48h_Female_Gnome_EventPlayerTimeWarp_02	Note à moi-même_: éviter ce combat.	
VO_GILA_BOSS_48h_Female_Gnome_EventPlayerTimeWarpToki_01	Attends. Comment se fait-il que tu connaisses déjà ça_!	
VO_GILA_BOSS_48h_Female_Gnome_EventPlayerTimeWarpToki_02	Je me rappelle très bien avoir fait ça la dernière fois… que je l’ai fait_!	
VO_GILA_BOSS_48h_Female_Gnome_EventTimeWarp_01	Tu apprendras à faire ça dans quelques années.	
VO_GILA_BOSS_48h_Female_Gnome_EventTimeWarp_02	Celui-là m’a donné du fil à retordre.	
VO_GILA_BOSS_48h_Female_Gnome_EventTurn2_01	Je dois m’arrêter_! Avant que j’arrive trop tard_!	
VO_GILA_BOSS_48h_Female_Gnome_EventTurn4_01	Tu ne peux pas gagner_! Je connais chacune de mes tactiques_!	
VO_GILA_BOSS_48h_Female_Gnome_EventTurn6_01	On va toutes les deux regretter ton prochain coup. À moins que je ne t’arrête_!	
VO_GILA_BOSS_48h_Female_Gnome_HeroPower_01	Il est temps d’accélérer les choses_!	
VO_GILA_BOSS_48h_Female_Gnome_HeroPower_02	Tic, tac, tic, tac_!	
VO_GILA_BOSS_48h_Female_Gnome_HeroPower_03	Finissons-en.	
VO_GILA_BOSS_48h_Female_Gnome_Intro_01	Ah, nous nous rencontrons de nouveau_! Pour la première fois_!	
VO_GILA_BOSS_48h_Female_Gnome_Intro_02	Encore moi_? C’est la deuxième fois que je m’affronte.	
VO_GILA_BOSS_48h_Female_Gnome_Intro_03	C’est déjà la troisième fois qu’on s’affronte. Tu ferais mieux d’abandonner_!	
VO_GILA_BOSS_48h_Female_Gnome_Intro_04	Tu n’en finis donc jamais de… revenir_? Ça suffit, maintenant_!	
VO_GILA_BOSS_48h_Female_Gnome_Intro_05	Combien de fois encore allons-nous devoir jouer à ce petit jeu_?	
VO_GILA_BOSS_48h_Female_Gnome_PlayerHeroPower_01	Qu’est-ce qui a pu me faire croire que ce serait une bonne idée_?	
VO_GILA_BOSS_48h_Female_Gnome_PlayerHeroPower_02	Dire que je me trouvais si intelligente.	
VO_GILA_BOSS_48h_Female_Gnome_PlayerHeroPower_03	Pas encore_!	
VO_GILA_BOSS_48h_Female_Gnome_PlayerHeroPower_04	Je commence VRAIMENT à me taper sur les nerfs.	
VO_GILA_BOSS_49h_Female_Undead_Death_01	Un cœur… corrompu…	
VO_GILA_BOSS_49h_Female_Undead_DefeatPlayer_01	Vous auriez pu être des nôtres.	
VO_GILA_BOSS_49h_Female_Undead_EmoteResponse_01	Rejoignez notre culte. Le vendredi, c’est sorcellerie.	
VO_GILA_BOSS_49h_Female_Undead_EventFaithfulDies_01	J’avais besoin de ce serviteur_!	
VO_GILA_BOSS_49h_Female_Undead_EventFaithfulDies_02	Les bons serviteurs sont difficiles à contrôler.	
VO_GILA_BOSS_49h_Female_Undead_EventFaithfulDies_03	Je ne t’oublierai jamais… euh, c’était quoi ton nom, déjà_?	
VO_GILA_BOSS_49h_Female_Undead_EventPact_01	Rejoins-nous…	
VO_GILA_BOSS_49h_Female_Undead_EventPact_02	Un nouveau membre pour mon culte_!	
VO_GILA_BOSS_49h_Female_Undead_EventPact_03	Viens à moi, oui…	
VO_GILA_BOSS_49h_Female_Undead_EventPact_05	Mon culte grandit_!	
VO_GILA_BOSS_49h_Female_Undead_EventPlayBird_01	Épine de pacifique\net aiguillon de Rougecrête_;\npatte de lézard et\naile de chouette.	
VO_GILA_BOSS_49h_Female_Undead_EventPlayCauldron_01	Redoublons de travail et de soins, redoublons. Feu, brûle et dans le chaudron, le bouillon.	
VO_GILA_BOSS_49h_Female_Undead_EventPlayDragon_01	Dents de loup et écaille de dragon_; une tige de terrestrine pour compléter notre potion.	
VO_GILA_BOSS_49h_Female_Undead_EventPlayFaithful_01	Approche, mon enfant.	
VO_GILA_BOSS_49h_Female_Undead_EventPlayFaithful_02	Avance, fidèle serviteur…	
VO_GILA_BOSS_49h_Female_Undead_EventPlayFaithful_03	Confie-moi ta vie.	
VO_GILA_BOSS_49h_Female_Undead_EventPlayFaithful_04	Mes chers serviteurs_!	
VO_GILA_BOSS_49h_Female_Undead_EventPlayFaithful_05	Sers-moi une dernière fois_!	
VO_GILA_BOSS_49h_Female_Undead_EventPlayHex_01	Œil de triton et branchie de têtard_; duvet de chauve-souris et langue de brouillard.	
VO_GILA_BOSS_49h_Female_Undead_EventPlaySnake_01	Filet de serpent trempé de poison_; bous et cuis dans le chaudron.	
VO_GILA_BOSS_49h_Female_Undead_EventPlayTreant_01	Mélanger le tout avec du bois putride_;\net notre charme est parfait et solide.	
VO_GILA_BOSS_49h_Female_Undead_EventTurn02_01	Si vous connaissiez sa puissance, Shaw, vous lui obéiriez comme l’un de vos chiens.	
VO_GILA_BOSS_49h_Female_Undead_Intro_02	Parce que vous nous avez traqués, ou parce que nous vous avons attiré ici_?	
VO_GILA_BOSS_50h_Male_Spirit_DefeatPlayer_01	Mieux vaut se consumer que disparaître…	
VO_GILA_BOSS_50h_Male_Spirit_EmoteResponse_01	Respirez…	
VO_GILA_BOSS_50h_Male_Spirit_EventPlaysEcho_01	Oui…	
VO_GILA_BOSS_50h_Male_Spirit_EventPlaysEcho_02	Un autre…	
VO_GILA_BOSS_50h_Male_Spirit_EventPlaysEcho_03	Encore…_!	
VO_GILA_BOSS_50h_Male_Spirit_EventPlaysEcho_04	Hm hm, hahaha.	
VO_GILA_BOSS_50h_Male_Spirit_Intro_01	La brume vous appelle…	
VO_GILA_BOSS_51h_Male_Undead_Death_01	<Meurt.>	
VO_GILA_BOSS_51h_Male_Undead_DefeatPlayer_01	Oh_! Vous n’allez plus avoir besoin de cet or, on dirait.	
VO_GILA_BOSS_51h_Male_Undead_EmoteResponse_01	Taisez-vous.	
VO_GILA_BOSS_51h_Male_Undead_EventPlayCoinPouch_01	Allez. Donnez-moi ça.	
VO_GILA_BOSS_51h_Male_Undead_EventPlayMinion_01	Hé_! Il y a un impôt là-dessus.	
VO_GILA_BOSS_51h_Male_Undead_EventPlayMinion_03	Ça va vous coûter cher.	
VO_GILA_BOSS_51h_Male_Undead_EventPlayMinion_04	Vous allez le payer. Très bientôt.	
VO_GILA_BOSS_51h_Male_Undead_HeroPower_01	Ce n’est qu’une goutte d’eau dans l’océan.	
VO_GILA_BOSS_51h_Male_Undead_HeroPower_02	Payez ce que vous devez.	
VO_GILA_BOSS_51h_Male_Undead_HeroPower_03	Trois fois rien, vraiment.	
VO_GILA_BOSS_51h_Male_Undead_HeroPower_04	Videz. Vos. Poches.	
VO_GILA_BOSS_51h_Male_Undead_Intro_01	Vous avez la tête de quelqu’un qui me doit de l’argent.	
VO_GILA_BOSS_52h_Male_Human_DefeatPlayerALT_02	Je ne retournerai pas en prison_! Pas aujourd’hui_!	
VO_GILA_BOSS_52h_Male_Human_EmoteResponse_02	Tout n’est que fumée et cendres, par ici.	
VO_GILA_BOSS_52h_Male_Human_EventPlayRoyalGift_02	Oooh, joli_! J’aimerais bien mettre la main dessus.	
VO_GILA_BOSS_52h_Male_Human_EventPlayStealth_02	Deux poids, deux mesures_!	
VO_GILA_BOSS_52h_Male_Human_EventPlayStealth_03	Oh et quand MOI je me camoufle, ça fait de moi un voleur.	
VO_GILA_BOSS_52h_Male_Human_EventTransform_01	Là, vous avez vraiment réussi à m’énerver.	
VO_GILA_BOSS_52h_Male_Human_HeroPower_01	[x]Invisible !	
VO_GILA_BOSS_52h_Male_Human_HeroPower_02	Je ne ferai rien en douce, promis_!	
VO_GILA_BOSS_52h_Male_Human_HeroPower_03	C’est ma tenue de ville, rien de plus.	
VO_GILA_BOSS_52h_Male_Human_HeroPower_04	Quelques taches de suie.	
VO_GILA_BOSS_52h_Male_Human_HeroPower_05	Poussière de camouflage_!	
VO_GILA_BOSS_52h_Male_Human_IntroALT_02	Un cambrioleur_? Moi_? Non, je n’oserais jamais…	
VO_GILA_BOSS_52h2_Male_Worgen_EmoteResponse_02	Ah, regardez ce que vous m’avez fait faire_!	
VO_GILA_BOSS_52h2_Male_Worgen_HeroPower_01	AHOUUU !	
VO_GILA_BOSS_52h2_Male_Worgen_HeroPower_02	Attrapez-les_!	
VO_GILA_BOSS_52h2_Male_Worgen_HeroPower_03	Libérez la bête qui sommeille en vous_!	
VO_GILA_BOSS_54h_Male_Golem_DefeatPlayer_01	Tordre et casser. Écraser et briser.	
VO_GILA_BOSS_54h_Male_Golem_EmoteResponse_01	Je ne vous jette pas la pierre…	
VO_GILA_BOSS_54h_Male_Golem_HeroPower_01	Tous nous obéiront.	
VO_GILA_BOSS_54h_Male_Golem_HeroPower_02	Le bois Maudit grandit.	
VO_GILA_BOSS_54h_Male_Golem_HeroPower_03	Raser la terre. Répandre les graines.	
VO_GILA_BOSS_54h_Male_Golem_HeroPower_04	L’aura d’Hagatha nous rend plus forts.	
VO_GILA_BOSS_54h_Male_Golem_HeroPower_05	Par la volonté d’Hagatha.	
VO_GILA_BOSS_54h_Male_Golem_Intro_01	Pierre qui roule n’amasse pas mousse.	
VO_GILA_BOSS_55h_Female_NightElf_Death_01	Qui les sauvera_?	
VO_GILA_BOSS_55h_Female_NightElf_DefeatPlayer_01	Du calme. Votre esprit est en sécurité, désormais…	
VO_GILA_BOSS_55h_Female_NightElf_EmoteResponse_01	Chut_! Pas devant les feux follets.	
VO_GILA_BOSS_55h_Female_NightElf_EventAssimilation_01	Ce qui est à vous sera à nous.	
VO_GILA_BOSS_55h_Female_NightElf_EventAssimilation_02	Leurs corps… Emparez-vous-en_!	
VO_GILA_BOSS_55h_Female_NightElf_EventAssimilation_03	C’est notre chance_!	
VO_GILA_BOSS_55h_Female_NightElf_EventKillsWisp_02	[x]Non !	
VO_GILA_BOSS_55h_Female_NightElf_EventKillsWisp_03	[x]Arrêtez !	
VO_GILA_BOSS_55h_Female_NightElf_EventKillsWisp_04	Mes enfants_!	
VO_GILA_BOSS_55h_Female_NightElf_EventPlayCartographer_01	Une cartographe_! Elle doit savoir comment quitter cet endroit.	
VO_GILA_BOSS_55h_Female_NightElf_EventPlayCompass_01	Ça nous permettra peut-être de trouver la sortie.	
VO_GILA_BOSS_55h_Female_NightElf_HeroPower_01	Venez, mes enfants.	
VO_GILA_BOSS_55h_Female_NightElf_HeroPower_02	Ah, vous voilà.	
VO_GILA_BOSS_55h_Female_NightElf_HeroPower_03	Venez, venez…	
VO_GILA_BOSS_55h_Female_NightElf_Intro_01	La malédiction d’Hagatha dévore tout. Je dois sauver mes enfants_!	
VO_GILA_BOSS_56h_Male_Elemental_DefeatPlayer_01	Pourquoi vous faites cette tête_? Oh, ça va.	
VO_GILA_BOSS_56h_Male_Elemental_EmoteResponse_01	Je n’aurais pas dit mieux.	
VO_GILA_BOSS_56h_Male_Elemental_EventTransformFace_02	Le masque parfait.	
VO_GILA_BOSS_56h_Male_Elemental_HeroPower_01	Nouveau masque, nouveau visage.	
VO_GILA_BOSS_56h_Male_Elemental_HeroPower_02	Nouveau visage, nouvelle personne.	
VO_GILA_BOSS_56h_Male_Elemental_HeroPower_03	Nouvelle personne, nouvelle vie.	
VO_GILA_BOSS_56h_Male_Elemental_HeroPower_05	La vie, c’est le changement.	
VO_GILA_BOSS_56h_Male_Elemental_HeroPower_07	Nous ne faisons qu’un, mais nous sommes multiples.	
VO_GILA_BOSS_56h_Male_Elemental_HeroPower_09	Vous rappelez-vous seulement qui vous étiez_?	
VO_GILA_BOSS_56h_Male_Elemental_HeroPower_10	Tout ce dont vous avez besoin, c’est d’un masque.	
VO_GILA_BOSS_56h_Male_Elemental_IntroALT_02	Nous ne sommes pas si différents, vous et moi.	
VO_GILA_BOSS_57h_Male_Undead_DefeatPlayer_01	Vous reviendrez, en temps voulu.	
VO_GILA_BOSS_57h_Male_Undead_EmoteResponse_01	Je transmettrai vos salutations à la Dame noire.	
VO_GILA_BOSS_57h_Male_Undead_EventDesecrate_01	Laissez la maladie vous emporter.	
VO_GILA_BOSS_57h_Male_Undead_EventDesecrate_02	Encore un qui finit dans la tombe.	
VO_GILA_BOSS_57h_Male_Undead_EventDesecrate_03	C’est contagieux.	
VO_GILA_BOSS_57h_Male_Undead_EventDesecrate_04	Vous n’allez pas tarder à les rejoindre.	
VO_GILA_BOSS_57h_Male_Undead_EventPlayHolyBook_01	Vos saintes écritures ne vous sauveront pas.	
VO_GILA_BOSS_57h_Male_Undead_EventShallowGraves_01	Levez-vous_!	
VO_GILA_BOSS_57h_Male_Undead_EventShallowGraves_02	[x]Revenez !	
VO_GILA_BOSS_57h_Male_Undead_EventShallowGraves_03	Répondez à l’appel de la Dame noire.	
VO_GILA_BOSS_57h_Male_Undead_HeroPower_01	Profanation.	
VO_GILA_BOSS_57h_Male_Undead_HeroPower_02	Comme du petit bois.	
VO_GILA_BOSS_57h_Male_Undead_HeroPower_03	Inhalez la fumée.	
VO_GILA_BOSS_57h_Male_Undead_HeroPower_04	La corruption s’étend.	
VO_GILA_BOSS_57h_Male_Undead_Intro_01	Bienvenue_! Regardez ce que j’ai exhumé pour vous.	
VO_GILA_BOSS_58h_Male_Giant_Death_01	<Meurt.>	
VO_GILA_BOSS_58h_Male_Giant_DefeatPlayer_01	Joliiiie ville. À ÉCRASER_!	
VO_GILA_BOSS_58h_Male_Giant_DefeatPlayer_02	Grum SUR la ville_!	
VO_GILA_BOSS_58h_Male_Giant_EmoteResponse_01	[x]Piétiner !	
VO_GILA_BOSS_58h_Male_Giant_EventBigWeapon_01	Vous très faché_?	
VO_GILA_BOSS_58h_Male_Giant_EventMinionReturn_01	Te revoilà_!	
VO_GILA_BOSS_58h_Male_Giant_EventMinionReturn_02	De retour_!	
VO_GILA_BOSS_58h_Male_Giant_EventMinionReturn_03	Rebonjour.	
VO_GILA_BOSS_58h_Male_Giant_HeroPower_01	[x]Fuyeeeeeez !	
VO_GILA_BOSS_58h_Male_Giant_HeroPower_02	Ohhhh… BOUH_!	
VO_GILA_BOSS_58h_Male_Giant_HeroPower_03	Où vous êtes cachés…_?!	
VO_GILA_BOSS_58h_Male_Giant_HeroPower_04	Fi-faï-fo-GRUM.	
VO_GILA_BOSS_58h_Male_Giant_HeroPower_05	Vous pouvez fuir mais vous pouvez… aussi vous cacher_?	
VO_GILA_BOSS_58h_Male_Giant_Intro_01	Ouaiiiiiiis, casser_!	
VO_GILA_BOSS_59h_Male_Undead_DefeatPlayer_01	Vous ne valez guerre mieux qu’un chien errant.	
VO_GILA_BOSS_59h_Male_Undead_DefeatPlayer_02	Adieu, mon vieil ami.	
VO_GILA_BOSS_59h_Male_Undead_DefeatPlayer_03	Voilà donc l’assassin qu’on envoie me tuer_? Ridicule.	
VO_GILA_BOSS_59h_Male_Undead_EmoteResponse_01	Un canon pour un duel_?\nEt c’est moi qu’on traite de lâche_?	
VO_GILA_BOSS_59h_Male_Undead_EventDeadlyShot_01	Dans le mille_!	
VO_GILA_BOSS_59h_Male_Undead_EventDeadlyShot_02	Quoi_? C’est un service que je lui rends.	
VO_GILA_BOSS_59h_Male_Undead_EventQuickShot_01	J’ai quelques tours dans mon sac.	
VO_GILA_BOSS_59h_Male_Undead_EventQuickShot_02	Dégainez !	
VO_GILA_BOSS_59h_Male_Undead_EventTurn02_01	J’ai ordonné à Grisetête de vous laisser pourrir en prison, Crowley.	
VO_GILA_BOSS_59h_Male_Undead_HeroPowerKills_01	Ça me rappelle des souvenirs.	
VO_GILA_BOSS_59h_Male_Undead_HeroPowerKills_02	J’avais oublié à quel point j’aimais ça_!	
VO_GILA_BOSS_59h_Male_Undead_HeroPowerKills_03	Ahhahaha.	
VO_GILA_BOSS_59h_Male_Undead_HeroPowerKills_04	Ah, voir le monde brûler.	
VO_GILA_BOSS_59h_Male_Undead_HeroPowerKills_05	Si seulement je pouvais faire la même chose à tous les Worgens.	
VO_GILA_BOSS_59h_Male_Undead_Intro_01	Votre voyage va s’achever dans la douleur_!	
VO_GILA_BOSS_59h_Male_Undead_IntroCrowley_01	Vous êtes mal placé pour parler de loyauté, Crowley.	
VO_GILA_BOSS_60h_Male_HumanGhost_Death_02	Emporté… par les flots…	
VO_GILA_BOSS_60h_Male_HumanGhost_DefeatPlayer_01	Bienvenue à bord. Pour toujours_!	
VO_GILA_BOSS_60h_Male_HumanGhost_EmoteResponseTess_01	Commencez à croire aux histoires de fantômes, mademoiselle.	
VO_GILA_BOSS_60h_Male_HumanGhost_EventBigWeapon_01	Bien affûtée.	
VO_GILA_BOSS_60h_Male_HumanGhost_EventBigWeapon_02	Quelle beauté.	
VO_GILA_BOSS_60h_Male_HumanGhost_EventBigWeapon_03	Avez-vous déjà vu une telle lame_?	
VO_GILA_BOSS_60h_Male_HumanGhost_EventPlayerKingsblade_01	Quoi… Elle n’est pas unique_?	
VO_GILA_BOSS_60h_Male_HumanGhost_EventPlayKingsblade_01	J’ai parcouru le monde à la recherche de cette beauté.	
VO_GILA_BOSS_60h_Male_HumanGhost_EventPlayKingsblade_02	Elle me reviendra toujours.	
VO_GILA_BOSS_60h_Male_HumanGhost_EventPlayKragg_02	Quitter la mer pour les cieux_? Quelle folie.	
VO_GILA_BOSS_60h_Male_HumanGhost_EventPlayPatches_02	Neunœil_! Il te manque quelques yeux, mon vieil ami_!	
VO_GILA_BOSS_60h_Male_HumanGhost_EventPlayTuskarrRaider_01	Pff. N’importe qui peut devenir pirate, de nos jours.	
VO_GILA_BOSS_60h_Male_HumanGhost_EventTurn2_01	Quelle meilleure\nvengeance que faire\nde vous un membre\nde mon équipage_?	
VO_GILA_BOSS_60h_Male_HumanGhost_HeroPower_01	Ma lame chante pour moi et je lui réponds_!	
VO_GILA_BOSS_60h_Male_HumanGhost_HeroPower_07	Nous couvrirons le bruit des vagues_!	
VO_GILA_BOSS_60h_Male_HumanGhost_IntroTess_01	Oh_! Que je sois pendu si ce n’est pas un coup de la fille du roi.	
VO_GILA_BOSS_61h_Female_Orc_DefeatPlayer_01	Je ne fais qu’un avec ces bois, et je ne mourrai jamais.	
VO_GILA_BOSS_61h_Female_Orc_EmoteResponse_01	Contemplez votre reflet et vous découvrirez l’instrument de votre destruction.	
VO_GILA_BOSS_61h_Female_Orc_EmoteResponseCrowley_01	Tu as une dette à racheter, Crowley_? Hein_?	
VO_GILA_BOSS_61h_Female_Orc_EmoteResponseShaw_01	Ouaf ouaf, wouf wouf. Et tes chiens sont tout aussi énervants que toi_!	
VO_GILA_BOSS_61h_Female_Orc_EmoteResponseTess_01	Tes parents ont-ils aimé un seul de leurs enfants_?	
VO_GILA_BOSS_61h_Female_Orc_EmoteResponseToki_01	Comment as-tu pu échapper au gnomenappeur_?	
VO_GILA_BOSS_61h_Female_Orc_EventCannonKill_01	Maudit soit ce canon_!	
VO_GILA_BOSS_61h_Female_Orc_EventCannonKill_02	Tu n’es pas intelligent. Juste bruyant.	
VO_GILA_BOSS_61h_Female_Orc_EventCannonKill_03	Le fer rouille aussi bien que la chair pourrit.	
VO_GILA_BOSS_61h_Female_Orc_EventCannonKill_04	Tes aboiements sont trop forts, sale chien.	
VO_GILA_BOSS_61h_Female_Orc_EventCrowleyHagathaLow_01	Je vivrai tant que ces bois vivront.	
VO_GILA_BOSS_61h_Female_Orc_EventCrowleyLow_01	Je t’enterrerai avec ton canon, Crowley.	
VO_GILA_BOSS_61h_Female_Orc_EventCrowleyTurn2_01	Vous avez abandonné ces terres_! Je les ai récupérées_!	
VO_GILA_BOSS_61h_Female_Orc_EventCrowleyTurn4_01	Tu es un paria, même pour les tiens.	
VO_GILA_BOSS_61h_Female_Orc_EventShawHoundKill_01	Méchant chien.	
VO_GILA_BOSS_61h_Female_Orc_EventShawHoundKill_02	Sales chiens.	
VO_GILA_BOSS_61h_Female_Orc_EventShawLow_01	La malédiction du bois Maudit va t’emporter.	
VO_GILA_BOSS_61h_Female_Orc_EventShawTurn2_01	Toutes les créatures de la forêt deviennent miennes…	
VO_GILA_BOSS_61h_Female_Orc_EventShawTurn2_02	… dès qu’elles sentent ma présence.	
VO_GILA_BOSS_61h_Female_Orc_EventShawTurn4_01	J’ai des milliers d’esprits maléfiques à ma disposition.	
VO_GILA_BOSS_61h_Female_Orc_EventSummonCrowskin_01	Mon culte ne mourra jamais.	
VO_GILA_BOSS_61h_Female_Orc_EventSummonGodfrey_01	Godfrey, les esprits de ces bois t’appellent…	
VO_GILA_BOSS_61h_Female_Orc_EventTessHagathaLow_01	JE SUIS ces bois.	
VO_GILA_BOSS_61h_Female_Orc_EventTessLow_01	Mon bois se repaîtra de ton cadavre.	
VO_GILA_BOSS_61h_Female_Orc_EventTessScavenges_01	Rien ne te sauvera.	
VO_GILA_BOSS_61h_Female_Orc_EventTessScavenges_02	Continue à creuser, princesse.	
VO_GILA_BOSS_61h_Female_Orc_EventTessScavenges_03	Tu fouilles dans les déchets, maintenant_?	
VO_GILA_BOSS_61h_Female_Orc_EventTessScavenges_04	Ça ne te sauvera pas.	
VO_GILA_BOSS_61h_Female_Orc_EventTessTurn2_01	Ces bois envahiront ta cité et la feront disparaître.	
VO_GILA_BOSS_61h_Female_Orc_EventTessTurn4_01	Cette terre était morte_! Je l’ai ramenée à la vie. À présent, elle m’appartient.	
VO_GILA_BOSS_61h_Female_Orc_EventTokiHagathaLow_01	Les esprits de ces bois me protégeront…	
VO_GILA_BOSS_61h_Female_Orc_EventTokiHeroPower_01	… Que s’est-il passé_?	
VO_GILA_BOSS_61h_Female_Orc_EventTokiHeroPower_03	Tu prends des risques.	
VO_GILA_BOSS_61h_Female_Orc_EventTokiHeroPower_04	Les esprits savent ce que tu fais.	
VO_GILA_BOSS_61h_Female_Orc_EventTokiHeroPower_05	Un jour, tes sales tours te rattraperont.	
VO_GILA_BOSS_61h_Female_Orc_EventTokiLow_01	Tu as joué ton dernier tour, Gnome.	
VO_GILA_BOSS_61h_Female_Orc_EventTokiTurn2_01	Et c’est moi que l’on traite d’abomination…	
VO_GILA_BOSS_61h_Female_Orc_EventTokiTurn4_01	Tu penses que\nje ne vois pas tes manigances.\nMais rien ne m’échappe.	
VO_GILA_BOSS_61h_Female_Orc_Intro_01	Je suis le cœur de ces bois.	
VO_GILA_BOSS_61h_Female_Orc_IntroCrowley_01	Je rêve du silence qui régnera quand j’aurai fait taire ce canon.	
VO_GILA_BOSS_61h_Female_Orc_IntroShaw_01	Je retournerai tes chiens contre leur maître.	
VO_GILA_BOSS_61h_Female_Orc_IntroTess_01	Fais demi-tour, «_princesse_». Et va dire à ton père que tout espoir est perdu.	
VO_GILA_BOSS_61h_Female_Orc_IntroToki_01	Tu changes le cours de ton destin, mais les arbres et les étoiles se souviennent de tout.	
VO_GILA_BOSS_62h_GustaveTheGutRipper_Emote	OOOoozzzz !	
VO_GILA_BOSS_62h_GustaveTheGutRipper_Intro	PffReeooo !	
VO_GILA_BOSS_62h_GustaveTheGutRipper_PlayerDefeat	Mragrararouh !	
VO_GILA_BOSS_63h_Female_Harpy_Death_01	Mes… œufs…	
VO_GILA_BOSS_63h_Female_Harpy_DefeatPlayer_01	Mes sœurs_! Portez ce cadavre jusqu’à mon nid.	
VO_GILA_BOSS_63h_Female_Harpy_EmoteResponse_01	Entamer une conversation ne ferait que perturber la dynamique de notre relation.	
VO_GILA_BOSS_63h_Female_Harpy_HeroPower_01	À moi_!	
VO_GILA_BOSS_63h_Female_Harpy_HeroPower_02	Votre magie ne fait qu’assombrir ces bois.	
VO_GILA_BOSS_63h_Female_Harpy_HeroPower_03	Je deviens plus puissante, imbécile.	
VO_GILA_BOSS_63h_Female_Harpy_Intro_01	Vous n’irez pas plus loin. Ordres d’Hagatha_!	
VO_GILA_BOSS_64h_Male_Goblin_Death_01	A-attendez_!	
VO_GILA_BOSS_64h_Male_Goblin_DefeatPlayer_01	Merci, merci_! Parlons maintenant de mes émoluments…	
VO_GILA_BOSS_64h_Male_Goblin_EmoteResponse_01	J’adore quand le public participe.	
VO_GILA_BOSS_64h_Male_Goblin_EvenPlayCursedCurio_01	Superbe_! Où l’avez-vous trouvé_?	
VO_GILA_BOSS_64h_Male_Goblin_EventMCTech_01	Hé oh. C’est à moi, ça_!	
VO_GILA_BOSS_64h_Male_Goblin_EventMindControl_01	Vous essayez de me battre à mon propre jeu_?	
VO_GILA_BOSS_64h_Male_Goblin_HeroPowerHandBig_01	Vous avez sommeil.	
VO_GILA_BOSS_64h_Male_Goblin_HeroPowerHandBig_03	Vos paupières sont lourdes, vous avez du mal à garder les yeux ouverts_!	
VO_GILA_BOSS_64h_Male_Goblin_HeroPowerHandEmpty_01	Zzzz… Zzzz…	
VO_GILA_BOSS_64h_Male_Goblin_HeroPowerHandMedium_01	Regardez-moi dans les yeux.	
VO_GILA_BOSS_64h_Male_Goblin_HeroPowerHandMedium_02	Suivez ma montre des yeux… Euh… Que disait le manuel, ensuite_?	
VO_GILA_BOSS_64h_Male_Goblin_HeroPowerHandMedium_03	À droite, à gauche, à droite, à gauche. Regardez-la se balancer_!	
VO_GILA_BOSS_64h_Male_Goblin_HeroPowerHandSmall_01	Je faisais quoi déjà_?	
VO_GILA_BOSS_64h_Male_Goblin_HeroPowerHandSmall_02	Vous êtes… fatigué.	
VO_GILA_BOSS_64h_Male_Goblin_Intro_01	Oh_! Un volontaire_?	
VO_GILA_BOSS_66h_Female_Undead_DefeatPlayer_01	…	
VO_GILA_BOSS_66h_Female_Undead_EmoteResponse_02	…	
VO_GILA_BOSS_66h_Female_Undead_EventPlayHorn_02	…	
VO_GILA_BOSS_66h_Female_Undead_HeroPower_01	…	
VO_GILA_BOSS_66h_Female_Undead_HeroPower_02	…	
VO_GILA_BOSS_66h_Female_Undead_HeroPower_03	…	
VO_GILA_BOSS_66h_Female_Undead_Intro_01	…	
VO_GILA_BOSS_67h_Male_Undead_DefeatPlayer_01	Les rats quittent le navire.	
VO_GILA_BOSS_67h_Male_Undead_EmoteResponse_01	Je ne veux plus vous entendre couiner_!	
VO_GILA_BOSS_67h_Male_Undead_EventPlayRat_01	Les rats font d’excellentes mascottes. Surtout en ragoût_!	
VO_GILA_BOSS_67h_Male_Undead_EventPlayRat_02	De petites créatures inoffensives. Tout comme vous.	
VO_GILA_BOSS_67h_Male_Undead_EventPlayRat_03	Attention, ces morsures ne sont pas des preuves d’affection.	
VO_GILA_BOSS_67h_Male_Undead_EventPlayRatTrap_01	Une caisse_? Un morceau de bois_? Vous manquez vraiment de subtilité_!	
VO_GILA_BOSS_67h_Male_Undead_Intro_01	Je vous tiens_! J’ai toujours eu du nez pour attraper les rats.	
VO_GILA_BOSS_68h_Male_Undead_DefeatPlayer_01	Bravo_! Vous avez résisté longtemps. Vous ferez un excellent cas d’étude.	
VO_GILA_BOSS_68h_Male_Undead_EmoteResponse_01	Savez-vous à quel point il est difficile de contrôler une épidémie_?	
VO_GILA_BOSS_68h_Male_Undead_EventPlayPoison_01	Vous m’avez devancé.	
VO_GILA_BOSS_68h_Male_Undead_EventPlayPoison_02	Oh, du poison_!	
VO_GILA_BOSS_68h_Male_Undead_EventPlayPoison_03	J’adore votre façon de penser.	
VO_GILA_BOSS_68h_Male_Undead_EventPlayPoison_04	Je peux vous emprunter ça_? Juste un instant.	
VO_GILA_BOSS_68h_Male_Undead_Intro_01	Sortez vos morts_! J’en ai besoin.	
VO_HeadlessHorseman_Male_Human_HallowsEve_01	C'est ici que je suis, corps sot et ahuri_!	
VO_HeadlessHorseman_Male_Human_HallowsEve_02	Misérable bélître, objet de mon mépris, finissez ce chapitre… dans les flammes en furie_!	
VO_HeadlessHorseman_Male_Human_HallowsEve_04	Le ciel se vêt de noir, et le feu a grand-faim. Vous luttez sans espoir, car file le destin.	
VO_HeadlessHorseman_Male_Human_HallowsEve_07	Mes flammes ont décliné, plus un reflet n’y court_! Je vais vous dérober votre vie, votre jour_!	
VO_HeadlessHorseman_Male_Human_HallowsEve_08	Pour que coule mon sang, vous luttez sans faillir. C’est ma tête pourtant, qu’il vous faudra occire.	
VO_HeadlessHorseman_Male_Human_HallowsEve_10	HAHAHAHAHHA AHAHAAAAAA_!	
VO_HeadlessHorseman_Male_Human_HallowsEve_11	AAAAAHAHAHA HAHHAAHAH_!	
VO_HeadlessHorseman_Male_Human_HallowsEve_12	Ne soyez pas surpris, le tocsin a sonné_! Mettez bien à l’abri infirmes, vieillards, et bébés_!	
VO_HeadlessHorseman_Male_Human_HallowsEve_13	Chacun aura le prix en entier à payer. Implorez ma merci, à l’heure du jugement_!	
VO_HeadlessHorseman_Male_Human_HallowsEve_17	HAHAHAHAahaha…	
VO_HRW_DEBUG_01	1	
VO_HRW_DEBUG_02	2	
VO_HRW_DEBUG_03	3	
VO_HRW_DEBUG_04	4	
VO_HRW_DEBUG_05	5	
VO_HRW_TEST_00	Je vous libère tous les deux de la malédiction de la chair !	
VO_HRW_TEST_01	Bien joué ! Vous avez vaincu le boss ensemble.\nLes deux joueurs sont victorieux !	
VO_HRW_TEST_02	Battez ensemble le maître des rouages Mécazod pour gagner !	
VO_HRW_TEST_ABILITY_00	Inflige des dégâts à un héros.	
VO_HRW_TEST_ABILITY_01	Détruit le serviteur avec l’ATQ la plus haute.	
VO_HRW_TEST_ABILITY_02	Lance 3 bombes.	
VO_HRW_TEST_ABILITY_03	Inflige des dégâts à tous les autres personnages.	
VO_HRW_TEST_ABILITY_04	Gagne +2 ATQ.	
VO_HRW_TEST_ABILITY_05	Inflige des dégâts aux deux héros.	
VO_HRW_TEST_ABILITY_06	Réduit durablement au silence le chroniqueur Cho.	
VO_HRW_TEST_ABILITY_98	Plateau ciblé plein. Vidage en cours.	
VO_ICC_841_Female_Sanlayn_Death_02	Mais tout allait si bien entre nous_!	
VO_ICC01_Jaina_Female_Human_DrawsRager_01	C’est une plaisanterie_?!	
VO_ICC01_Jaina_Female_Human_JainaDKIntro_05	J’entends les murmures… des morts…	
VO_ICC01_Jaina_Female_Human_PostDeath_02	Nous devons… résister…	
VO_ICC01_LichKing_Male_Human_EmoteResponse_01	Vos supplications sonnent creux.	
VO_ICC01_LichKing_Male_Human_EndOfTurn2_01	Ha ha ha, ÇA c’est de l’entrée en matière_!	
VO_ICC01_LichKing_Male_Human_EndOfTurn2_02	Et ce n’est même pas mon deck le plus agressif.	
VO_ICC01_LichKing_Male_Human_Idle_01	Allez-y, terminez votre tour, que j’en finisse avec vous_!	
VO_ICC01_LichKing_Male_Human_Intro_01	Choisissez bien vos cartes car ce sont les dernières que vous piocherez.	
VO_ICC01_LichKing_Male_Human_JainaDKIntro_01	Relève-toi, mage. Ton travail n’est pas terminé.	
VO_ICC01_LichKing_Male_Human_JainaDKIntro_02	Rejoins-moi. Les vivants trembleront devant toi et les morts t’obéiront.	
VO_ICC01_LichKing_Male_Human_JainaDKIntro_03	Tes ennemis te craindront plus que la mort elle-même…	
VO_ICC01_LichKing_Male_Human_JainaDKintro_06	Maintenant, championne, débarrasse-moi de cette vermine.	
VO_ICC01_LichKing_Male_Human_PlaysFrostmourne_01	Votre classement va souffrir.	
VO_ICC01_LichKing_Male_Human_Turn1_01	Mes cartes sont tellement puissantes…	
VO_ICC01_LichKing_Male_Human_Turn11_01	Mes hordes de morts-vivants sont à tes ordres.	
VO_ICC01_LichKing_Male_Human_Turn13_01	Fais-les souffrir.	
VO_ICC01_LichKing_Male_Human_Turn15_01	La pitié, c’est pour les faibles.	
VO_ICC01_LichKing_Male_Human_Turn2_02	Contemplez ma puissance.	
VO_ICC01_LichKing_Male_Human_Turn4_01	Personne ne peut vous sauver.	
VO_ICC01_LichKing_Male_Human_Turn4_02	Mon pouvoir est absolu.	
VO_ICC01_LichKing_Male_Human_Turn5_01	Nul ne peut me résister.	
VO_ICC01_LichKing_Male_Human_Turn5_02	Vous aussi, vous me servirez.	
VO_ICC01_Tirion_Male_Human_AFKay_01	Soyez vigilant_!	
VO_ICC01_Tirion_Male_Human_EmoteResponse_02	Je ne vous reconnais plus_!	
VO_ICC01_Tirion_Male_Human_EndOfTurn4_01	Allez_! Tenez bon_!	
VO_ICC01_Tirion_Male_Human_EndOfTurn4_02	Je suis convaincu que la providence vous fournira l’aide dont vous avez grandement besoin.	
VO_ICC01_Tirion_Male_Human_EndOfTurn4_03	Ayez confiance, la providence vous aidera en ces heures difficiles.	
VO_ICC01_Tirion_Male_Human_Flavor01_01	Il va me falloir des aventuriers plus doués…	
VO_ICC01_Tirion_Male_Human_Flavor02_01	Jaina, vous êtes devenue un monstre_!	
VO_ICC01_Tirion_Male_Human_Flavor03_01	Le roi-liche paiera pour cette atrocité_!	
VO_ICC01_Tirion_Male_Human_JainaDKintro_05	Qu’est-ce que c’est…_? Qu’êtes-vous devenue_?!	
VO_ICC01_Tirion_Male_Human_PauseDeath_02	[x]Arrêtez !	
VO_ICC01_Tirion_Male_Human_PostDeath_01	Votre volonté vous appartient. Résistez à l’appel du roi-liche_!	
VO_ICC01_Tirion_Male_Human_TerribleTank_01	Qu’attendez-vous pour les provoquer_?	
VO_ICC01_Tirion_Male_Human_Turn2_01	N’ayez crainte_! Nous arrivons.	
VO_ICC01_Tirion_Male_Human_Turn3_01	Nous sommes presque là_! Comment ça se passe_? Bien_?	
VO_ICC01_Tirion_Male_Human_Turn6_01	Nous sommes quasiment…	
VO_ICC01_Tirion_Male_Human_Turn6_02	[x]Quoi ?!	
VO_ICC01_Tirion_Male_Human_Turn8_01	Vous affrontez les meilleurs aventuriers d’Azeroth_!	
VO_ICC04_LichKing_Male_Human_BreathNoMinion_01	Quoi, aucun serviteur à geler_? Sindragosa va être déçue.	
VO_ICC04_LichKing_Male_Human_Lose_01	Vos restes gelés serviront d’avertissement aux autres…	
VO_ICC04_LichKing_Male_Human_Turn5_01	Vous vous demandez peut-être comment vous débarrasser de ces blocs de glace_?	
VO_ICC04_LichKing_Male_Human_Turn5_02	La réponse est simple_: vous ne pouvez pas_!	
VO_ICC04_LichKing_Male_Human_Win_02	TOUT CE DECK DOIT ÊTRE NETTOYÉ_!	
VO_ICC04_Sindragosa_Female_Dragon_Bounce_01	Rendez-le-moi_!	
VO_ICC04_Sindragosa_Female_Dragon_BreathNoRoomLeft_01	Vous n’avez plus de serviteurs derrière lesquels vous cacher.	
VO_ICC04_Sindragosa_Female_Dragon_Death_01	Graooooor !	
VO_ICC04_Sindragosa_Female_Dragon_EmoteResponse_01	Ce petit jeu me fatigue_!	
VO_ICC04_Sindragosa_Female_Dragon_Intro_01	Qu’il est stupide d’être venu ici_!	
VO_ICC04_Sindragosa_Female_Dragon_LichKing_01	J’ai été trahie_!	
VO_ICC04_Sindragosa_Female_Dragon_Malygos_01	Malygos… Mon ancien amour_!	
VO_ICC04_Sindragosa_Female_Dragon_PlayerPlaysMinion_02	Choisissez bien vos victimes. Car la main glacée de la mort vous emportera tous.	
VO_ICC04_Sindragosa_Female_Dragon_SecondBreath_01	Sentez le pouvoir infini de mon maître, et désespérez_!	
VO_ICC04_Sindragosa_Female_Dragon_Sindragosa_01	Notre pitoyable magie nous trahit_!	
VO_ICC04_Sindragosa_Female_Dragon_Sindragosa_02	Notre pitoyable magie nous trahit_!	
VO_ICC04_Sindragosa_Female_Dragon_TransformDK_01	Je ne sers qu’un maître_!	
VO_ICC04_Sindragosa_Female_Dragon_UnchainedMagic_02	Votre pitoyable magie vous trahit_!	
VO_ICC04_Sindragosa_Female_Dragon_UnchainedMagic_04	[x]Souffrez !	
VO_ICC05_Lanathel_Female_Sanlayn_BiteOoze_01	Ohhh, comment pouvez-vous poser votre BOUCHE sur ça_?	
VO_ICC05_Lanathel_Female_Sanlayn_BitePoisonous_01	N’oubliez pas de recracher le poison quand vous aurez fini.	
VO_ICC05_Lanathel_Female_Sanlayn_BiteReminder_01	Vous n’oubliez pas quelque chose_? Cette soif qui brûle dans vos veines_!	
VO_ICC05_Lanathel_Female_Sanlayn_BiteReminderAcolyte_01	N’hésitez pas. Nourrissez-vous_! Nourrissez-vous des endormis_!	
VO_ICC05_Lanathel_Female_Sanlayn_BiteShell_01	N’allez pas vous casser une dent.	
VO_ICC05_Lanathel_Female_Sanlayn_BiteSpikes_01	Mordre là-dedans, ça doit faire mal.	
VO_ICC05_Lanathel_Female_Sanlayn_BloodEssence_01	Il commence à y avoir un peu trop de monde, par ici.	
VO_ICC05_Lanathel_Female_Sanlayn_BloodEssence_02	Vous ne comptiez pas vous en servir, n’est-ce pas_?	
VO_ICC05_Lanathel_Female_Sanlayn_BloodEssence_03	Et si on variait les plaisirs, hmm_?	
VO_ICC05_Lanathel_Female_Sanlayn_BloodPrince_01	Traître_! Rentrez vos crocs_!	
VO_ICC05_Lanathel_Female_Sanlayn_BossBite_01	Voyez ma soif_!	
VO_ICC05_Lanathel_Female_Sanlayn_EmoteResponse_01	Est-ce que… vous me draguez_?	
VO_ICC05_Lanathel_Female_Sanlayn_Intro_01	Ce n'est pas une décision… très sage.	
VO_ICC05_Lanathel_Female_Sanlayn_LichKing_01	[x]Vous… !	
VO_ICC05_Lanathel_Female_Sanlayn_PlayerBiteAcolyte_01	Oh, quelle délicieuse ironie_!	
VO_ICC05_Lanathel_Female_Sanlayn_PlayerBloodBite_01	Vous arrivez trop tard. Je suis déjà perdue_!	
VO_ICC05_Lanathel_Female_Sanlayn_TransformDK_01	Oh, je savais que vous alliez me plaire.	
VO_ICC05_Lanathel_Female_Sanlayn_Turn3_01	Pourquoi ne pas vous nourrir d’un de MES serviteurs_?	
VO_ICC05_Lanathel_Female_Sanlayn_Turn3_02	Ils sont endormis… délicieux… et bien juteux_!	
VO_ICC05_Lanathel_Female_Sanlayn_Wounded_01	Vraiment_? Et c’est tout_?	
VO_ICC05_LichKing_Male_Human_BossBite_02	Ah oui, la fameuse morsure des San’layn.	
VO_ICC05_LichKing_Male_Human_BossBite_03	Attention à cette faim dévorante. Vous devez vous nourrir à chaque tour_!	
VO_ICC05_LichKing_Male_Human_LichKing_02	Ce boss mord.	
VO_ICC05_LichKing_Male_Human_Lose_01	Vous hésitez à mordre vos serviteurs_? Allons, un peu de sang-froid_!	
VO_ICC05_LichKing_Male_Human_Win_01	Lana’thel… À ce rang, vous ne pouvez pas perdre d’étoiles. Une chance pour vous.	
VO_ICC06_LichKing_Male_Human_LichKing_02	N’y voyez rien de personnel, Gargamoelle.	
VO_ICC06_LichKing_Male_Human_Win_01	Je vais devoir créer un NOUVEL amalgame d’os. Pourquoi pas doré_?	
VO_ICC06_Marrowgar_Male_BoneWraith_Alexstraza_01	Elle m’a léché, cette dragonne m’a léché_!	
VO_ICC06_Marrowgar_Male_BoneWraith_AncientOne_01	Je ne regrette RIEN_!	
VO_ICC06_Marrowgar_Male_BoneWraith_AuchenaiSoulpriest_01	Hah hah, j’ai votre prêtresse. Une minute. Non. Va-t’en_! Ouste_!	
VO_ICC06_Marrowgar_Male_BoneWraith_BigHeal_01	La mort est éternelle, impitoyable…	
VO_ICC06_Marrowgar_Male_BoneWraith_Bonespike_01	La seule issue est la mort_!	
VO_ICC06_Marrowgar_Male_BoneWraith_Bonespike_02	Le maître vous aura.	
VO_ICC06_Marrowgar_Male_BoneWraith_Bonespike_03	Sous ma caresse, la chair et les muscles disparaissent.	
VO_ICC06_Marrowgar_Male_BoneWraith_Bonespike_04	C’est l’heure de la moisson.	
VO_ICC06_Marrowgar_Male_BoneWraith_Bonespike_05	Si dangereux. Mais tellement délicieux_!	
VO_ICC06_Marrowgar_Male_BoneWraith_BonespikePlayerHit_01	Argh_! La rage du maître coule dans mes veines_!	
VO_ICC06_Marrowgar_Male_BoneWraith_BonespikeStolen_01	Argh_! Espèce de… voleur d’os_!	
VO_ICC06_Marrowgar_Male_BoneWraith_Bonestorm_01	Tempête d’os_!	
VO_ICC06_Marrowgar_Male_BoneWraith_Bonestorm_02	Tempête d’ooooosss_!	
VO_ICC06_Marrowgar_Male_BoneWraith_Bonestorm_03	Tempête d’ooooosss_!	
VO_ICC06_Marrowgar_Male_BoneWraith_Bonestorm_04	Tempête d’ooooosss_!	
VO_ICC06_Marrowgar_Male_BoneWraith_Bonestorm_05	TEMPÊÊÊTE D’OOOOSSS_!	
VO_ICC06_Marrowgar_Male_BoneWraith_BonestormFast_01	Tempête d’os.	
VO_ICC06_Marrowgar_Male_BoneWraith_Death_01	Des cendres aux cendres…	
VO_ICC06_Marrowgar_Male_BoneWraith_DKTransform_01	Oui. Embrassez votre destin, répondez à l’appel du maître_!	
VO_ICC06_Marrowgar_Male_BoneWraith_EmoteResponse_01	Imbécile, je n’ai pas d’oreilles_! Ha ha ha ha ha_!	
VO_ICC06_Marrowgar_Male_BoneWraith_Idle_01	Hmmmm…	
VO_ICC06_Marrowgar_Male_BoneWraith_Intro_01	Personne ne pénètre dans le sanctuaire du maître_!	
VO_ICC06_Marrowgar_Male_BoneWraith_LichKing_01	… Maître_?	
VO_ICC06_Marrowgar_Male_BoneWraith_Skeleton_01	Quoi de neuf, mon petit nonos_? Hmm_?	
VO_ICC07_LichKing_Male_Human_LichKing_02	Je suis un homme de terrain.	
VO_ICC07_LichKing_Male_Human_Lose_01	Putricide, ton deck est parfaitement dégoûtant. Je t’ai sous-estimé.	
VO_ICC07_LichKing_Male_Human_Win_02	Putricide, c’était pitoyable. Ta place est dans un deck de chasseur, pas dans ma citadelle.	
VO_ICC07_Putricide_Male_Undead_Aviana_01	Votre science est meilleure que la mienne_!	
VO_ICC07_Putricide_Male_Undead_CloakedHuntress_01	Eh bien, ça me semble superflu.	
VO_ICC07_Putricide_Male_Undead_Death_01	Mauvaise nouvelle, mes amis…	
VO_ICC07_Putricide_Male_Undead_EaglehornBow_01	J’en veux un tout pareil_!	
VO_ICC07_Putricide_Male_Undead_EaterOfSecrets_01	Non_! Mes secrets_! L’œuvre de toute une vie_!	
VO_ICC07_Putricide_Male_Undead_EmoteResponse_01	Ce n’est pas très gentil.	
VO_ICC07_Putricide_Male_Undead_EquipWeapon_01	Houlàlà.	
VO_ICC07_Putricide_Male_Undead_EquipWeapon_02	Je ne me rappelais même pas que j’avais ÇA.	
VO_ICC07_Putricide_Male_Undead_EquipWeapon_03	Oui, ça fera l’affaire.	
VO_ICC07_Putricide_Male_Undead_EquipWeapon_04	Mais d’où ça sort_?	
VO_ICC07_Putricide_Male_Undead_EquipWeapon_05	Si dangereux. Mais tellement délicieux_!	
VO_ICC07_Putricide_Male_Undead_EtherealArcanist_01	Ne faites jamais confiance à un éthérien. Ils n’ont pas de visage_!	
VO_ICC07_Putricide_Male_Undead_FestergutDeath_01	Oh, Pulentraille, tu as toujours été mon préféré… après Trognepus.	
VO_ICC07_Putricide_Male_Undead_Intro_02	Grande nouvelle, mes amis_! J’ai réparé le distributeur de poison.	
VO_ICC07_Putricide_Male_Undead_LichKing_01	Ça alors, je ne m’attendais pas à vous voir ici.	
VO_ICC07_Putricide_Male_Undead_MysteriousChallenger_01	Personne n’est plus mystérieux que moi_!	
VO_ICC07_Putricide_Male_Undead_Ooze_01	Oh, un limon_!	
VO_ICC07_Putricide_Male_Undead_PhaseTransition_01	Des tentacules_! Oh là là, on dirait qu’ils ont leur propre volonté_!	
VO_ICC07_Putricide_Male_Undead_PhaseTransition_03	Hmmm, intéressant.	
VO_ICC07_Putricide_Male_Undead_Putricide_02	Quoi_? Mais ce gars là, c’est moi_!	
VO_ICC07_Putricide_Male_Undead_Putricide_03	Bonne nouvelle… moi_!	
VO_ICC07_Putricide_Male_Undead_Putricide_04	Ce n’est pas du tout une bonne nouvelle, sale double plein de tentacules_!	
VO_ICC07_Putricide_Male_Undead_Rotface_01	Trognepus_! Comment as-tu pu_?!	
VO_ICC07_Putricide_Male_Undead_RotfaceDeath_01	Non, pas Trognepus_! Mais qu’est-ce qu’il vous a fait_?!	
VO_ICC07_Putricide_Male_Undead_Scientist_01	Est-ce que vous avez débauché mon personnel_?	
VO_ICC07_Putricide_Male_Undead_Slime_01	Merveilleuse nouvelle, mes amis_! La gelée coule à flots_!	
VO_ICC07_Putricide_Male_Undead_TentaclesForArms_01	Cette arme est vraiment des plus chics.	
VO_ICC07_Putricide_Male_Undead_TransformDK_01	Mais que…_? Vous venez pas de changer de coiffure_?	
VO_ICC07_Rotface_Male_Abomination_Rotface_02	Trognepus a BESOINS.	
VO_ICC08_Anduin_Male_Human_Muted_02	[x]Mmpphh !	
VO_ICC08_Anduin_Male_Human_Muted_03	[x]Mmpphh ?	
VO_ICC08_Anduin_Male_Human_Muted_06	[x]Mmpphh !	
VO_ICC08_Anduin_Male_Human_Muted_07	[x]Mmpphhhhhh… !	
VO_ICC08_Anduin_Male_Human_Muted_11	Mmpphh…	
VO_ICC08_Anduin_Male_Human_Muted_13	Mmpphh…	
VO_ICC08_Anduin_Male_Human_WinA_01	Le monde a besoin…	
VO_ICC08_Anduin_Male_Human_WinB_01	… d’un roi-liche_!	
VO_ICC08_Garrosh_Male_Orc_WinA_01	Le monde a besoin…	
VO_ICC08_Garrosh_Male_Orc_WinB_01	… d’un roi-liche_!	
VO_ICC08_Guldan_Male_Orc_WinA_01	Le monde a besoin…	
VO_ICC08_Guldan_Male_Orc_WinB_01	… d’un roi-liche_!	
VO_ICC08_Jaina_Female_Human_WinA_01	Le monde a besoin…	
VO_ICC08_Jaina_Female_Human_WinB_01	… d’un roi-liche_!	
VO_ICC08_LichKing_Male_Human_Archmage Antonidas_01	Je t’ai déjà tué une fois, vieillard, et je le referai sans hésitation.	
VO_ICC08_LichKing_Male_Human_Arfas_01	Méchant chien_!	
VO_ICC08_LichKing_Male_Human_Bolvar_01	Briser celui-là n’est pas de tout repos.	
VO_ICC08_LichKing_Male_Human_Death_01	Je ne vois… que les ténèbres qui m’entourent…	
VO_ICC08_LichKing_Male_Human_DeathPunisher_01	C’était un coup bas.	
VO_ICC08_LichKing_Male_Human_EmoteResponse_01	Nul ne peut me donner d’ordres_!	
VO_ICC08_LichKing_Male_Human_EndOfTurn4_01	Aucune carte ne saurait empêcher mon inévitable triomphe.	
VO_ICC08_LichKing_Male_Human_Frostmourne_01	Deuillegivre a faim…	
VO_ICC08_LichKing_Male_Human_Frostmourne_02	Deuillegivre a faim… Vous vouliez quelque chose_?	
VO_ICC08_LichKing_Male_Human_Frostmourne_07	Contemplez la puissance de Deuillegivre.	
VO_ICC08_LichKing_Male_Human_GenericStart_03	Je mettrai votre deck en pièces, puis je briserai… VOTRE ÂME_!	
VO_ICC08_LichKing_Male_Human_Horsemen_01	Imaginez votre honte si je parviens à m’emparer des quatre.	
VO_ICC08_LichKing_Male_Human_Hunter_01	Pauvre chasseur. Sans vos bêtes, que vous reste-t-il à m’opposer_?	
VO_ICC08_LichKing_Male_Human_Illidan_01	Le trône de glace est mien, démon. Écarte-toi.	
VO_ICC08_LichKing_Male_Human_IndestructableWeapon_01	Quelle tentative pitoyable.	
VO_ICC08_LichKing_Male_Human_Intro_01	Votre souffrance sera légendaire. Contrairement à votre rang.	
VO_ICC08_LichKing_Male_Human_Intro_02	À la fin, vous me servirez tous.	
VO_ICC08_LichKing_Male_Human_Intro_03	Vous osez appeler ce misérable tas de cartes un deck_?	
VO_ICC08_LichKing_Male_Human_Intro_04	Je suis l’alpha et l’oméga, JE SUIS LE NOUVEAU MÉTA.	
VO_ICC08_LichKing_Male_Human_Intro_06	Vous croyez que j’aurai pitié de vous_?	
VO_ICC08_LichKing_Male_Human_Intro_07	C’est votre deck, ça_? On dirait plutôt un appel à l’aide.	
VO_ICC08_LichKing_Male_Human_Intro_08	Vos cris d’agonie seront un hymne à mon talent légendaire.	
VO_ICC08_LichKing_Male_Human_Intro_09	Est-ce vraiment la justice qui\nvous anime_? Je me demande…	
VO_ICC08_LichKing_Male_Human_Kelthuzad_01	Kel’thuzad_! Tu t’es trompé d’aventure_!	
VO_ICC08_LichKing_Male_Human_Lanathel_01	Ta trahison ne me surprend pas, Lana’thel.	
VO_ICC08_LichKing_Male_Human_LichKing_01	Hé, bonjour beau gosse.	
VO_ICC08_LichKing_Male_Human_LichKing_02	J’ai la classe.	
VO_ICC08_LichKing_Male_Human_LichKingMuted_01	Une minute, vous ne pouvez pas…	
VO_ICC08_LichKing_Male_Human_LichKingMutedResponse_01	Mmmph.	
VO_ICC08_LichKing_Male_Human_LichKingMutedResponse_02	Mppmph mmmphm_!	
VO_ICC08_LichKing_Male_Human_LichKingMutedResponse_03	[x]MphMPH !	
VO_ICC08_LichKing_Male_Human_LichKingMutedResponse_04	Mpphmmm…	
VO_ICC08_LichKing_Male_Human_LilLich_01	Je… Je l’adore.	
VO_ICC08_LichKing_Male_Human_Lose_03	Rejoignez-moi dans les ténèbres…	
VO_ICC08_LichKing_Male_Human_Mage_01	Mage_! Moi seul peux maîtriser le frisson glacial de la mort_!	
VO_ICC08_LichKing_Male_Human_MageSpellReflect_01	Comment les testeurs ont-ils pu laisser passer ça_?	
VO_ICC08_LichKing_Male_Human_MageSpellReflect_02	C’est de la folie_! Mais qui teste ces aventures_?	
VO_ICC08_LichKing_Male_Human_Mograine_01	Mograine_! Je n’arrive plus à suivre, tu es avec les bons ou les méchants_?	
VO_ICC08_LichKing_Male_Human_MutedResponse_01	[x]Silence !	
VO_ICC08_LichKing_Male_Human_MutedResponse_02	[x]Chut !	
VO_ICC08_LichKing_Male_Human_MutedResponse_03	[x]Chuuuuuuut !	
VO_ICC08_LichKing_Male_Human_MutedResponse_04	Zipez-la.	
VO_ICC08_LichKing_Male_Human_MutedResponse_05	Maintenant, zipez-la.	
VO_ICC08_LichKing_Male_Human_MutedResponse_06	Ziiiip.	
VO_ICC08_LichKing_Male_Human_Paladin_01	La Lumière ne vous protégera pas ici, paladin. Rien ne vous protégera…	
VO_ICC08_LichKing_Male_Human_Phase03_01	Rencontrez votre tragique fin.	
VO_ICC08_LichKing_Male_Human_PhaseTransition_02	Quelqu’un a-t-il touché à mon arme_?	
VO_ICC08_LichKing_Male_Human_PowerReplace_01	Vous ne vous débarrasserez pas aussi facilement de mon pouvoir.	
VO_ICC08_LichKing_Male_Human_Priest_01	Silence, prêtre_! La Lumière ne vous sera d’aucun secours.	
VO_ICC08_LichKing_Male_Human_Putricide_01	Au fond, je n’ai jamais pu te supporter.	
VO_ICC08_LichKing_Male_Human_Rogue_01	Cessez de vous cacher, voleur. Je connais toutes vos ficelles_!	
VO_ICC08_LichKing_Male_Human_Shaman_01	Vos serviteurs tremblent de terreur devant ma puissance, chaman_!	
VO_ICC08_LichKing_Male_Human_Sindragosa_01	Je comptais m’en servir pour vous finir_! Rendez-la-moi_!	
VO_ICC08_LichKing_Male_Human_Sylvanas_01	Après ce que vous m’avez fait subir, je ne suis pas disposé à vous laisser en paix.	
VO_ICC08_LichKing_Male_Human_Tirion_01	Je vais te laisser en vie, que tu sois témoin de la fin, Fordring.	
VO_ICC08_LichKing_Male_Human_TransformDK_01	Oui… Ne faites qu’un avec votre nouveau pouvoir… J’ai déjà gagné…	
VO_ICC08_LichKing_Male_Human_Turn6_01	Je n’avais jamais vu un tour aussi pitoyable. Pourtant, vous en avez joué de bien médiocres.	
VO_ICC08_LichKing_Male_Human_Turn6_03	Vous jouez vos cartes comme mon père dirigeait son royaume. Avec faiblesse.	
VO_ICC08_LichKing_Male_Human_Turn6_04	Comment pouvez-vous jouer de telles cartes sans éprouver de honte_?	
VO_ICC08_LichKing_Male_Human_Turn6_05	Chacune des cartes que vous jouez vous rapproche de votre perdition.	
VO_ICC08_LichKing_Male_Human_Turn6_06	Votre échec est inévitable et aucune emote ne vous suffira à exprimer votre honte.	
VO_ICC08_LichKing_Male_Human_Turn6_07	Qui a construit ce deck pour vous_?	
VO_ICC08_LichKing_Male_Human_Turn6_08	Qui croyiez-vous affronter_? Lardeur_?	
VO_ICC08_LichKing_Male_Human_Warlock_01	Démoniste, défaites-vous de votre pitoyable main. Les terreurs que vous commandez ME serviront bientôt.	
VO_ICC08_LichKing_Male_Human_Warrior_01	Guerrier. Vous ferez un merveilleux chevalier de la mort quand je vous aurai brisé.	
VO_ICC08_LichKing_Male_Human_Wounded_01	L’espoir faiblit…	
VO_ICC08_LichKing_Male_Human_Wounded_02	Impossible… IMPOSSIBLE_!	
VO_ICC08_LichKing_Male_Human_YoungArthas_01	Qu’est-ce que c’est_? Une réinterprétation dramatique de mon tourment intérieur_?	
VO_ICC08_Malfurion_Male_NightElf_WinA_01	Le monde a besoin…	
VO_ICC08_Malfurion_Male_NightElf_WinB_01	… d’un roi-liche…	
VO_ICC08_Rexxar_Male_Orc_WinA_01	Le monde a besoin…	
VO_ICC08_Rexxar_Male_Orc_WinB_01	… d’un roi-liche…	
VO_ICC08_Thrall_Male_Orc_WinA_01	Le monde a besoin…	
VO_ICC08_Thrall_Male_Orc_WinB_01	… d’un roi-liche…	
VO_ICC08_Tirion_Male_Human_Win_01	Vous avez réussi, champion_!	
VO_ICC08_Tirion_Male_Human_Win_02	Maintenant que le roi-liche est mort, le Fléau déchaîné va devenir une menace encore plus grande pour ce monde.	
VO_ICC08_Uther_Male_Human_WinA_01	Le monde a besoin…	
VO_ICC08_Uther_Male_Human_WinB_01	… d’un roi-liche_!	
VO_ICC08_Valeera_Female_Human_WinA_01	Le monde a besoin…	
VO_ICC08_Valeera_Female_Human_WinB_01	… d’un roi-liche…	
VO_ICC09_LichKing_Male_Human_LichKing_02	Ne vous inquiétez pas, je ne peux pas vous attaquer.	
VO_ICC09_LichKing_Male_Human_Lose_01	Vous n’avez pas choisi les bonnes armes.	
VO_ICC09_LichKing_Male_Human_Win_01	C’était ma carte légendaire préférée_! Et dire que je vais devoir la convertir en poussière pour en créer une meilleure.	
VO_ICC09_Saurfang_Male_Orc_AttackedByPlayer_01	Faites de votre pire_!	
VO_ICC09_Saurfang_Male_Orc_AttacksPlayer_01	Affrontez la puissance du Fléau_!	
VO_ICC09_Saurfang_Male_Orc_AttacksPlayer_02	Je deviens la mort_!	
VO_ICC09_Saurfang_Male_Orc_AttacksPlayer_03	Le roi-liche s’emparera de tout.	
VO_ICC09_Saurfang_Male_Orc_AttacksPlayer_04	Combattez_! Mourez_! Votre destin est scellé.	
VO_ICC09_Saurfang_Male_Orc_BloodBeast_01	Repaissez-vous, mes serviteurs_!	
VO_ICC09_Saurfang_Male_Orc_BloodBeast_02	Dévorez-les…	
VO_ICC09_Saurfang_Male_Orc_BloodBeast_03	Ma puissance ne fait que croître.	
VO_ICC09_Saurfang_Male_Orc_BloodBeast_04	Ma rage s’incarne_!	
VO_ICC09_Saurfang_Male_Orc_BloodBeastStolen_01	Gardez-la. Vous ne vous débarrasserez plus jamais de l’odeur.	
VO_ICC09_Saurfang_Male_Orc_CursedBlade_01	C’était l’idée de qui, ça_?	
VO_ICC09_Saurfang_Male_Orc_Death_01	Je suis… libre…	
VO_ICC09_Saurfang_Male_Orc_DKTransform_01	Enfin_! Un adversaire convenable_!	
VO_ICC09_Saurfang_Male_Orc_Doomerang_01	Hmm… C’est une arme comme ça qu’il me faut…	
VO_ICC09_Saurfang_Male_Orc_EmoteResponse_01	Poltron pleurnichard.	
VO_ICC09_Saurfang_Male_Orc_EquipWeapon_01	Par la puissance du roi-liche_!	
VO_ICC09_Saurfang_Male_Orc_EquipWeapon_02	Impressionnant.	
VO_ICC09_Saurfang_Male_Orc_Intro_01	Venez affronter la puissance du Fléau_!	
VO_ICC09_Saurfang_Male_Orc_LichKing_01	Que faites-VOUS ici_?	
VO_ICC09_Saurfang_Male_Orc_WeaponDestroyed_01	[x]Groar !	
VO_ICC10_Deathwhisper_Female_Lich_DamageByValithria_01	Argh…	
VO_ICC10_Deathwhisper_Female_Lich_Death_01	[x]Impossible… !	
VO_ICC10_Deathwhisper_Female_Lich_DKTransform_01	Ah_! Vous avez aussi goûté au pouvoir du maître…	
VO_ICC10_Deathwhisper_Female_Lich_EmoteResponse_01	Ohhh, c’était une menace_?	
VO_ICC10_Deathwhisper_Female_Lich_Equality_01	Ce n’est pas une aussi bonne idée que vous le pensez.	
VO_ICC10_Deathwhisper_Female_Lich_HeroPower_01	Les vivants sont tellement faibles…	
VO_ICC10_Deathwhisper_Female_Lich_HeroPower_02	Votre chair est une malédiction…	
VO_ICC10_Deathwhisper_Female_Lich_HeroPower_03	Saisissez-vous la futilité de vos actes_?	
VO_ICC10_Deathwhisper_Female_Lich_HeroPower_04	Les ténèbres vous étreignent…	
VO_ICC10_Deathwhisper_Female_Lich_HeroPowerInitial_01	La mort vous appelle…	
VO_ICC10_Deathwhisper_Female_Lich_Intro_01	Quelle est cette perturbation_? Mon travail ici n’est pas encore terminé.	
VO_ICC10_Deathwhisper_Female_Lich_LichKing_01	Maître, je… s’il vous plaît, je les tue aussi vite que je peux_!	
VO_ICC10_Deathwhisper_Female_Lich_PlayerPlaysEnrage_01	Vos serviteurs ont envie d’être punis_!	
VO_ICC10_Deathwhisper_Female_Lich_StoneskinGargoyle_01	Quoi_? Je ne savais pas qu’on pouvait jouer des cartes Libres ici_!	
VO_ICC10_Deathwhisper_Female_Lich_ValithriaBlessedChampion_01	Ne touchez pas à ça, paladin_!	
VO_ICC10_Deathwhisper_Female_Lich_ValithriaDivineShield_01	Pas touche au dragon_!	
VO_ICC10_Deathwhisper_Female_Lich_ValithriaResurrect_01	Ce petit jeu ne me plaît plus du tout.	
VO_ICC10_Deathwhisper_Female_Lich_ValithriaTaunt_01	Comme si je ne haïssais pas assez ce dragon.	
VO_ICC10_Deathwhisper_Female_Lich_ValithriaWindfury_01	Écœurant.	
VO_ICC10_LichKing_Male_Human_DamageByValithria_02	Ce dragon va démolir notre œuvre_! Détruis-le, Murmemort_!	
VO_ICC10_LichKing_Male_Human_Lose_01	Même joueur joue encore. Mais avec des soins_!	
VO_ICC10_LichKing_Male_Human_Turn2_01	Murmemort_! Je t’avais pourtant demandé de t’occuper de ce dragon.	
VO_ICC10_LichKing_Male_Human_Turn2_02	J’aurais pensé une dirigeante de culte démoniaque plus efficace que ça.	
VO_ICC10_LichKing_Male_Human_Win_01	Quel deck pitoyable, Murmemort. Réjouis-toi d’avoir subi une défaite aussi rapide.	
VO_ICC10_LichKing_Male_Human_Wounded_01	Cesse de t’amuser avec eux et finis-en, Murmemort.	
VO_ICC10_LichKing_Male_Human_Wounded_02	Pourquoi ton deck ne compte-t-il aucune Explosion des Arcanes_?	
VO_ICCA08_033_Male_HumanGhost_Flavor_01	… Aidez-nous…	
VO_ICCA08_033_Male_HumanGhost_Flavor_02	… Sauvez-nous…	
VO_ICCA08_033_Male_HumanGhost_Flavor_03	… Il n’y a pas d’échappatoire…	
VO_ICCA08_033_Male_HumanGhost_Flavor_04	… Peut-être que si…	
VO_ICCA08_033_Male_HumanGhost_Flavor_05	… Chut_!	
VO_ICCA10_001_Female_GreenDragon_Healed_01	Je… revis_!	
VO_ICCA10_001_Female_GreenDragon_Start_01	Aidez-moi… Je ne dois pas… abandonner…	
VO_Illhoof_Male_Demon_IlhoofKilrek_01	Viens, Kil’rek. Maintenant, nous pouvons terminer l’invocation_!	
VO_Illhoof_Male_Demon_IllhoofDeath_02	Non_! Si proche_! Sarger…	
VO_Illhoof_Male_Demon_IllhoofEmoteResponse_01	Votre essence nourrit le rituel_!	
VO_Illhoof_Male_Demon_IllhoofOpen_01	Ah, juste à temps_!	
VO_Illhoof_Male_Demon_IllhoofSummonImps_01	Venez, vous qui vivez dans les ténèbres_! Ralliez-vous à moi_!	
VO_Illhoof_Male_Demon_IllhoofSummoningPortal_01	Un portail sans rituel_? Ça semble tellement plus simple…	
VO_Illhoof_Male_Demon_IllhoofTurn1_01	Le rituel commence maintenant_!	
VO_Illhoof_Male_Demon_IllhoofWounded_01	Venez, mes chéris. Le rituel doit être accompli_!	
VO_INNKEEPER_Male_Dwarf_HSNewYearBrawl_02	L’année du Corbeau est un peu plus… effrayante que les autres.	
VO_INNKEEPER_Male_Dwarf_HSNewYearBrawl_03	Regardez, voici un signe annonciateur de l’année du Corbeau.	
VO_INNKEEPER_Male_Dwarf_HSNewYearBrawl_05	L’année du Corbeau donne lieu à d’obscures transformations…	
VO_INNKEEPER_Male_Dwarf_HSNewYearBrawl_08	Les bêtes cachées dans les ombres s’enhardissent.	
VO_INNKEEPER_Male_Dwarf_HSNewYearBrawl_09	Les créatures des ténèbres sortent jouer au grand jour.	
VO_INNKEEPER_Male_Dwarf_HSNewYearBrawl_10	Les monstres des marais s’approchent de plus en plus.	
VO_Jaraxxus_Male_Demon_FinalMalchezaarJaraxxus_01	Idiot de prince. Entraînez-vous au karaoké comme Jaraxxus_!	
VO_Jaraxxus_Male_Demon_FinalMalchezaarJaraxxus_02	Nous sommes la\nLigue des explorateurs\net nous sommes une ligue d’explorateurs…	
VO_Julianne_Female_Human_JulianneDeath_01	Ô Romulo_! Je bois à toi…	
VO_Julianne_Female_Human_JulianneEmoteResponse_01	Est-ce à notre intention que vous mordez votre pouce_?	
VO_Julianne_Female_Human_JulianneFeignDeath_03	Et alors tu t’éveilleras comme d’un doux sommeil…	
VO_Julianne_Female_Human_JulianneHeroPower_01	Viens, gentille nuit_; rends-moi mon Romulo_!	
VO_Julianne_Female_Human_JulianneOpen_01	Quel démon es-tu_?	
VO_KAR03_MOROES_MALE_HUMAN_CHESS_TURN_1	Les pièces attaqueront automatiquement à la fin de votre tour.	
VO_KAR03_MOROES_MALE_HUMAN_CHESS_TURN_3	Si une pièce se trouve entre deux ennemis, elle les attaquera tous les deux_!	
VO_KAR03_MOROES_MALE_HUMAN_CHESS_TURN_5	Bien positionner ses pièces est la clé de la victoire. Profitez de ces attaques doubles_!	
VO_KARA_04_01_Female_Human_CroneHuffer_01	Oh Souffleur, j’ai l’impression que nous ne sommes plus à la marche de l’Ouest…	
VO_KARA_04_01_Female_Human_CroneLionTigerBear_02	Oh_! Des lions, des dragons et des ours_! Oh mon dieu_!	
VO_KARA_04_01_Female_Human_CroneTurn1_01	Oh non, ne la laissez pas me faire de mal_!	
VO_KARA_04_01_Female_Human_CroneTurn3_01	Vite, formons une chaîne_! Ensemble, nous sommes plus forts_!	
VO_KARA_06_01_Male_Human_JulianneDeadlyPoison_02	Ah, une dose de poison.	
VO_KARA_06_01_Male_Human_JulianneTurn1_01	Tu veux donc me provoquer_? Eh bien, à toi_!	
VO_KT_ANTI_CHEESE1_65	On est en mode héroïque, là. Je ne supporterai pas des tactiques aussi pitoyables.	
VO_KT_ANTI_CHEESE2_66	Auspice funeste ? Tu te crois malin ?	
VO_KT_ANTI_CHEESE3_67	Égalité ? Pas de ça chez moi.	
VO_KT_ANUB2_43	NOOON ! Je veux dire… Aucune importance. Tu ne pourras jamais vaincre la Grande veuve.	
VO_KT_BARON2_64	Le quartier militaire m’a déçu. De nos jours, il devient vraiment difficile de trouver de la bonne main-d’œuvre.	
VO_KT_FAERLINA2_45	Tuer Faerlina ne prouve rien. La reine des araignées va t’expédier en un rien de temps.	
VO_KT_GLUTH2_73	J’ai demandé aux zombies s’ils voulaient te manger la cervelle. Tu sais ce qu’ils m’ont répondu ? La malbouffe, très peu pour nous ! MOUAHAHAHA !	
VO_KT_GLUTH2_ALT_74	Je suis quasiment certain qu’on peut obtenir un haut fait en perdant contre Gluth.	
VO_KT_GLUTH3_75	HA HA HA HA ! MAIS NON, J’AI MENTI ! ON N’OBTIENT PAS DE HAUT FAIT EN PERDANT CONTRE GLUTH !	
VO_KT_GLUTH4_76	Non ! Qui va manger les derniers zombies, maintenant ?	
VO_KT_GLUTH5_77	L’extermination, c’est ma grande passion. À moins que ça ne soit de glacer le sang...	
VO_KT_GLUTH6_78	Gentil toutou ! Ça c’est un bon toutou !	
VO_KT_GOTHIK2_62	Et pourquoi Gothik ne reviendrait pas sous forme spectrale ? Allez, quoi !	
VO_KT_GROBBULUS2_71	Il va falloir que je reprenne tout depuis le début…	
VO_KT_HEIGAN2_55	Je bous de colère. LITTÉRALEMENT.	
VO_KT_LOATHEB2_57	Tu continues à TUER MES SERVITEURS ! Arrête ça tout de suite !	
VO_KT_MAEXXNA2_47	Son poison te tuera sans douleur… ou presque.	
VO_KT_MAEXXNA3_48	Un géant des mers ? Maexxna, je n’ai pas approuvé cette carte !	
VO_KT_MAEXXNA4_49	IMPOSSIBLE ! Ce n’est pas terminé, pauvre mortel !	
VO_KT_MAEXXNA6_51	Comment appelle-t-on un joueur dont le serviteur vient de se faire entoiler ? Un CONDAMNÉ !	
VO_KT_NOTH2_53	Pauvre Noth. On aurait dû l’appeler le Porte-Poisse.	
VO_KT_PATCHWERK2_69	Mon avatar de guerre ! J’aurais dû le coudre avec de meilleurs joueurs…	
VO_KT_RAZUVIOUS2_59	Et qui va former mes chevaliers de la mort, maintenant ? Je ne peux pas le faire, je suis SUPER occupé.	
VO_KT_SAPPHIRON2_84	Regardez-moi ce petit gnome. Lui aussi a fait intrusion ici, COMME TOI.	
VO_KT_SAPPHIRON3_85	Arrête de te planquer derrière ce bloc de glace !	
VO_KT_SAPPHIRON4_ALT_87	Saphiron, exécution du plan : « Glacer le sang ! »	
VO_KT_SAPPHIRON5_88	MON DRAGON ! Je ne t’aime plus du tout.	
VO_KT_THADDIUS2_81	Intrus ! C’est la goutte d’eau qui fait déborder le vase !	
VO_LichKing_Male_Human_Brawl_01	Toute l’auberge sera nettoyée_!	
VO_LichKing_Male_Human_Brawl_03	Qu’importe le nombre d’imbéciles que vous rallierez à votre combat. Je l’emporterai toujours.	
VO_LichKing_Male_Human_Brawl_05	Contemplez mes innombrables points de vie, et désespérez…	
VO_LichKing_Male_Human_ExpansionIntro_02	La Couronne de glace_! On y vient pour son incommensurable pouvoir. On y reste mort.	
VO_LichKing_Male_Human_FinaleFirstVictory_01	Impossible… Impossible… Je vous propose un affrontement au meilleur des neuf manches_?	
VO_LichKing_Male_Human_FinaleLock_01	Vous ne me vaincrez JAMAIS_! Pas tant que cette aile est verrouillée, en tout cas. Ah ah ah ah_!	
VO_LichKing_Male_Human_FinaleUnlock_03	Dois-je déposer Deuillegivre et me jeter à vos pieds en implorant pitié_? Au risque de vous décevoir, je ne le ferai PAS.	
VO_LichKing_Male_Human_LowerCitadelUnlock_01	La citadelle de la Couronne de glace_! Elle rassemble les plus effroyables de mes serviteurs créés, non pas à partir de poussière, mais de HAINE.	
VO_LichKing_Male_Human_PrologueBossCoin_01	Approchez, champion_! Je vais vous anéantir, puis vous désenchanter pour récupérer de la poussière arcanique_!	
VO_LichKing_Male_Human_PrologueBossCoin_02	J’ai créé ce terrible amalgame d’os à partir des plus effroyables restes de mes cartes en double.	
VO_LichKing_Male_Human_PrologueBossCoin_03	Le Porte-mort Saurcroc était mon premier serviteur légendaire. J’ai conçu toute cette aventure autour de lui.	
VO_LichKing_Male_Human_PrologueBossCoin_04	Voici dame Murmemort. Avant que ses caractéristiques soient revues à la baisse_!	
VO_LichKing_Male_Human_PrologueBossCoin_05	Le professeur Putricide est mon usine à cartes. Ou, mon usine à «_gaz_», devrais-je plutôt dire. Si vous saviez comme je le déteste.	
VO_LichKing_Male_Human_PrologueBossCoin_07	Lana’thel_! Il y a des traces de MORSURES sur mes CARTES_! Je t’avais dit de les glisser dans des POCHETTES_!	
VO_LichKing_Male_Human_PrologueBossCoin_08	Sindragosa est ma carte maîtresse. Bas les pattes_! Vous ne l’aurez pas_!	
VO_LichKing_Male_Human_PrologueBossCoin_09	Vous crierez grâce. Vous appuierez sur le bouton «_Capituler_», et je refuserai.	
VO_LichKing_Male_Human_PrologueBossCoin_11	Regardez votre main, mortel. Voyez ce que vous êtes devenu. Sommes-nous si différents, vous et moi_?	
VO_LichKing_Male_Human_PrologueBossCoin_12	Me voilà devant eux, comme le loup devant les agneaux… et ils n’ont pas peur.	
VO_LichKing_Male_Human_ResponseAnubaArak_01	Sers-moi, Anub’Arak_!	
VO_LichKing_Male_Human_ResponseMalganis_01	Combien de fois vais-je devoir te tuer, Mal’Ganis_?	
VO_LichKing_Male_Human_UpperReachesLock_01	Vous cherchez à retourner mon pouvoir contre moi_? Une seconde, je vais trouver un deck sur Internet qui plongera à jamais ce monde dans les ténèbres.	
VO_LichKing_Male_Human_UpperReachesUnlock_01	Vous cherchez à retourner mon pouvoir contre moi_? Avez-vous la moindre idée du nombre de fois où j’ai atteint le rang Légende_?	
VO_LOE_01_DEATH_2	Orsis ! Venge-moi !	
VO_LOE_01_RESPONSE	Craignez le courroux du soleil !	
VO_LOE_01_STAFF	Ha ha ! Il est à moi !	
VO_LOE_01_STAFF_2	Vous allez brûler !	
VO_LOE_01_STAFF_2_RENO	Vous devriez garder cette baguette. Elle a beaucoup de valeur.	
VO_LOE_01_START	Je suis INVINCIBLE !	
VO_LOE_01_WIN	Ha ha ! J’ai la baguette ! Si seulement Harrison pouvait me voir_!	
VO_LOE_01_WIN_2	Emparez-vous de ce bâton !	
VO_LOE_01_WIN_2_ALT_2	Heu, c’est normal que le sol remue autant ?	
VO_LOE_01_WOUNDED	Je l’ai coincé dans les cordes_! Finissez-le !	
VO_LOE_02_DEATH	De retour dans la lampe, noooooon !	
VO_LOE_02_INTRO	La baguette du Soleil est à MOI_!	
VO_LOE_02_MORE_WISHES	Ouah, je n’arrive pas à croire que ça ait marché.	
VO_LOE_02_PHAERIX_STAFF_RECOVER	Vous ne pouvez pas comprendre la puissance de la baguette !	
VO_LOE_02_RESPONSE	Une puissance cosmique phénoménale !	
VO_LOE_02_START	Enfin libre ! Une mort rapide sera votre récompense !	
VO_LOE_02_START2	Aventurier ! Je suis Reno Jackson, archéologue de renommée mondiale, explorateur et chasseur de trésors.	
VO_LOE_02_START3	Avec toute la maîtrise d’un collectionneur invétéré.	
VO_LOE_02_TURN_10	Imaginez ça, la baguette du Soleil ! Ça vaut des milliards !	
VO_LOE_02_TURN_6	Je vous ai parlé de la fois où j’ai infiltré les ogres de Hache-Tripes avec un super déguisement ?	
VO_LOE_02_TURN_6_2	Et de la fois où je me suis faufilé dans le Lycéum de Rochenoire pour obtenir…	
VO_LOE_02_WIN	En avant ! La baguette est dans cette salle !	
VO_LOE_02_WISH	C’est gentil de sa part, il nous accorde des vœux tout en essayant de nous tuer.	
VO_LOE_03_RESPONSE	Dépêchez-vous !	
VO_LOE_03_TURN_1	Le plafond va s’écrouler et il y a des monstres partout ! Dépêchez-vous !	
VO_LOE_03_TURN_10	On y est presque_! Je peux voir le soleil_!	
VO_LOE_03_TURN_2	Hé hé, un bassin luminescent. On y va ?	
VO_LOE_03_TURN_2_2	On n’a pas le temps pour ça !	
VO_LOE_03_TURN_3	Humm… Ok… Droite ou gauche ?	
VO_LOE_03_TURN_3_BOULDER	Ce rocher est énorme ! Ne restez pas là !	
VO_LOE_03_TURN_3_WARNING	Le grondement devient plus fort. Je parie que le plafond tout entier va s’écrouler au prochain tour !	
VO_LOE_03_TURN_4	Hé, une fosse remplie de pointes !	
VO_LOE_03_TURN_4_BAD	Ha ha ha ! Ça n’avait pas l’air marrant.	
VO_LOE_03_TURN_4_GOOD	Ah, joli ! Presque aussi bien que moi.	
VO_LOE_03_TURN_4_NEITHER	Ok, vous passez à travers les pointes ? Alors dépêchez-vous !	
VO_LOE_03_TURN_5	Hé, c’est une belle statue. Et le rubis est si éclatant…	
VO_LOE_03_TURN_5_4	Oh oh, il n’a pas l’air content. Je crois qu’il veut récupérer sa gemme.	
VO_LOE_03_TURN_6	Attention ! Le plafond s’écroule !	
VO_LOE_03_TURN_6_2	Ouh ! Cest pas passé loin ! Content que vous vous en soyez sorti. Il n’y a pas de quoi.	
VO_LOE_03_TURN_7	Hmm, il fait très sombre ici, mais je suis sûr que c’est le chemin le plus rapide. Allons-y !	
VO_LOE_03_TURN_7_2	Sur ma carte, il y a écrit « NE PASSEZ PAS PAR LÀ ».	
VO_LOE_03_TURN_8	Pfiou ! Il commence à faire chaud. Dépêchons-nous !	
VO_LOE_03_TURN_9	Argh. Pourquoi faut-il que ce soit toujours des insectes ?	
VO_LOE_03_WIN	Rah ! Nous avons réussi ! Je ne croyais pas être aussi heureux de revoir un jour ce désert désert ! … Je crois qu’il me faut de l’eau.	
VO_LOE_04_RESPONSE	Trogg écraser stupide !	
VO_LOE_04_SCARVASH_TURN_2	Trogg pas stupide_! Trogg rendre vous stupide !	
VO_LOE_04_START	Uldaman QUE pour troggs !	
VO_LOE_04_WIN	Il en vient toujours plus ! Par ici, sautez dans ce chariot de mine !	
VO_LOE_07_RESPONSE	Vous avez vraiment le temps pour ça ?	
VO_LOE_07_START	Attention, ils nous poursuivent !	
VO_LOE_07_WIN	Ha ha ! Des chariots de mine et des bombes ! Ça m’éclate !	
VO_LOE_08_ANIMATE_STONE	Terre et pierre, réveillez-vous !	
VO_LOE_08_LANDSLIDE	Je vais vous enterrer !	
VO_LOE_08_RESPONSE	Vous n’êtes que poussière.	
VO_LOE_08_START	Qui ose affronter le courroux des Faiseurs ?	
VO_LOE_08_WIN	Le pommeau est à nous ! Plus qu’une partie à récupérer !	
VO_LOE_092_Attack_02	Admirez !	
VO_LOE_10_NYAH	Mrrrglmrrrgl niah !	
VO_LOE_10_RESPONSE	Mrglmrrglrmrrgl !	
VO_LOE_10_RESPONSE_ALT_read	Mi-Aileron, qu’est-ce que tu fais là ?	
VO_LOE_10_START	Mrglmrglmrgl !	
VO_LOE_10_START_2	Vraiment ? C’est extrêmement malpoli.	
VO_LOE_10_TURN_2_GIANTFIN	MRRRGL !  MRRRGLMRGL !	
VO_LOE_10_TURN1	Mrrrgl !  Mrrglrrglmrgl !	
VO_LOE_10_WIN	Une honte. Avec une meilleure éducation, il aurait pu devenir quelqu’un de convenable.	
VO_LOE_12_NAZJAR_PEARL	Remarquable. La Perle des marées dépasse toutes mes espérances.	
VO_LOE_12_NAZJAR_TURN_1	Je suis la lame d’Azshara. Qui êtes-vous pour oser me défier ?	
VO_LOE_12_NAZJAR_TURN_1_FINLEY	Je me présente, Sir Finley Mrrgglton. C’est un plaisir de vous rencontrer.	
VO_LOE_12_NAZJAR_TURN_3_FINLEY	Élise, comment s’en sortent les autres ?	
VO_LOE_12_NAZJAR_TURN_5	Armées des profondeurs, fondez sssur nos adversssaires comme une vague de mort !	
VO_LOE_12_NAZJAR_TURN_5_FINLEY	Cela sonne un petit peu trop extrême.	
VO_LOE_12_NAZJAR_TURN_7_FINLEY	Mrgggl!  MRRGLMRRGL !	
VO_LOE_12_NAZJAR_TURN_7_FINLEY_2	Excusez-moi, très cher, parfois, je m’oublie.	
VO_LOE_12_RESPONSE	Je détiens la puisssssance de la perle !	
VO_LOE_12_START	La puisssance des marées vous consssumera !	
VO_LOE_12_WIN	Bravo ! La perle est à nous ! Accompagnez-moi au hall des Explorateurs, nous assemblerons l’artéfact ensemble !	
VO_LOE_13_RESPONSE	RAAAAHHR	
VO_LOE_13_START_2	Rarrrh !	
VO_LOE_13_TURN_1	Le bâton était maudit ! Il a invoqué des éthériens à travers nos protections. Il nous vole tout !	
VO_LOE_13_TURN_1_2	Pas tout. Juste les objets intéressants.	
VO_LOE_13_TURN_5	Oooh, c’est vraiment la chevalière d’Arthas_? Et en parfait état !	
VO_LOE_13_TURN_5_2	Reno, Brann, cachez les artéfacts !	
VO_LOE_13_TURN_9	Il anime toute une armée ! Élise, arrêtez-le !	
VO_LOE_13_TURN_9_2	Tel’zaxus Nalore ! Le bâton est trop puissant, mais je peux le ralentir !	
VO_LOE_13_WIN	Nous allons nous occuper des pièces exposées. Allez vous occuper de Rafaam !	
VO_LOE_14_RESPONSE	CLING	
VO_LOE_14_START	Oh, c’est l’armure de Lothar ! Ça m’a pris des mois de tamisage dans Rochenoire, les pieds dans le crottin de dragon, pour la trouver.	
VO_LOE_14_TURN_13	Brann, il anime les livres de la bibliothèque ! Je vais m’occuper des marteaux volants de l’exposition de Lordaeron.	
VO_LOE_14_TURN_5	J’ai envoyé les épées animées dans le hall est. Élise, qui puis-je aider ?	
VO_LOE_14_TURN_5_2	Rejoignez Reno dans la réserve principale ! Il est cerné de Ro’Boums !	
VO_LOE_14_TURN_9	Vous avez l’air tous très occupés. Je vais juste récupérer cette adorable broche.	
VO_LOE_14_WIN	Nous avons sécurisé le musée. Maintenant, allez combattre Rafaam !	
VO_LOE_15_RESPONSE	Quelles cartes merveilleuses !	
VO_LOE_15_SPARE	Nous avons un deck de secours_; utilisez-le !	
VO_LOE_16_BOOM_BOT	Oh oui, il nous en reste encore plein. Finissez-le !	
VO_LOE_16_CROWN	La magie du mage maboul manifestée.	
VO_LOE_16_EYE	C’est drôle. Il était dans ma poche, j’imagine que je peux vous le prêter.	
VO_LOE_16_FIRST_ITEM	Nous fouillons le musée à la recherche d’objets utiles. Prévenez-moi si vous en voulez un !	
VO_LOE_16_GOBLET	J’ai horreur des serpents.	
VO_LOE_16_GREAVE	Une partie de l’armure de Lothar restée intacte après votre chute.	
VO_LOE_16_LOCKET	Les fantômes de Karazhan hantent ce bijou.	
VO_LOE_16_PIPE	Attrapez ! Mais ne dites rien à Brann ; il adore cette pipe !	
VO_LOE_16_RAFAAM_DEATH2	NON ! JE NE PEUX PAS ÊTRE VAINCU !	
VO_LOE_16_SHARD	C’était dans une boîte avec « NE PAS OUVRIR » écrit dessus. Alors… bonne chance !	
VO_LOE_16_SPLINTER	J’ai trouvé ça au cœur du Magma. Le chambellan l’utilisait pour se curer les dents.	
VO_LOE_16_START_2	Le bâton est en train de se charger. Attention !	
VO_LOE_16_TEAR	Un artéfact sacré de mon peuple. Buvez-le vite !	
VO_LOE_16_TURN_2	Le bâton est presque chargé. Préparez-vous !	
VO_LOE_16_TURN_2_2	HAHAHA ! PUISSANCE ÉCRASANTE !	
VO_LOE_16_TURN_2_3	Le bâton est en surcharge ! C’est le moment !	
VO_LOE_16_TURN_3	Je suis invincible_! Vous ne me battrez jamais !	
VO_LOE_16_TURN_3_2	Le bâton est à nouveau en train de se charger. Nous aurons une autre occasion dans un moment.	
VO_LOE_16_TURN_4	Le bâton est presque prêt. Préparez-vous !	
VO_LOE_16_TURN_5	HAHAHA ! PUISSANCE ÉCRASANTE !	
VO_LOE_16_TURN_5_2	Son bouclier est tombé. Attaquez !	
VO_LOE_16_TURN_6	Son bouclier fonctionne à nouveau. Soyez prudent !	
VO_LOE_16_VIAL	Il y a écrit « BUVEZ-MOI », mais nous l’avons trouvé dans Naxxramas, alors personne n’a voulu y goûter.	
VO_LOE_ARCHAEDAS_TURN_1_CARTOGRAPHER	S’il n’était pas aussi occupé à vous enterrer sous des tonnes de pierres.	
VO_LOE_GIANTFIN_TIDEHUNTER_2	Non, Finley ! Vous étiez différent, même à cette époque.	
VO_LOE_NAZJAR_TURN_3_CARTOGRAPHER	Reno est de retour avec la baguette du Soleil et Brann est en chemin.	
VO_LOE_SCARVASH_TURN_6_CARTOGRAPHER	Concentrez-vous, Brann !	
VO_LOE_ZINAAR_TURN_10_CARTOGRAPHER_2	On ne va pas le vendre.	
VO_LOE_ZINAAR_TURN_6_CARTOGRAPHER_2	Oui.	
VO_LOE_ZINAAR_TURN_6_CARTOGRAPHER_2_ALT	Oui.	
VO_LOE10_DEAD_MURLOCS	Tellement de morts. Quel gâchis.	
VO_LOE10_NYAH_FINLEY	Oh, balivernes. Ne soyez pas puéril.	
VO_LOE10_TIDEHUNTER	Avant qu’Élise me trouve, j’étais chasse-marée. Cela aurait-il pu être mon destin ?	
VO_LOE10_TURN_2_FINLEY	Mes frères ! Devons-nous vraiment nous battre ?	
VO_LOE10_TURN_2_FINLEY_2	Je suppose qu’il fallait s’y attendre.	
VO_LOEA04_BRANN_TURN_1	Scarvash était un tout petit trogg la dernière fois que je suis venu. Maintenant, il est plus grand, plus bête et plus laid.	
VO_LOEA04_BRANN_TURN_6	Fascinant. Ces runes de mithril contiennent un code de gardien. Il doit remonter à l’époque des titans !	
VO_LOEA07_MINE_ALMOST_DONE	On y est presque ! Je me demande à quoi sert ce bouton…	
VO_LOEA07_MINE_ARCHAEDAS	PAR LA BARBE DE MAGNI – EST-CE ARCHAEDAS EN PERSONNE ???	
VO_LOEA07_MINE_BARREL_FORWARD	En avant toute !	
VO_LOEA07_MINE_BOOM	Des bombes rebondissantes ! Ça leur apprendra !	
VO_LOEA07_MINE_BOOMZOOKA	BOUM ! Je vais la recharger pour un nouveau tir !	
VO_LOEA07_MINE_DETONATE	Vous faites détoner le puits ? VOUS ÊTES FOU ?!	
VO_LOEA07_MINE_DYNAMITE	Ah ! Attention avec ce truc ! Vous avez explosé un bout de voie !	
VO_LOEA07_MINE_HUNKER_DOWN	Baissez-vous !	
VO_LOEA07_MINE_PARROT	Envole-toi, Ginny !	
VO_LOEA07_MINE_RAMMING	Ha ha ! Hors de notre chemin !	
VO_LOEA07_MINE_REPAIRS	Un peu de gomme de gésier et elle est comme neuve !	
VO_LOEA07_MINE_SPIKED_DECOY	Hé, stupides troggs ! Venez me chercher !	
VO_LOEA08_TURN_1_BRANN	Un serviteur des anciens titans. Toutes les histoires qu’il pourrait nous raconter…	
VO_LOEA09_1_RESPONSE	Plus à manger pour le dîner !	
VO_LOEA09_1_TURN1	Vous osez envahir la ville en ruines ?	
VO_LOEA09_FINLEY_DEATH	Je serai guéri dans un instant. Achevez ce naga !	
VO_LOEA09_HERO_POWER	Ssss’est l’heure du dîner ! Au menu aujourd’hui, sssoupe de murloc !	
VO_LOEA09_HERO_POWER1	Salutations, mon ami. Vous aideriez un collègue dans le pétrin ?	
VO_LOEA09_HERO_POWER2	Ma foi, il fait horriblement noir ici.	
VO_LOEA09_HERO_POWER3	Oh là là. Est-ce que ça se réchauffe ?	
VO_LOEA09_HERO_POWER4	C’est vraiment déplaisant, il faut bien l’avouer.	
VO_LOEA09_HERO_POWER5	Hum, il fait vraiment chaud ici.	
VO_LOEA09_HERO_POWER6	J’apprécierais fortement un peu d’aide.	
VO_LOEA09_QUOTE1	Merci, l’ami ! C’était vraiment limite !	
VO_LOEA09_UNSTABLE	Retourne dans le chaudron !	
VO_LOEA09_WIN	Vous avez toute ma gratitude, cher compagnon. Puis-je vous conduire jusqu’au dernier morceau ?	
VO_LOEA10_1_MIDDLEFIN	Mi-Aileron, qu’est-ce que tu fais là ?	
VO_LOEA15_1_LOSS_11	Votre deck est nul. Il est temps d’utiliser le mien.	
VO_LOEA15_1_LOW_HEALTH_10	J’ai peut-être fait une erreur en prenant votre deck.	
VO_LOEA15_1_MAGMA_RAGER_09	Enragé du magma ?! Mais pourquoi vous jouez cette carte ???	
VO_LOEA15_1_START_07	J’aime votre deck. Je crois que je vais VOUS LE PRENDRE.	
VO_LOEA15_1_TURN1_08	Oh oui. Cette main est INCROYABLE.	
VO_LOEA15_1_WIN_12	Votre deck est STUPÉFIANT. Ah ah ah !	
VO_LOEA15_GOLDEN	Ce deck est TOTALEMENT DORÉ ? Votre collection rivalise avec la mienne !	
VO_LOEA16_1_CARD_04	J’ai récupéré des artéfacts sur des CENTAINES de mondes !	
VO_LOEA16_1_RESPONSE_03	Oui ! OUI !	
VO_LOEA16_1_START_01	Contemplez la PLEINE PUISSANCE du bâton !	
VO_LOEA16_1_TURN1_02	Je suis invincible ! Je détiens la puissance des titans !	
VO_LOOT_329_Male_Elemental_Attack_01	Flétrissez.	
VO_LOOT_329_Male_Elemental_Death_01	<Meurt.>	
VO_LOOT_329_Male_Elemental_Play_01	Le vivant moisit. Le moisi survit.	
VO_LOOT_541_Male_Kobold_BOSS_AFKay_01	Vite_! Attaquer humaine pendant que elle pas faire attention_!	
VO_LOOT_541_Male_Kobold_BOSS_Blackseed_01	Sombregraine aller loin, loin profond, revenir avec… eurk… bras serpents. 	
VO_LOOT_541_Male_Kobold_BOSS_Brimstone_01	Chut_! Statues avoir des yeux, mais elles dodo. Pas réveiller_!	
VO_LOOT_541_Male_Kobold_BOSS_Candlebeard_01	Barbe-Roussie penser que déterrer trésors faire de kobold un pirate.	
VO_LOOT_541_Male_Kobold_BOSS_Chronomancer_01	Sorcière du temps_! Nous retrouver nous, pour première fois_!	
VO_LOOT_541_Male_Kobold_BOSS_Everrot_01	Vous pas toucher spores_! Vos serviteurs toucher.	
VO_LOOT_541_Male_Kobold_BOSS_Flurgl_01	Kobolds pas comprendre murlocs_: eux parler bizarre_!	
VO_LOOT_541_Male_Kobold_BOSS_GeorgeKarl_01	Eux deux partir un jour dans jungle, et tout perdus.	
VO_LOOT_541_Male_Kobold_BOSS_Gnosh_01	Tunnel pas être tunnel du tout_! Grande bouche_! Pleine de dents_!	
VO_LOOT_541_Male_Kobold_BOSS_Graves_01	Soigneur perdu faire la morale, «_pitié, pitié_». Vous le tuer_!	
VO_LOOT_541_Male_Kobold_BOSS_Gutmook_01	Troggs. BAH. Vous pas parler et laisser serviteurs écraser lui.	
VO_LOOT_541_Male_Kobold_BOSS_Hamm_01	Hamm être plus meilleur creuseur de tunnel. «_Creuseur_» être eurphémisme.	
VO_LOOT_541_Male_Kobold_BOSS_Jeeru_01	Oh non non non non, pas frotter lampe_! Ça être piège.	
VO_LOOT_541_Male_Kobold_BOSS_Lyris_01	Folle elfe qui brille de tout partout_! Vous faire attention, serviteurs serpents faire qui-brûle.	
VO_LOOT_541_Male_Kobold_BOSS_MagmaRager_01	Kobolds barricader tunnel de lave, mais tunnel se rouvrir tout seul.	
VO_LOOT_541_Male_Kobold_BOSS_Mothergloop_01	Vous méfier de matriarche Gloups, mère de tous les gloups_!	
VO_LOOT_541_Male_Kobold_BOSS_Mushhuckster_01	Max la Girolle venir de mauvais côté du donjon.	
VO_LOOT_541_Male_Kobold_BOSS_Russell_01	Barde chanter des chansons qui faire perdre face.	
VO_LOOT_541_Male_Kobold_BOSS_Seriona_01	Stupide dragon du Crépuscule rendre kobolds faibles_! Euh, très faibles_!	
VO_LOOT_541_Male_Kobold_BOSS_Sturmi_01	Pétrine faire petits potes de cire_! Oh, elle trop marrante pendant fêtes kobolds.	
VO_LOOT_541_Male_Kobold_BOSS_TrappedRoom_01	Chut… Vous… Pas toucher… À RIEN…	
VO_LOOT_541_Male_Kobold_BOSS_TreasureVault_01	Trésor_! Trésor ici. Vous casser et prendre_!	
VO_LOOT_541_Male_Kobold_BOSS_Troll_01	Boss troll ingrédient indispensable de donjon équilibré.	
VO_LOOT_541_Male_Kobold_BOSS_Whopwhisker_01	Bon vieux Barbarillon plus en colère de tous les kobolds.	
VO_LOOT_541_Male_Kobold_DefeatPlayer_01	Tout plein de trésors_! Hé hé… À moi, moi, moi, moi, moi.	
VO_LOOT_541_Male_Kobold_EmoteResponse_01	Vous fermer clapet.	
VO_LOOT_541_Male_Kobold_LOOT_Backpacks_01	Sac à dos_! Plus seulement pour les dos, maintenant.	
VO_LOOT_541_Male_Kobold_LOOT_Boombox_01	Boîte à boum_! Être meilleure boîte de bombes jamais emboitées.	
VO_LOOT_541_Male_Kobold_LOOT_Candle1_01	Pas prendre bougie_!	
VO_LOOT_541_Male_Kobold_LOOT_Candle2_01	Je vous avoir dit_! Vous avoir dit pas prendre mais vous prendre quand même_!	
VO_LOOT_541_Male_Kobold_LOOT_CapturedFlag_01	Alliance et Horde tous gaga pour drapeaux. 	
VO_LOOT_541_Male_Kobold_LOOT_Cube_01	Oh, boîte en cube beaucoup folle_! Quand gagner plus être une option_!	
VO_LOOT_541_Male_Kobold_LOOT_Invisibility_01	Cape d’invisibilisation_! Je toujours la perdre_! Elle invisible.	
VO_LOOT_541_Male_Kobold_LOOT_QuelDelar_01	Quel’Delar_! Épée légendaire être cassée en deux. Pas être ma faute.	
VO_LOOT_541_Male_Kobold_LOOT_QuelDelarForged_01	Très jolie_! Beaucoup briller_! Beaucoup… épée_!	
VO_LOOT_541_Male_Kobold_LOOT_Wand_01	Kobolds vénérer Baguette à griller, être bonne carte pour tester agilité.	
VO_LOOT_541_Male_Kobold_LOOT_WaxRager_01	Enragé de cire ami très puissant. D’où cire venir ? Des oreilles.	
VO_LOOT_541_Male_Kobold_TUT_AdventureSelect_01	Quoi moi sentir_? Cuir_? Acier_? Torches… AVENTURIERS. Bah_! Aventuriers_!	
VO_LOOT_541_Male_Kobold_TUT_BossHeroPower_01	Monstres tous faire quelque chose différent. Tous très méchants. Vous cliquer et voir_!	
VO_LOOT_541_Male_Kobold_TUT_BountyBoard_01	Stop_! Demi-tour_! Gros tas de trésor pour MOI, pas pour VOUS.	
VO_LOOT_541_Male_Kobold_TUT_CharacterSelect_01	Qui oser venir pour trésors kobolds_? Épée qui-pique_? Feu qui-brûle_?	
VO_LOOT_541_Male_Kobold_TUT_Final_Boss_Azari_01	Dévorateur être libre_! Vous fuir_!	
VO_LOOT_541_Male_Kobold_TUT_Final_Boss_Darkness_01	Vous faire attention à ténèbres_! Raison de kobolds pour toujours garder bougies.	
VO_LOOT_541_Male_Kobold_TUT_Final_Boss_KoboldKing_01	Mon tour, hé ha_! Moi reprendre tous les trésors que vous pris_!	
VO_LOOT_541_Male_Kobold_TUT_Final_Boss_Vustrasz_01	Vous prendre butin du dragon_? Ohhh, lui se fâcher TOUT rouge…	
VO_LOOT_541_Male_Kobold_TUT_Final_Boss_Xol_01	Vous pas regarder dans yeux de Xol_! Elle avoir yeux partout.	
VO_LOOT_541_Male_Kobold_TUT_Game1Begin1_01	Premiers monstres être petits et faibles. Mais vous aussi_!	
VO_LOOT_541_Male_Kobold_TUT_Game1Begin2_01	Vous les écraser et les dépouiller pour devenir plus fort_!	
VO_LOOT_541_Male_Kobold_TUT_Game1Defeat_01	Ça bien. Mourir jeune mieux que mourir jamais.	
VO_LOOT_541_Male_Kobold_TUT_Game1Victory_01	Vous être vainqueur_! Prendre butin maintenant. Hé ha. Aventurier classique.	
VO_LOOT_541_Male_Kobold_TUT_Game2Begin1_01	Quand vous devenir plus fort, monstres aussi devenir plus forts.	
VO_LOOT_541_Male_Kobold_TUT_Game2Begin2_01	Élasticité pécuniaire être partie importante de doctrine d’économie mixte d’empire kobold.	
VO_LOOT_541_Male_Kobold_TUT_GeneralDefeat1_01	Dommage. Pour vous. Quand aventurier mourir, roi kobold récupérer tout le butin_!	
VO_LOOT_541_Male_Kobold_TUT_GeneralDefeat2_01	Envoyer aventuriers plus encore_! Hé ha_! Moi plus de butin, plus de butin, plus de butin, plus de butin…	
VO_LOOT_541_Male_Kobold_TUT_MainBoss1_01	Vous trouver beaucoup monstres dans empire kobold. Combats rendre vous plus fort_! … Ou mort.	
VO_LOOT_541_Male_Kobold_TUT_MainBoss3_01	Pour finir donjon, devoir battre huit monstres_! Un pour chaque doigt.	
VO_LOOT_541_Male_Kobold_TUT_TreasureSelect1_01	OHHH gros trésor_! Vous choisir un seul. Vous bien choisir.	
VO_LOOT_541_Male_Kobold_TUT_TreasureSelect2_01	Vous choisir cartes pour votre deck de donjon.	
VO_LOOT_541_Male_Kobold_TUT_TreasureSelect3_01	Vous construire deck pour écraser monstres. Ça être votre deck de vous jusqu’à vous mort.	
VO_LOOT_541_Male_Kobold_TUT_TreasureSelect4_01	Vous gagner plus, vous avoir plus de butin_! Être comme ça avec kobolds_!	
VO_LOOT_541_Male_Kobold_TUT_Victory1_01	Quoi_? Personne partir avec trésors kobolds_!	
VO_LOOT_541_Male_Kobold_TUT_Victory2_01	Sûrement pas neuf fois_!	
VO_LOOT_541_Male_Kobold_TUT_VictoryComplete_01	Vous réussir_! Vous maîtriser donjon en mode maître du donjon dingo, bingo_!	
VO_LOOT_541_Male_Kobold_TUT_VictoryComplete_02	Vous réussir_!\nVous maître du donjon_!	
VO_LOOTA_829_Male_Human_Event_01	Maudite soit ma soudaine mais inévitable trahison_!	
VO_LOOTA_BOSS_04h_Female_Kobold_Death_01	<Death>	
VO_LOOTA_BOSS_04h_Female_Kobold_DefeatPlayer_01	Vous pas bouger_! Laisser cire sécher… Vous joli, très joli sujet… Très joli.	
VO_LOOTA_BOSS_04h_Female_Kobold_EmoteResponse_01	Moi bougie-mancienne, pas cérumancienne.	
VO_LOOTA_BOSS_04h_Female_Kobold_EventWaxOff_01	Bougie de là…	
VO_LOOTA_BOSS_04h_Female_Kobold_EventWaxOn_01	Cirez-vous_!	
VO_LOOTA_BOSS_04h_Female_Kobold_EventWaxRagerPlay_01	Ohh… Joli_!	
VO_LOOTA_BOSS_04h_Female_Kobold_EventWaxRagerRespawn_01	Oh, lui toujours revenir, non_?	
VO_LOOTA_BOSS_04h_Female_Kobold_Intro1_01	Oh oui, hm, cire avoir yeux…	
VO_LOOTA_BOSS_04h_Female_Kobold_Intro2_01	Moi faire jolis qui-brille, beaux qui-brille de cire.	
VO_LOOTA_BOSS_05h_Male_Kobold_Death_01	<Death>	
VO_LOOTA_BOSS_05h_Male_Kobold_DefeatPlayer_01	Bam faire le Hamm_!	
VO_LOOTA_BOSS_05h_Male_Kobold_EmoteResponse_01	Pas prendre boum-boum.	
VO_LOOTA_BOSS_05h_Male_Kobold_EventBoomBots_01	Joli. JOLI_! Joli, joli, joli_!	
VO_LOOTA_BOSS_05h_Male_Kobold_EventMadBomberDeath_01	Pas comme ça…	
VO_LOOTA_BOSS_05h_Male_Kobold_HeroPower1_01	Boum, bébé. Ha ha_! BOUM_!	
VO_LOOTA_BOSS_05h_Male_Kobold_HeroPower2_01	Ha ha ha.	
VO_LOOTA_BOSS_05h_Male_Kobold_HeroPower3_01	Ha ha ha ha.	
VO_LOOTA_BOSS_05h_Male_Kobold_Intro_01	Moi tout démolir_!	
VO_LOOTA_BOSS_06h_Male_Furbolg_Death_01	Il y en a d’autres, plus bas…	
VO_LOOTA_BOSS_06h_Male_Furbolg_DefeatPlayer_01	Est-ce que… je l’ai tué_? Qu’est-ce que j’ai fait…_?	
VO_LOOTA_BOSS_06h_Male_Furbolg_EmoteResponse_01	Vous êtes juste… une voix de plus parmi les autres…	
VO_LOOTA_BOSS_06h_Male_Furbolg_EventPlayerEvolves_01	Je perçois les ténèbres en vous_!	
VO_LOOTA_BOSS_06h_Male_Furbolg_HeroPower1_01	Elles m’appellent…	
VO_LOOTA_BOSS_06h_Male_Furbolg_HeroPower2_01	Ces tunnels s’enfoncent loin.	
VO_LOOTA_BOSS_06h_Male_Furbolg_HeroPower3_01	Les choses ne sont pas ce qu’elles paraissent…	
VO_LOOTA_BOSS_06h_Male_Furbolg_HeroPower4_01	Qui est le monstre ici_?	
VO_LOOTA_BOSS_06h_Male_Furbolg_HeroPower5_01	Vous ne voyez pas les ombres… mais elles vous voient.	
VO_LOOTA_BOSS_06h_Male_Furbolg_Intro_01	Une créature malfaisante se terre par ici…	
VO_LOOTA_BOSS_09h_Female_Furbolg_Death_01	<Death>	
VO_LOOTA_BOSS_09h_Female_Furbolg_DefeatPlayer_01	Voilà comment on règle les problèmes à Berceau-de-l’Hiver.	
VO_LOOTA_BOSS_09h_Female_Furbolg_EmoteResponse_01	Glacial, l’accueil.	
VO_LOOTA_BOSS_09h_Female_Furbolg_EventFrostMagic1_01	Vous aussi, vous étreignez le givre.	
VO_LOOTA_BOSS_09h_Female_Furbolg_EventFrostMagic2_01	<Frissonne.>	
VO_LOOTA_BOSS_09h_Female_Furbolg_EventFrostMagic3_01	C’est froid_!	
VO_LOOTA_BOSS_09h_Female_Furbolg_HeroPower1_01	Reste où tu es encore un peu.	
VO_LOOTA_BOSS_09h_Female_Furbolg_HeroPower2_01	Ah non. Sûrement pas.	
VO_LOOTA_BOSS_09h_Female_Furbolg_HeroPower3_01	Reste là.	
VO_LOOTA_BOSS_09h_Female_Furbolg_Intro_01	Satanés kobolds, je vous avais dit de… Oh mais qui voilà_?	
VO_LOOTA_BOSS_10h_Male_Human_Death_01	C’était écrit…	
VO_LOOTA_BOSS_10h_Male_Human_DefeatPlayer_02	Je revendique ces trésors. Au nom de la Lumière_! Et pour moi.	
VO_LOOTA_BOSS_10h_Male_Human_EmoteResponse_01	Implorer ma pitié ne vous sauvera pas.	
VO_LOOTA_BOSS_10h_Male_Human_EventOverdraw_01	Aïe. Vous avez vu trop clerc dans mon jeu_!	
VO_LOOTA_BOSS_10h_Male_Human_HeroPower1_01	Ayez la foi_!	
VO_LOOTA_BOSS_10h_Male_Human_HeroPower2_01	Vous voilà de nouveau en bonne santé_!	
VO_LOOTA_BOSS_10h_Male_Human_HeroPower3_01	Renoncez aux ténèbres_!	
VO_LOOTA_BOSS_10h_Male_Human_HeroPower4_01	La Lumière vous accorde sa miséricorde.	
VO_LOOTA_BOSS_10h_Male_Human_HeroPower5_01	[x]Magnifique !	
VO_LOOTA_BOSS_10h_Male_Human_Intro_01	Halte_! Je revendique ces trésors au nom de la Lumière_!	
VO_LOOTA_BOSS_11h_Male_Trogg_Death_01	<Death>	
VO_LOOTA_BOSS_11h_Male_Trogg_DefeatPlayer_01	Bon chef devoir connaître le chemin, prendre le chemin et montrer le fouet.	
VO_LOOTA_BOSS_11h_Male_Trogg_EmoteResponse_01	Pas parler pour rien dire. Laisser faire FOUET_!	
VO_LOOTA_BOSS_11h_Male_Trogg_EventEquality_01	Oh.… Serviteurs déjà fouettés_!	
VO_LOOTA_BOSS_11h_Male_Trogg_HeroPower1_01	Du nerf_!	
VO_LOOTA_BOSS_11h_Male_Trogg_HeroPower2_01	[x]Allez !	
VO_LOOTA_BOSS_11h_Male_Trogg_HeroPower3_01	Plus vite_!	
VO_LOOTA_BOSS_11h_Male_Trogg_HeroPower4_01	On accélère_!	
VO_LOOTA_BOSS_11h_Male_Trogg_HeroPower5_01	Bon coup de fouet.	
VO_LOOTA_BOSS_11h_Male_Trogg_Intro_01	L’heure du fouet_!	
VO_LOOTA_BOSS_12h_Male_Kobold_CandleAttack1_01	Vous mettre bougie très en colère_!	
VO_LOOTA_BOSS_12h_Male_Kobold_CandleAttack2_01	Pas provoquer bougie_!	
VO_LOOTA_BOSS_12h_Male_Kobold_CandleAttack3_01	[x]Rakanishu !	
VO_LOOTA_BOSS_12h_Male_Kobold_CandleAttack4_01	Être l’heure de bougie_!	
VO_LOOTA_BOSS_12h_Male_Kobold_CandleAttack5_01	Personne toucher bougie_!	
VO_LOOTA_BOSS_12h_Male_Kobold_Death_01	Pas… prendre…	
VO_LOOTA_BOSS_12h_Male_Kobold_Death1_01	Le supplice de la cale_!	
VO_LOOTA_BOSS_12h_Male_Kobold_Death2_01	Yo ho… non…	
VO_LOOTA_BOSS_12h_Male_Kobold_Death3_01	Ah, mille sabords_!	
VO_LOOTA_BOSS_12h_Male_Kobold_DefeatPlayer_01	Y-arrr_! Magnifique autosabordage_!	
VO_LOOTA_BOSS_12h_Male_Kobold_DefeatPlayer_02	Tout plein de trésors_! Ha ha_! Moi les montrer à Rafaam…	
VO_LOOTA_BOSS_12h_Male_Kobold_EmoteResponse_01	Fermez votre caquet, mineur de pacotille_!	
VO_LOOTA_BOSS_12h_Male_Kobold_EventCandleStolen_01	Quoi_? Règlement sur prendre bougie TRÈS clair_!	
VO_LOOTA_BOSS_12h_Male_Kobold_EventChargeBigMinion_01	Oh, ho HO_!	
VO_LOOTA_BOSS_12h_Male_Kobold_EventFindCandle_01	Oh, jolie bougie_! Chut… Moi prendre toi…	
VO_LOOTA_BOSS_12h_Male_Kobold_EventPlayCandle_01	MOI DIRE vous PAS PRENDRE_!	
VO_LOOTA_BOSS_12h_Male_Kobold_EventPlayerPlaysCrab_01	Éloignez ça_! Non_!	
VO_LOOTA_BOSS_12h_Male_Kobold_EventPlayerPlaysPatches_01	Non_! C’est moi qui commande_! MOI_!	
VO_LOOTA_BOSS_12h_Male_Kobold_EventPlayKoboldKing_01	Régicire.	
VO_LOOTA_BOSS_12h_Male_Kobold_GetTreasure1_01	Moi aussi avoir trésor_!	
VO_LOOTA_BOSS_12h_Male_Kobold_GetTreasure2_01	Du qui-brille digne d’un roi…	
VO_LOOTA_BOSS_12h_Male_Kobold_GetTreasure3_01	Moi avoir quelle carte_? Oh, bien_!	
VO_LOOTA_BOSS_12h_Male_Kobold_GetTreasure4_01	Ah… du trésor_!	
VO_LOOTA_BOSS_12h_Male_Kobold_GetTreasure5_01	Mon donjon_! Mon trésor_!	
VO_LOOTA_BOSS_12h_Male_Kobold_Intro_01	Vous lâcher qui-brille tout de suite_! Moi prendre_! À moi_!	
VO_LOOTA_BOSS_12h_Male_Kobold_Intro1_01	Par ma jambe de bois_!	
VO_LOOTA_BOSS_12h_Male_Kobold_Intro2_01	Par la barbe du cap’taine_!	
VO_LOOTA_BOSS_12h_Male_Kobold_Intro3_01	Oh… Yarrr… Parsambleu_!	
VO_LOOTA_BOSS_13h_Female_Undead_Death_01	<Death>	
VO_LOOTA_BOSS_13h_Female_Undead_DefeatPlayer_01	Voyons ce que vous aviez… Hmm_? Vraiment_? Vous avez vraiment choisi ces cartes_?	
VO_LOOTA_BOSS_13h_Female_Undead_EmoteResponse_01	C’est la première fois que vous venez dans ce donjon, on dirait. On n’aime pas trop les bavards ici.	
VO_LOOTA_BOSS_13h_Female_Undead_EventBagOfCoins_01	Oh, un aventurier fortuné…	
VO_LOOTA_BOSS_13h_Female_Undead_EventStealQuest_01	Arrêtez_! Sale voleur_!	
VO_LOOTA_BOSS_13h_Female_Undead_HeroPower_01	Derrière moi_!	
VO_LOOTA_BOSS_13h_Female_Undead_HeroPower1_01	Reculer.	
VO_LOOTA_BOSS_13h_Female_Undead_HeroPower2_01	Se déplacer vite.	
VO_LOOTA_BOSS_13h_Female_Undead_HeroPower3_01	Se cacher dans les ombres pour mieux en resurgir…	
VO_LOOTA_BOSS_13h_Female_Undead_HeroPower4_01	Ne jamais servir de cible.	
VO_LOOTA_BOSS_13h_Female_Undead_Intro_01	Donnez-moi le trésor et je vous offrirai une mort rapide.	
VO_LOOTA_BOSS_15h_Male_Human_Death_01	<Death>	
VO_LOOTA_BOSS_15h_Male_Human_DefeatPlayer_01	Bon, peut-être qu’en empruntant CE chemin, nous parviendrons à rentrer à Un’Goro.	
VO_LOOTA_BOSS_15h_Male_Human_EmoteResponse_01	On ne se serait pas déjà vus à Un’Goro_?	
VO_LOOTA_BOSS_15h_Male_Human_Intro_01	Par la Lumière, Karl_! Regarde OÙ nous avons atterri_!	
VO_LOOTA_BOSS_15h_Male_Human_PartnerDeath_01	Par la Lumière, vous avez tué Karl_!	
VO_LOOTA_BOSS_15h_Male_Human_TaggedIn1_01	Pousse-toi, je m’occupe de la suite.	
VO_LOOTA_BOSS_15h_Male_Human_TaggedIn2_01	C’est ridicule. Donne-moi les cartes.	
VO_LOOTA_BOSS_15h_Male_Human_TaggedIn3_01	Pousse-toi, c’est MON tour_!	
VO_LOOTA_BOSS_16h_Male_Troll_Death_01	Maintenant, je vais pouvoir me parler à moi-même_!	
VO_LOOTA_BOSS_16h_Male_Troll_DefeatPlayer_01	Hé, ne vous inquiétez pas, petit cadavre. Azun, il vous tient compagnie maintenant.	
VO_LOOTA_BOSS_16h_Male_Troll_EmoteResponse_01	Moi, je parle aux morts. Toi, tu parles à ma main.	
VO_LOOTA_BOSS_16h_Male_Troll_EventPlayerDeathrattle1_01	Ha ha, elle est bonne, celle-là.	
VO_LOOTA_BOSS_16h_Male_Troll_EventPlayerDeathrattle2_01	Personne ne repose en paix, ici.	
VO_LOOTA_BOSS_16h_Male_Troll_EventPlayerDeathrattle3_01	La mort, elle lui va bien.	
VO_LOOTA_BOSS_16h_Male_Troll_EventPlayerDeathrattle4_01	Mieux vaut mort que jamais.	
VO_LOOTA_BOSS_16h_Male_Troll_EventPlayerDeathrattle5_01	On ne meurt que deux fois.	
VO_LOOTA_BOSS_16h_Male_Troll_Intro_01	Je parle… aux morts_! D’accord_? D’accord_!	
VO_LOOTA_BOSS_17h_Male_Troll_Death_01	<Death>	
VO_LOOTA_BOSS_17h_Male_Troll_DefeatPlayer_01	Vous vouliez affronter Jin’zo_? Jin’zo, il vous a fait payer cet affront.	
VO_LOOTA_BOSS_17h_Male_Troll_EmoteResponse_01	C’est pas le moment de parler. C’est le moment de PLEURER_!	
VO_LOOTA_BOSS_17h_Male_Troll_EventPlayerBattlecry1_01	J’aime le cran de celle-ci.	
VO_LOOTA_BOSS_17h_Male_Troll_EventPlayerBattlecry2_01	Jin’zo approuve_!	
VO_LOOTA_BOSS_17h_Male_Troll_EventPlayerBattlecry3_01	Oui, celle-ci, elle parle à Jin’zo_!	
VO_LOOTA_BOSS_17h_Male_Troll_EventPlayerBrann_01	Le nain, il croit qu’il peut crier aussi fort que Jin’zo_? NON_!	
VO_LOOTA_BOSS_17h_Male_Troll_Intro_01	Jin’zo, il a des GRANDS projets pour vous_!	
VO_LOOTA_BOSS_19h_Male_Trogg_Death_01	<Death>	
VO_LOOTA_BOSS_19h_Male_Trogg_DefeatPlayer_01	Vous faites des sales coups, vous prenez des coups_!	
VO_LOOTA_BOSS_19h_Male_Trogg_EmoteResponse_01	Vous voulez des troggs_? Je vais vous en donner.	
VO_LOOTA_BOSS_19h_Male_Trogg_EventHandFull_01	Doucement, je… eh, j’en ai trop_!	
VO_LOOTA_BOSS_19h_Male_Trogg_HeroPower1_01	Viens là, trogg_!	
VO_LOOTA_BOSS_19h_Male_Trogg_HeroPower2_01	Causez toujours. J’en ai encore.	
VO_LOOTA_BOSS_19h_Male_Trogg_HeroPower3_01	Ils sentent la magie.	
VO_LOOTA_BOSS_19h_Male_Trogg_HeroPowerHard1_01	Quelle puissance.	
VO_LOOTA_BOSS_19h_Male_Trogg_HeroPowerHard2_01	Causez toujours.	
VO_LOOTA_BOSS_19h_Male_Trogg_HeroPowerHard3_01	Ahhhh… La magie…	
VO_LOOTA_BOSS_19h_Male_Trogg_Intro_01	À GENOUX devant les TROGGS_!	
VO_LOOTA_BOSS_20h_Male_Earthen_Death_01	Dormiiiiir…	
VO_LOOTA_BOSS_20h_Male_Earthen_DefeatPlayer_01	Le sanctum est sécurisé.	
VO_LOOTA_BOSS_20h_Male_Earthen_EmoteResponse_01	Je ne faillirai pas.	
VO_LOOTA_BOSS_20h_Male_Earthen_EventPlayerSilence_01	Oh… merci.	
VO_LOOTA_BOSS_20h_Male_Earthen_EventStatueDestroyed1_01	Vous retardez l’inévitable.	
VO_LOOTA_BOSS_20h_Male_Earthen_EventStatueDestroyed2_01	Ce n’est qu’une question de temps.	
VO_LOOTA_BOSS_20h_Male_Earthen_EventStatueDestroyed3_01	Vous profanez ce lieu.	
VO_LOOTA_BOSS_20h_Male_Earthen_EventStatueDestroyed4_01	Je… dois protéger… le sanctum…	
VO_LOOTA_BOSS_20h_Male_Earthen_EventStatueDestroyed5_01	J’ai une volonté de pierre…	
VO_LOOTA_BOSS_20h_Male_Earthen_HeroPower_01	RÉVEILLEZ-VOUS_!	
VO_LOOTA_BOSS_20h_Male_Earthen_HeroPowerNoStatues_01	RÉVEILLEZ-VOUS_! … Oh.	
VO_LOOTA_BOSS_20h_Male_Earthen_Intro_01	Partez. Il n’y a rien pour vous ici.	
VO_LOOTA_BOSS_22h_Male_Murloc_Death_01	<Death>	
VO_LOOTA_BOSS_22h_Male_Murloc_DeathSpecial_01	… !!	
VO_LOOTA_BOSS_22h_Male_Murloc_DefeatPlayer_01	…_! …_?	
VO_LOOTA_BOSS_22h_Male_Murloc_EmoteResponse_01	… ?!	
VO_LOOTA_BOSS_22h_Male_Murloc_EventFishUpChest_01	…	
VO_LOOTA_BOSS_22h_Male_Murloc_EventSummonCrab_01	… !!	
VO_LOOTA_BOSS_22h_Male_Murloc_FishLarge_02	… !	
VO_LOOTA_BOSS_22h_Male_Murloc_FishMedium_01	… ?	
VO_LOOTA_BOSS_22h_Male_Murloc_FishSmall_01	…	
VO_LOOTA_BOSS_22h_Male_Murloc_Intro_01	… !	
VO_LOOTA_BOSS_23h_Male_Furbolg_Death_01	<Death>	
VO_LOOTA_BOSS_23h_Male_Furbolg_DefeatPlayer_01	Que vos ossements servent d’avertissement aux autres.	
VO_LOOTA_BOSS_23h_Male_Furbolg_EmoteResponse_01	Continuez à parler, que mes bêtes vous trouvent…	
VO_LOOTA_BOSS_23h_Male_Furbolg_EventPlayBigMinion1_01	La traque… est terminée_!	
VO_LOOTA_BOSS_23h_Male_Furbolg_EventPlayBigMinion2_01	Vous n’en réchapperez pas.	
VO_LOOTA_BOSS_23h_Male_Furbolg_EventPlayBigMinion3_01	Ils sentent votre peur_!	
VO_LOOTA_BOSS_23h_Male_Furbolg_HeroPower1_01	Votre heure est venue…	
VO_LOOTA_BOSS_23h_Male_Furbolg_HeroPower2_01	Ma puissance ne fait que croître.	
VO_LOOTA_BOSS_23h_Male_Furbolg_HeroPower3_01	Mes bêtes VONT vous trouver.	
VO_LOOTA_BOSS_23h_Male_Furbolg_HeroPower4_01	Je connais ces tunnels. Contrairement à vous.	
VO_LOOTA_BOSS_23h_Male_Furbolg_HeroPower5_01	C’est MON terrain de chasse.	
VO_LOOTA_BOSS_23h_Male_Furbolg_Intro_01	Ici… C’est VOUS la proie_!	
VO_LOOTA_BOSS_25h_Male_Dragon_Death_01	<Death>	
VO_LOOTA_BOSS_25h_Male_Dragon_DefeatPlayer_01	Ces trésors, anciens et vénérables… Ici, ils resteront.	
VO_LOOTA_BOSS_25h_Male_Dragon_EmoteResponse_01	Hm. Je vais prendre ceci en considération.	
VO_LOOTA_BOSS_25h_Male_Dragon_EventMarinTheFox_01	Marin le malandrin_! Tu oses revenir ici_?	
VO_LOOTA_BOSS_25h_Male_Dragon_HeroPower1_01	Brûlez, intrus.	
VO_LOOTA_BOSS_25h_Male_Dragon_HeroPower2_01	Maudit pillard_!	
VO_LOOTA_BOSS_25h_Male_Dragon_HeroPower3_01	[x]Souffrez !	
VO_LOOTA_BOSS_25h_Male_Dragon_HeroPower4_01	[x]Disparaissez !	
VO_LOOTA_BOSS_25h_Male_Dragon_HeroPower5_01	Vous ne pouvez plus vous cacher.	
VO_LOOTA_BOSS_25h_Male_Dragon_Intro_01	Montrez-vous, misérable voleur.	
VO_LOOTA_BOSS_25h_Male_Dragon_TreasureDestroy1_01	Ça ne vous appartient pas_!	
VO_LOOTA_BOSS_25h_Male_Dragon_TreasureDestroy2_01	[x]Voleur !	
VO_LOOTA_BOSS_25h_Male_Dragon_TreasureDestroy3_01	Rendez-le-moi_!	
VO_LOOTA_BOSS_25h_Male_Dragon_TreasureDestroy4_02	Ne soyez pas si cupide_!	
VO_LOOTA_BOSS_25h_Male_Dragon_TreasureDestroy5_01	Vous paierez le prix de votre cupidité.	
VO_LOOTA_BOSS_26h_Female_Demon_Death_01	<Death>	
VO_LOOTA_BOSS_26h_Female_Demon_DefeatPlayer_01	Que d’effronterie vous faites preuve. Je vois tout.	
VO_LOOTA_BOSS_26h_Female_Demon_EmoteResponse_01	Je n’ai d’yeux… que pour vous.	
VO_LOOTA_BOSS_26h_Female_Demon_EyeStalkConfuse_01	Folie.	
VO_LOOTA_BOSS_26h_Female_Demon_EyeStalkDeath_01	Fatalité.	
VO_LOOTA_BOSS_26h_Female_Demon_EyeStalkDevitalize_01	Fatigue.	
VO_LOOTA_BOSS_26h_Female_Demon_EyeStalkFear_01	Frayeur.	
VO_LOOTA_BOSS_26h_Female_Demon_EyeStalkFire_01	Flamme.	
VO_LOOTA_BOSS_26h_Female_Demon_EyeStalkFrost_01	Froid.	
VO_LOOTA_BOSS_26h_Female_Demon_Intro_01	Arriver jusqu’ici demande de l’habileté… Laissez-moi vous regarder…	
VO_LOOTA_BOSS_32h_Male_Human_Death_01	<Death>	
VO_LOOTA_BOSS_32h_Male_Human_EmoteResponse_01	Je ne parle pas aux inconnus.	
VO_LOOTA_BOSS_32h_Male_Human_PartnerDeath_01	Oh non, pas George_!	
VO_LOOTA_BOSS_32h_Male_Human_TaggedIn1_01	Laisse-moi essayer_!	
VO_LOOTA_BOSS_32h_Male_Human_TaggedIn2_01	Laisse-moi t’aider, George_!	
VO_LOOTA_BOSS_32h_Male_Human_TaggedIn3_01	Je peux jouer, George_? Hein_? Dis, je peux_?	
VO_LOOTA_BOSS_34h_Male_Demon_Death_01	<Death>	
VO_LOOTA_BOSS_34h_Male_Demon_DefeatPlayer_01	J’en veux plus… PLUS_!	
VO_LOOTA_BOSS_34h_Male_Demon_EmoteResponse_01	Je me gorge de votre peur et me nourris de vos remords.	
VO_LOOTA_BOSS_34h_Male_Demon_HeroPower1_01	Je me nourris.	
VO_LOOTA_BOSS_34h_Male_Demon_HeroPower2_01	Plus…	
VO_LOOTA_BOSS_34h_Male_Demon_HeroPower3_01	J’en veux plus…	
VO_LOOTA_BOSS_34h_Male_Demon_HeroPower4_01	Je dévorerai ce monde.	
VO_LOOTA_BOSS_34h_Male_Demon_HeroPower5_01	C’est la fin pour vous.	
VO_LOOTA_BOSS_34h_Male_Demon_Intro_01	J’AI FAIM.	
VO_LOOTA_BOSS_35h_Male_Furbolg_Death_01	Faites demi-tour… Seule la mort vous attend dans les profondeurs_!	
VO_LOOTA_BOSS_35h_Male_Furbolg_DefeatPlayer_01	Votre âme est enfin libre, séparée de votre corps.	
VO_LOOTA_BOSS_35h_Male_Furbolg_EmoteResponse_01	Si vous cherchez la paix, abandonnez vos trésors et fuyez.	
VO_LOOTA_BOSS_35h_Male_Furbolg_Intro_01	Partez_! Votre magie est inutile ici_!	
VO_LOOTA_BOSS_35h_Male_Furbolg_SpellCountered1_01	Votre magie ne sert qu’à nourrir notre labyrinthe. 	
VO_LOOTA_BOSS_35h_Male_Furbolg_SpellCountered2_01	[x]Silence !	
VO_LOOTA_BOSS_35h_Male_Furbolg_SpellCountered3_01	Vos forces déclinent.	
VO_LOOTA_BOSS_35h_Male_Furbolg_SpellCountered4_01	Ma magie est plus forte que la vôtre…	
VO_LOOTA_BOSS_35h_Male_Furbolg_SpellCountered5_01	Nul ne peut rivaliser avec les coutumes ancestrales.	
VO_LOOTA_BOSS_37h_Female_BloodElf_Death_01	Je brûle_!	
VO_LOOTA_BOSS_37h_Female_BloodElf_DefeatPlayer_01	Quand on joue avec MON feu, on se brûle…	
VO_LOOTA_BOSS_37h_Female_BloodElf_EmoteResponse_01	Vous êtes grillé_!	
VO_LOOTA_BOSS_37h_Female_BloodElf_EventFireball_01	Feu… FEU_!	
VO_LOOTA_BOSS_37h_Female_BloodElf_EventPyroblast_01	C’est chaud, chaud CHAUD_!	
VO_LOOTA_BOSS_37h_Female_BloodElf_EventRagnaros_01	ÇA, c’est un combat comme je les aime_!	
VO_LOOTA_BOSS_37h_Female_BloodElf_EventTheCandle_01	Donc… VOUS avez pris la bougie_?	
VO_LOOTA_BOSS_37h_Female_BloodElf_Flamewakers_01	Ça va être un véritable feu d’artifice_!	
VO_LOOTA_BOSS_37h_Female_BloodElf_HeroPower1_01	Il me faut plus de puissance…	
VO_LOOTA_BOSS_37h_Female_BloodElf_HeroPower2_01	Encore… plus_!	
VO_LOOTA_BOSS_37h_Female_BloodElf_HeroPower3_01	Les sorts, c’est marrant_! Trop marrant_!	
VO_LOOTA_BOSS_37h_Female_BloodElf_Intro_01	Mes flammes vont vous faire danser_!	
VO_LOOTA_BOSS_38h_Male_Kobold_Death_01	[x]Malédiction !	
VO_LOOTA_BOSS_38h_Male_Kobold_DefeatPlayer_01	Moi savoir mon vaudou meilleur_!	
VO_LOOTA_BOSS_38h_Male_Kobold_EmoteResponse_01	Moi vous maudire_!	
VO_LOOTA_BOSS_38h_Male_Kobold_EventBrann_01	Vaudou nain être bizarre.	
VO_LOOTA_BOSS_38h_Male_Kobold_EventPlayerBattlecries1_01	Lui beaucoup crier.	
VO_LOOTA_BOSS_38h_Male_Kobold_EventPlayerBattlecries2_01	Lui crier beaucoup.	
VO_LOOTA_BOSS_38h_Male_Kobold_EventPlayerBattlecries3_01	Tous beaucoup crier.	
VO_LOOTA_BOSS_38h_Male_Kobold_EventPlayerDeathrattles1_01	Lui beaucoup râler.	
VO_LOOTA_BOSS_38h_Male_Kobold_EventPlayerDeathrattles3_01	Son vaudou être mortel.	
VO_LOOTA_BOSS_38h_Male_Kobold_EventRivendare_01	Vaudou des morts être le pire vaudou.	
VO_LOOTA_BOSS_38h_Male_Kobold_Intro_01	Moi faire vaudou aussi_!	
VO_LOOTA_BOSS_39h_Male_Golem_Death_01	Je suis… brisé…	
VO_LOOTA_BOSS_39h_Male_Golem_DefeatPlayer_01	Le trésor est sécurisé.	
VO_LOOTA_BOSS_39h_Male_Golem_EmoteResponse_01	Vous n’êtes pas le maître.	
VO_LOOTA_BOSS_39h_Male_Golem_HeroPower1_01	Écraser.	
VO_LOOTA_BOSS_39h_Male_Golem_HeroPower2_01	Piétiner.	
VO_LOOTA_BOSS_39h_Male_Golem_HeroPower3_01	Personne ne passe_!	
VO_LOOTA_BOSS_39h_Male_Golem_HeroPower4_01	Si… petit…	
VO_LOOTA_BOSS_39h_Male_Golem_HeroPower5_01	Hors de ma vue_!	
VO_LOOTA_BOSS_39h_Male_Golem_Intro_01	Défendre… le trésor…	
VO_LOOTA_BOSS_40h_Female_Dragon_Death_01	<Death>	
VO_LOOTA_BOSS_40h_Female_Dragon_DefeatPlayer_01	Le vol draconique du Crépuscule s’élèvera de nouveau_!	
VO_LOOTA_BOSS_40h_Female_Dragon_EmoteResponse_01	Nous ne parviendrons pas à nous mettre d’accord.	
VO_LOOTA_BOSS_40h_Female_Dragon_EventPlayTwilightDrake_01	Petit frère, ne nous trahis pas.	
VO_LOOTA_BOSS_40h_Female_Dragon_EventPlayTwilightWhelp_01	Reviens parmi les tiens, petit_!	
VO_LOOTA_BOSS_40h_Female_Dragon_HeroPower1_01	Nourrissez-moi…_!	
VO_LOOTA_BOSS_40h_Female_Dragon_HeroPower2_01	Votre force me porte.	
VO_LOOTA_BOSS_40h_Female_Dragon_HeroPower3_01	Mon peuple persévérera.	
VO_LOOTA_BOSS_40h_Female_Dragon_HeroPower4_01	Rejoignez le Crépuscule.	
VO_LOOTA_BOSS_40h_Female_Dragon_Intro_01	Je sens une grande puissance en vous. Approchez…	
VO_LOOTA_BOSS_41h_Male_Kobold_Death_01	<Death>	
VO_LOOTA_BOSS_41h_Male_Kobold_DefeatPlayer_01	MOI prendre bougie. Vous RIEN prendre_!	
VO_LOOTA_BOSS_41h_Male_Kobold_EmoteResponse_01	Fermer clapet_! Vous battre_!	
VO_LOOTA_BOSS_41h_Male_Kobold_EventHornOfCenarius_01	Quoi… QUOI_? Vous pas respecter les règles_!	
VO_LOOTA_BOSS_41h_Male_Kobold_HeroPower1_01	Tout le monde… Attaquer_!	
VO_LOOTA_BOSS_41h_Male_Kobold_HeroPower2_01	[x]Bagarre !	
VO_LOOTA_BOSS_41h_Male_Kobold_HeroPower3_01	Tous venir_!	
VO_LOOTA_BOSS_41h_Male_Kobold_Intro_01	Vous rendre bougie_!	
VO_LOOTA_BOSS_42h_Female_Furbolg_Armor10_01	Je remercie ceux qui m’ont précédée.	
VO_LOOTA_BOSS_42h_Female_Furbolg_Armor15_01	Puissants sont les anciens_!	
VO_LOOTA_BOSS_42h_Female_Furbolg_Armor20_01	Renoncez à vos trésors, votre cause est sans espoir_!	
VO_LOOTA_BOSS_42h_Female_Furbolg_Armor5_01	Je combats sans crainte.	
VO_LOOTA_BOSS_42h_Female_Furbolg_Death_01	Je rejoins… mes ancêtres…	
VO_LOOTA_BOSS_42h_Female_Furbolg_DefeatPlayer_01	Loués soient les esprits des anciens_! Ils sont mon bouclier et mon salut.	
VO_LOOTA_BOSS_42h_Female_Furbolg_EmoteResponse_01	Les esprits des anciens… ne vous aiment pas beaucoup.	
VO_LOOTA_BOSS_42h_Female_Furbolg_Intro_01	Esprits des anciens_! Entendez mon appel.	
VO_LOOTA_BOSS_43h_Female_Djinn_Death_01	<Death>	
VO_LOOTA_BOSS_43h_Female_Djinn_DefeatPlayer_01	N’est-ce pas là tout ce que vous souhaitiez_?	
VO_LOOTA_BOSS_43h_Female_Djinn_EmoteResponse_01	Qui gâcherait un vœu pour ça_?	
VO_LOOTA_BOSS_43h_Female_Djinn_HeroAbility1_01	Quel est votre souhait_?	
VO_LOOTA_BOSS_43h_Female_Djinn_HeroAbility2_01	Un… Deux… Trois…	
VO_LOOTA_BOSS_43h_Female_Djinn_HeroAbility3_01	Vœu exaucé_!	
VO_LOOTA_BOSS_43h_Female_Djinn_HeroAbilityHandFull1_01	Hé hé hé.	
VO_LOOTA_BOSS_43h_Female_Djinn_HeroAbilityHandFull2_01	C’était trop pour vous_?	
VO_LOOTA_BOSS_43h_Female_Djinn_HeroAbilityHandFull3_01	Les vœux ne sont pas à prendre à la légère.	
VO_LOOTA_BOSS_43h_Female_Djinn_Intro_01	J’exaucerai tous vos souhaits… tant que vous en payez le prix.	
VO_LOOTA_BOSS_44h_Female_Dragon_Death_01	<Death>	
VO_LOOTA_BOSS_44h_Female_Dragon_DefeatPlayer_01	Tous partis maintenant_! Au revoir_!	
VO_LOOTA_BOSS_44h_Female_Dragon_EmoteResponse_01	Pas la mama_!	
VO_LOOTA_BOSS_44h_Female_Dragon_Intro_01	C’est l’heure de manger_?	
VO_LOOTA_BOSS_45h_Male_Gnome_Death_01	<Death>	
VO_LOOTA_BOSS_45h_Male_Gnome_DefeatPlayer_01	La vie donne et elle reprend. Moi, je prends votre vie.	
VO_LOOTA_BOSS_45h_Male_Gnome_EmoteResponse_01	Ce lieu est comme un labyrinthe truffé de pièges mortels et peuplé de monstres sanguinaires.	
VO_LOOTA_BOSS_45h_Male_Gnome_HeroPower1_01	Ah, brillant.	
VO_LOOTA_BOSS_45h_Male_Gnome_HeroPower2_01	Hé hé…	
VO_LOOTA_BOSS_45h_Male_Gnome_HeroPower3_01	Face_! Je gagne.	
VO_LOOTA_BOSS_45h_Male_Gnome_HeroPower4_01	Pile_! Vous perdez.	
VO_LOOTA_BOSS_45h_Male_Gnome_Intro_01	Vos poches m’ont l’air bien trop pleines_!	
VO_LOOTA_BOSS_46h_Male_Murloc_Death_01	<Death>	
VO_LOOTA_BOSS_46h_Male_Murloc_DefeatPlayer_01	… …_? …_!	
VO_LOOTA_BOSS_46h_Male_Murloc_EmoteResponse_01	<Vomit.>	
VO_LOOTA_BOSS_46h_Male_Murloc_HeroPower1_01	…	
VO_LOOTA_BOSS_46h_Male_Murloc_HeroPower2_01	… ?	
VO_LOOTA_BOSS_46h_Male_Murloc_HeroPower3_01	…	
VO_LOOTA_BOSS_46h_Male_Murloc_Intro_01	… !!	
VO_LOOTA_BOSS_49h_Male_Elemental_Death_01	<Death>	
VO_LOOTA_BOSS_49h_Male_Elemental_DefeatPlayer_01	Mouah ha ha…	
VO_LOOTA_BOSS_49h_Male_Elemental_EmoteResponse_01	Moi prendre bougie. C’est mon truc. C’est ce que je fais.	
VO_LOOTA_BOSS_49h_Male_Elemental_HeroPower1_01	Les ténèbres…	
VO_LOOTA_BOSS_49h_Male_Elemental_HeroPower2_01	Fuyez…	
VO_LOOTA_BOSS_49h_Male_Elemental_HeroPower3_01	Mouah hé hé ha.	
VO_LOOTA_BOSS_49h_Male_Elemental_Intro_01	Votre lumière faiblit…	
VO_LOOTA_BOSS_50h_Male_Kobold_Death_01	<Death>	
VO_LOOTA_BOSS_50h_Male_Kobold_DefeatPlayer_01	Oh ouiii, ça être costaud_!	
VO_LOOTA_BOSS_50h_Male_Kobold_EmoteResponse_01	NON. Ni reprendre ni échanger.	
VO_LOOTA_BOSS_50h_Male_Kobold_EventKazakus_01	Kazakus en vouloir plus, hein_?	
VO_LOOTA_BOSS_50h_Male_Kobold_EventMakePotion1_01	Oh ça… Ça pas être bon.	
VO_LOOTA_BOSS_50h_Male_Kobold_EventMakePotion2_01	Oui, ça mauvais, très mauvais.	
VO_LOOTA_BOSS_50h_Male_Kobold_EventMakePotion3_01	Oh oui. Hé, vous en vouloir_? Ha, dommage.	
VO_LOOTA_BOSS_50h_Male_Kobold_EventUsePotion1_01	Oh_! Ça mauvais. Vous sentir_!	
VO_LOOTA_BOSS_50h_Male_Kobold_EventUsePotion2_01	Oui hé hé oui_!	
VO_LOOTA_BOSS_50h_Male_Kobold_EventUsePotion3_01	Doh… Ça être mauvais, mais bon mauvais.	
VO_LOOTA_BOSS_50h_Male_Kobold_Intro_01	Hé… pssst… Vous vouloir acheter champis_?	
VO_LOOTA_BOSS_51h_Male_Dwarf_Death_01	Bonsoir, Azeroth_!	
VO_LOOTA_BOSS_51h_Male_Dwarf_DefeatPlayer_02	Merci pour vos serviteurs_!	
VO_LOOTA_BOSS_51h_Male_Dwarf_EmoteResponse_01	Oh, un trouble-fête_?	
VO_LOOTA_BOSS_51h_Male_Dwarf_EventBoombox_01	Hé_! Baissez un peu le volume_!	
VO_LOOTA_BOSS_51h_Male_Dwarf_Intro_01	Restez un instant et écoutez-moi_!	
VO_LOOTA_BOSS_51h_Male_Dwarf_KillingBlowReady_01	Kobolds et Catacombes_!	
VO_LOOTA_BOSS_51h_Male_Dwarf_Song1A_01	Vous avez signé, dans la mine entrez…	
VO_LOOTA_BOSS_51h_Male_Dwarf_Song1B_01	Trouvez le filon d’exception_!	
VO_LOOTA_BOSS_51h_Male_Dwarf_Song1C_01	Du butin sans fin, mais le danger vient…	
VO_LOOTA_BOSS_51h_Male_Dwarf_Song1D_01	Et les tunnels sont pleins de malfaçons_!	
VO_LOOTA_BOSS_51h_Male_Dwarf_Song2A_01	Volez leur lumière, jouez la fille de l’air…	
VO_LOOTA_BOSS_51h_Male_Dwarf_Song2B_01	Évitez les dangers et les trappes.	
VO_LOOTA_BOSS_51h_Male_Dwarf_Song2C_01	Vous courez comme un fou, les monstres sont après vous…	
VO_LOOTA_BOSS_51h_Male_Dwarf_Song2D_01	Alors que vous tentez de déchiffrer la carte.	
VO_LOOTA_BOSS_51h_Male_Dwarf_Song3A_01	Ils vont vous avoir, plus d’échappatoire…	
VO_LOOTA_BOSS_51h_Male_Dwarf_Song3B_01	Dans ces tunnels sombres aux allures de tombe.	
VO_LOOTA_BOSS_51h_Male_Dwarf_Song3C_01	Pour si peu de gain, serait-ce votre fin_?	
VO_LOOTA_BOSS_51h_Male_Dwarf_Song3D_01	C’est Kobolds et Catacombes_!	
VO_LOOTA_BOSS_51h_Male_Dwarf_Steal_01	Viens par ici_!	
VO_LOOTA_BOSS_51h_Male_Dwarf_Steal_02	Par ici_!	
VO_LOOTA_BOSS_51h_Male_Dwarf_Steal_03	Le spectacle va commencer_!	
VO_LOOTA_BOSS_51h_Male_Dwarf_StealDoomsayer_01	Pire. Chanteur. Du. Monde_!	
VO_LOOTA_BOSS_51h_Male_Dwarf_StealMinstrel_01	Ah_! Enfin un duo_!	
VO_LOOTA_BOSS_53h2_Female_Undead_Death_01	Un paradoxe temporel_!	
VO_LOOTA_BOSS_53h2_Female_Undead_DefeatPlayer_01	Je savais que j’allais gagner. J’ai vu mon avenir.	
VO_LOOTA_BOSS_53h2_Female_Undead_EmoteResponse_01	Vous pensez me faire peur_? J’ai triomphé des dragons de bronze.	
VO_LOOTA_BOSS_53h2_Female_Undead_EventManaDestroyed_01	Vous ne faites que retarder l’inévitable_!	
VO_LOOTA_BOSS_53h2_Female_Undead_EventPlayerTimeWalk_01	Vous aussi, vous avez foulé l’île du Temps figé_?	
VO_LOOTA_BOSS_53h2_Female_Undead_Intro_01	Le temps peut être remonté. Aussi certainement que vous allez mourir.	
VO_LOOTA_BOSS_53h2_Female_Undead_RitualPrep1_01	Votre heure viendra…	
VO_LOOTA_BOSS_53h2_Female_Undead_RitualPrep2_01	Ma puissance augmente.	
VO_LOOTA_BOSS_53h2_Female_Undead_RitualPrep3_01	Tic tac…	
VO_LOOTA_BOSS_53h2_Female_Undead_TimeRewindPlayCard1_01	Je m’améliore à chaque fois.	
VO_LOOTA_BOSS_53h2_Female_Undead_TimeRewindPlayCard2_01	Nous avons déjà fait ça auparavant.	
VO_LOOTA_BOSS_53h2_Female_Undead_TimeRewindPlayCard3_01	Le temps joue en ma faveur.	
VO_LOOTA_BOSS_53h2_Female_Undead_TimeRewindPlayCard4_01	Celle qui contrôle le temps, contrôle l’infini_!	
VO_LOOTA_BOSS_53h2_Female_Undead_TimeRewindPlayCard5_01	Il est temps d’en finir_!	
VO_LOOTA_BOSS_53h2_Female_Undead_TimeRewindStart1_01	Contemplez ma découverte_!	
VO_LOOTA_BOSS_53h2_Female_Undead_TimeRewindStart2_01	Le moment est venu_!	
VO_LOOTA_BOSS_53h2_Female_Undead_TimeRewindStart3_01	Encore_! Faisons-le encore une fois_!	
VO_LOOTA_BOSS_53h2_Female_Undead_TimeRewindStart4_01	C’est mon moment_!	
VO_LOOTA_BOSS_54h_Female_Human_Death_01	J’étais pas prête_!	
VO_LOOTA_BOSS_54h_Female_Human_DefeatPlayer_01	Bon_! Je suis prête, maintenant.	
VO_LOOTA_BOSS_54h_Female_Human_EmoteResponse_01	Je reviens. Prévenez-moi quand la partie commence_!	
VO_LOOTA_BOSS_54h_Female_Human_Intro_01	<Chantonne>	
VO_LOOTA_BOSS_54h_Female_Human_Intro_02	<Chantonne>	
VO_LOOTA_BOSS_54h_Female_Human_Intro_03	<Chantonne>	
VO_LOOTA_BOSS_54h_Female_Human_Intro_04	<Siffle avec satisfaction>	
VO_LOOTA_BOSS_54h_Female_Human_Intro_07	<Chantonne>	
VO_LOOTA_BOSS_54h_Female_Human_WakeUp_01	Oh_! La partie a déjà commencé_?	
VO_Maiden_Female_Titan_FinalMaidenEmoteResponse_01	Votre comportement est inacceptable.	
VO_Maiden_Female_Titan_FinalMaidenEyeForAnEye_01	Justice est faite.	
VO_Maiden_Female_Titan_FinalMaidenHeroPower_01	Chassez vos pensées corrompues.	
VO_Maiden_Female_Titan_FinalMaidenHumility_01	Oui_! Mettez-vous à genoux, et je vous épargnerai peut-être_!	
VO_Maiden_Female_Titan_FinalMaidenOpen_01	Vous osez invoquer un agent des titans_?	
VO_Maiden_Female_Titan_FinalMaidenTurn5_01	Nous sommes éternels. Vous n’êtes pas digne_!	
VO_Malchezaar_Male_Demon_Brawl_06	Vous n’avez quand même pas pensé que vous pouviez gagner.	
VO_Malchezaar_Male_Demon_EmoteParty_01	Malchezaar aussi aime faire la fête_!	
VO_Malchezaar_Male_Demon_FinalAltOpening_01	Imbéciles heureux_!	
VO_Malchezaar_Male_Demon_FinalMalchezaarDeath_01	Non_! Non_! Pas encore_!	
VO_Malchezaar_Male_Demon_FinalMalchezaarEmoteResponse_01	Je serai votre perte_!	
VO_Malchezaar_Male_Demon_FinalMalchezaarHeroPower_01	Vous n’affrontez pas seulement Malchezaar, mais aussi les légions que je commande_!	
VO_Malchezaar_Male_Demon_FinalMalchezaarJaraxxus_01	Vous_! C’est mon invitation_!	
VO_Malchezaar_Male_Demon_FinalMalchezaarMedivhSkin_01	Vous êtes venu en costume_? Hmmm… Je pourrais faire ça…	
VO_Malchezaar_Male_Demon_FinalMalchezaarSacrificialPact_03	Ha ha ha_! Ça ne marchera jamais sur un véritable seigneur érédar_!	
VO_Malchezaar_Male_Demon_FinalMalchezaarTurn1_01	Le magus est puissant, mais nul ne peut espérer résister à un pouvoir aussi écrasant_!	
VO_Malchezaar_Male_Demon_FinalMalchezaarTurn7_01	J’entends de la musique_! Les Medivas_! La fête_! Ce soir, c’est ma soirée_!	
VO_Malchezaar_Male_Demon_FinalThirdSequence_01	De retour à Karazhan_? Juste à temps pour la fête_!	
VO_Malchezaar_Male_Demon_FinalThirdSequence_04	Hors de mon chemin, imbécile_!	
VO_Malchezaar_Male_Demon_PrologueEmoteResponse_01	Imbécile heureux_!	
VO_Malchezaar_Male_Demon_PrologueHeroPower_01	Toutes les réalités, toutes les dimensions me sont ouvertes_!	
VO_Malchezaar_Male_Demon_PrologueOpen_01	Où est mon invitation_?	
VO_Malchezaar_Male_Demon_PrologueTurn1_04	Vous ne m’avez pas invité_? Je suis un prince érédar_!	
VO_Malchezaar_Male_Demon_PrologueTurn11_02	Vous avez invité Jaraxxus_? Cet avorton_?	
VO_Malchezaar_Male_Demon_PrologueWin_01	Vous venez avec moi_!	
VO_Mediva_01_Female_Blood Elf_AranSpell_04	Ohh, Brrr.	
VO_Mediva_01_Female_Blood Elf_ChessEmoteOops_06	Oh oooh !	
VO_Mediva_01_Female_Blood Elf_PrologueTurn5_06	[x]Medivas !	
VO_Mediva_02_Female_Draenei_JulianneDeadlyPoison_02	Comme c’est tragique.	
VO_Mediva_02_Female_Draenei_PrologueTurn5_05	[x]Oui ?	
VO_Mediva_03_Male_Night Elf_AranHeroPower_01	Brûlez_! Brûlez_!	
VO_Mediva_03_Male_Night Elf_CuratorBeasts_04	Atchoum, bébé.	
VO_Mediva_03_Male_Night Elf_PrologueTurn5_01	Vous m’avez appelé ?	
VO_Medivas_Multiple_Multiple_CroneLionTigerBear_01	Oh mon dieu_!	
VO_Medivas_Multiple_Multiple_IllhoofWounded_01	Mmm, j’ai trop peur.	
VO_Medivas_Multiple_Multiple_NetherspiteTurn1_01	Les rayons_!	
VO_Medivh_Male_Human_EmoteGreetings_01	Qu’est-ce que tu fais ici_?	
VO_Medivh_Male_Human_EmoteOops_01	C’était ça votre plan_?	
VO_Medivh_Male_Human_EmoteSorry_01	Oh, ça n’a pas marché…	
VO_Medivh_Male_Human_EmoteThanks_01	Trop aimable.	
VO_Medivh_Male_Human_EmoteThreaten_01	Vous n’aviez aucune chance_!	
VO_Medivh_Male_Human_EmoteWellPlayed_01	Bien tenté, démon.	
VO_Medivh_Male_Human_EmoteWow_01	Ha ha_! C’était génial_!	
VO_Medivh_Male_Human_FinalMalchezaarTurn5_01	Excellent travail, Moroes, la fête bat son plein_!	
VO_Medivh_Male_Human_FinalMalchezaarWin_01	Beau travail_! Venez, c’est l’heure de faire la fête_!	
VO_Medivh_Male_Human_FinalMedivhMedivhSkin_01	Oh, une minute_! Tu es moi_?! Mais du futur_? Dis-moi… elle était comment cette fête_? GÉNIALE, pas vrai_?	
VO_Medivh_Male_Human_FinalThirdSequence_01	Ah, un invité_! Veuillez vous occuper du démon, j’ai une fête à préparer_!	
VO_Medivh_Male_Human_FinalThirdSequence_02	Il ne vous a pas laissé de cartes_? N’hésitez pas à utiliser les portails.	
VO_Medivh_Male_Human_FinalThirdSequence_03	Tenez, je vous prête mon bâton_; il contrôle les portails. Mais ne l’abîmez pas.	
VO_Medivh_Male_Human_PrologueDeath_02	Quoi_? Impossible…	
VO_Medivh_Male_Human_PrologueHeroPower_01	Mais pas cette fête_!	
VO_Medivh_Male_Human_PrologueOpen_01	Argh, encore toi_?	
VO_Medivh_Male_Human_PrologueTurn1_02	Après la dernière fois_? Nous sommes encore en train de réparer le trou dans le toit_!	
VO_Medivh_Male_Human_PrologueTurn11_01	Tu l’as déjà entendu au karaoké_? Il est incroyable_!	
VO_Medivh_Male_Human_PrologueTurn3_02	Moroes, vérifiez le jeu d’échec. Les vrais invités vont bientôt arriver.	
VO_Medivh_Male_Human_PrologueTurn9_01	Les ballons_! Moroes, nous avons oublié les ballons_!	
VO_Medivh_Male_Human_PrologueWin_01	Rentre chez toi, démon_!	
VO_Medivh_Male_Human_Wing0Intro_01	Nous avons animé l’argenterie, répété notre opéra et préparé la Ménagerie. Cette soirée promet d’être mémorable_!	
VO_Medivh_Male_Human_Wing4Win_01	Aventurier, allez_! Profitez de la fête_!	
VO_Mirror_Male_Mirror_MirrorDeath_01	Hé_! Vous avez triché_! Je veux une revanche_!	
VO_Mirror_Male_Mirror_MirrorEmoteResponse_01	Non, c’est vous_!	
VO_Mirror_Male_Mirror_MirrorFirstCard_01	Vous avez ça dans votre deck_???	
VO_Mirror_Male_Mirror_MirrorMedivhSkin_01	Oh_! Medivh, mes hommages_! Vous êtes très élégant pour… Quoi_?! Hé_! Attendez_! Vous n’êtes pas Medivh_!	
VO_Mirror_Male_Mirror_MirrorMirrorImage_01	Hé, c’est ma carte préférée_! Et la vôtre, c’est laquelle_? Enragé du magma_?	
VO_Mirror_Male_Mirror_MirrorOpen_02	QUOI DE NEUF_!	
VO_Mirror_Male_Mirror_MirrorTurn1_01	Ouh, vous êtes a-ffreux_!	
VO_Mirror_Male_Mirror_MirrorTurn3_01	Miroir, mon beau miroir, dis-moi qui est le plus beau_?	
VO_Mirror_Male_Mirror_MirrorTurn3_03	Pas toi, grand-père_!	
VO_Mirror_Male_Mirror_MirrorTurn5_02	Néfarius_? Plutôt Gro-farius, pas vrai_?	
VO_Mirror_Male_Mirror_MirrorWellPlayedResponse_01	J’aimerais pouvoir vous dire la même chose_! BIM_!	
VO_Moroes_Male_Human_AranTurn1_01	*soupir* Je vous présente Aran, le fantôme grincheux.	
VO_Moroes_Male_Human_AranTurn9_04	Les dragons ont dévoré tout le buffet. Et maintenant ils lorgnent les murlocs_!	
VO_Moroes_Male_Human_AranWin_01	Le portail se trouve dans la prochaine pièce_! Nous arrivons juste à temps_!	
VO_Moroes_Male_Human_ChessForfeit_02	Vous n’avez plus de pièces. La partie est perdue.	
VO_Moroes_Male_Human_ChessTurn1_03	Ici, les pièces attaqueront automatiquement à la fin de votre tour.	
VO_Moroes_Male_Human_ChessTurn3_01	Si une pièce se trouve entre deux ennemis, elle les attaquera tous les deux_!	
VO_Moroes_Male_Human_ChessTurn5_01	Bien positionner ses pièces est la clé de la victoire. Profitez de ces attaques doubles_!	
VO_Moroes_Male_Human_ChessTurn7_01	Les autres invités s’impatientent à l’extérieur_! Nous sommes presque à l’opéra mais nous devons nous dépêcher_!	
VO_Moroes_Male_Human_ChessTurn7_02	Vous n’avez pas beaucoup de pièces. Les perdre toutes serait synonyme de défaite.	
VO_Moroes_Male_Human_ChessTurn7_03	Vous n’avez pas beaucoup de pièces. Les perdre toutes serait synonyme de défaite.	
VO_Moroes_Male_Human_ChessWin_01	Excellent_! En route pour l’opéra_!	
VO_Moroes_Male_Human_CroneTurn5_02	Le chambellan Executus est en bas. Dois-je lui faire savoir qu’il est arrivé trop tôt_?	
VO_Moroes_Male_Human_CroneWin_01	Enfin_! Nous allons libérer le magicien_!	
VO_Moroes_Male_Human_CuratorTurn3_01	Le conservateur est désorienté_! Vous devez l’arrêter avant qu’il libère toutes les créatures_!	
VO_Moroes_Male_Human_CuratorWin_01	Très bien… Une petite modification ici… et il est comme neuf_!	
VO_Moroes_Male_Human_EndWing1_01	Excellent_! L’opéra se trouve juste en haut de cet escalier_! Je suis sûr que Barnes nous laissera passer sans faire d’histoires_!	
VO_Moroes_Male_Human_FinalAltTurn5_01	Tant de portails… Je me demande ce qu’il y a dans celui-ci…	
VO_Moroes_Male_Human_FinalMaidenTurn1_01	Désolé, occupez-vous de ça pendant que je cherche les bonnes commandes.	
VO_Moroes_Male_Human_FinalMaidenTurn7_03	Oh, c’est le monde des tentacules. Nous n’avons vraiment pas besoin de ça.	
VO_Moroes_Male_Human_FinalNazraTurn7_02	Repoussez cette orque, qu’on puisse ouvrir un autre portail_!	
VO_Moroes_Male_Human_FinalSecondSequence_01	Excellent_! Maintenant voyons si celui-ci fonctionne…	
VO_Moroes_Male_Human_FInalStartSequence_01	Hmmm… Voyons voir. Euh, peut-être celui-ci_?	
VO_Moroes_Male_Human_FinalThirdSequence_01	C’est ça_!	
VO_Moroes_Male_Human_FinalTurn1_02	Oups_! Mauvais portail. Combattez l’orque pour que je puisse réessayer.	
VO_Moroes_Male_Human_IllhoofKilrekResponse_01	Que cherchent-ils à invoquer_?	
VO_Moroes_Male_Human_JulianneTurn5_01	Barnes, laissez-nous passer_! Nous devons rejoindre Medivh avant que la fête soit gâchée_!	
VO_Moroes_Male_Human_JulianneTurn9_02	Illidan est arrivé_! Nous ne sommes pas prêts_!	
VO_Moroes_Male_Human_MedivhSkinResponse_01	Un costume de Medivh_? Eh bien, la ressemblance est frappante_!	
VO_Moroes_Male_Human_MirrorTurn3_01	Hmmm…	
VO_Moroes_Male_Human_MirrorTurn5_01	Le seigneur Nefarius va bientôt arriver. Je redoute sa réaction.	
VO_Moroes_Male_Human_MirrorWin_02	Excellent_! L’escalier qui mène à l’opéra se trouve un peu plus loin_!	
VO_Moroes_Male_Human_NetherspiteTurn1_01	Ces rayons renforcent le dragon. Servez-vous de serviteurs pour les bloquer_!	
VO_Moroes_Male_Human_NetherspiteTurn5_01	Dites-nous seulement lequel mène à Medivh_!	
VO_Moroes_Male_Human_NetherspiteTurn7_01	Nous avons besoin de ces portails_! Les invités jettent des livres dans le bassin de mana_!	
VO_Moroes_Male_Human_NetherspiteWin_01	Beau travail_! Maintenant, voyons si je me souviens comment ça fonctionne…	
VO_Moroes_Male_Human_NightbaneTurn3_01	Conservateur, nous devons secourir Medivh_!	
VO_Moroes_Male_Human_NightbaneTurn7_01	La ligue des Explorateurs est arrivée. RENO, REPOSEZ TOUT DE SUITE L’ARGENTERIE_!	
VO_Moroes_Male_Human_PrologueTurn11_01	*Hum* Et il n’a pas incendié la bibliothèque…	
VO_Moroes_Male_Human_PrologueTurn5_03	Monsieur, les Medivas sont en place. Barnes répète avec elles en ce moment même.	
VO_Moroes_Male_Human_PrologueTurn7_01	Avez-vous regardé dehors, monsieur_? Des boss de raid se battent pour une invitation.	
VO_Moroes_Male_Human_PrologueTurn9_02	Monsieur, les murlocs sont terrifiés par les ballons. Vous vous souvenez de la semaine dernière_?	
VO_Moroes_Male_Human_PrologueWin_02	Ce n’est pas bon. Pas bon du tout.	
VO_Moroes_Male_Human_SilverwareResponse_01	Argh. C’était une antiquité…	
VO_Moroes_Male_Human_SilverwareTurn3_02	L’argenterie se rassemble_! Nous sommes encerclés_!	
VO_Moroes_Male_Human_SilverwareWin_01	Quel bazar.	
VO_Moroes_Male_Human_Wing1Intro_02	Je suis Moroes, le régisseur de Karazhan et j’ai besoin de votre aide. Medivh a disparu_! Nous avons besoin des portails au sommet de la tour pour les sauver… lui et la fête_!	
VO_Moroes_Male_Human_Wing1Win_01	Bien joué_! À ce rythme, nous atteindrons le sommet de la tour à temps pour sauver la fête_!	
VO_Moroes_Male_Human_Wing2Win_01	En avant_! En haut de ces marches, le conservateur garde la Ménagerie. Pourvu qu’il fonctionne correctement…	
VO_Moroes_Male_Human_Wing3Open_02	Le conservateur garde la Ménagerie, le foyer des créatures les plus exotiques de tout Azeroth. Plus loin, se trouvent les appartements du maître et le portail pour sauver Medivh_!	
VO_Moroes_Male_Human_Wing3Win_02	Nous sommes presque au sommet_! Nous devons sauver Medivh avant que la fête vire à la bagarre générale_!	
VO_Moroes_Male_Human_Wing4Intro_01	Enfin_! Le sommet de la tour_! Trouvez le bon portail et ramenez Medivh_!	
VO_Moroes_Male_Human_Wing4Win_01	Vous avez réussi. Je n’arrive pas à croire que la fête ait commencé à l’heure. Vous pouvez revenir la semaine prochaine_? C’est l’anniversaire de Medivh et, euh… un petit coup de main ne serait pas de refus.	
VO_Moroes_Male_Human_WolfClaws_03	Je ne crois pas…	
VO_NAX1_01_CARD_02	Rien qu’une petite bouchée !	
VO_NAX1_01_DEATH_05	Pourquoi, oh pourquoi ?	
VO_NAX1_01_EMOTE_04	Ça parle !	
VO_NAX1_01_HP_03	Plus près, morceaux de choix !	
VO_NAX1_01_START_01	Ahh… Bienvenue dans mon antre.	
VO_NAX10_01_DEATH_LINE_03	Qu’est-ce que… R’cous…uuuuhhh…	
VO_NAX10_01_EMOTE1_04	Jouer ?	
VO_NAX10_01_EMOTE2_05	Oui ! Jouer ! Jouer !	
VO_NAX10_01_HP_02	Euh… Plus jouer ?	
VO_NAX10_01_START_01	R’cousu veut jouer !	
VO_NAX11_01_CARD_03	Limon.	
VO_NAX11_01_DEATH_05	*agh euh ahoh grr grrrlrrlrrlaaahhh*	
VO_NAX11_01_EMOTE_04	Pas parler.	
VO_NAX11_01_HP_02	Ça pue.	
VO_NAX11_01_START_01	Viande.	
VO_NAX12_01_CARD_01	*Rugissement*	
VO_NAX12_01_DEATH_01	*Gémit*	
VO_NAX12_01_EMOTE_01	*Râle*	
VO_NAX12_01_EMOTE_02	*Grrr*	
VO_NAX12_01_EMOTE_03	*Grrroooooo*	
VO_NAX12_01_HP_01	*Groooar SCRONCH*	
VO_NAX12_01_START_01	*Grognement*	
VO_NAX13_01_DEATH_LINE_03	Merci…	
VO_NAX13_01_EMOTE_04	Tueeer !	
VO_NAX13_01_HP_02	Meurs maintenant !	
VO_NAX13_01_START_01	Je dois obéir !	
VO_NAX14_01_CARD_01	*rrrrrAAAHH*	
VO_NAX14_01_DEATH_01	*Rugit*	
VO_NAX14_01_EMOTE_01	*rrrr Rrahhh !*	
VO_NAX14_01_EMOTE_02	*grraaaaah*	
VO_NAX14_01_EMOTE_03	*rooooaaar*	
VO_NAX14_01_HP_01	*grrrrrrr*	
VO_NAX14_01_START_01	*GRRRRRRRRR*	
VO_NAX15_01_BIGGLES_32	Non !!! Qu’une malédiction s’abatte sur toi !	
VO_NAX15_01_DEATH_LINE_08	Ce n’est pas la fin !!! Il y a toujours le mode héroïque !	
VO_NAX15_01_DEATH_LINE2_09	NooooOooOOOooooOOOOoooon !!!	
VO_NAX15_01_EMOTE_HELLO_26	Tu dis souvent ça aux gens qui veulent te tuer ?	
VO_NAX15_01_EMOTE_OOPS_29	En effet.	
VO_NAX15_01_EMOTE_SORRY_28	Ce n’est pas grave. Nous faisons tous des erreurs.	
VO_NAX15_01_EMOTE_THANKS_27	Euh… De rien ?	
VO_NAX15_01_EMOTE_THREATEN_30	Ouhh, je tremble !	
VO_NAX15_01_EMOTE_WP_25	Peuh ! Évidemment que j’ai bien joué. Je suis Kel’Thuzad !	
VO_NAX15_01_HP_07	Je vais te glacer le sang !	
VO_NAX15_01_HP2_05	Ton âme est à moi, maintenant.	
VO_NAX15_01_HP3_06	Impossible d’en réchapper.	
VO_NAX15_01_HURRY_31	Ma patience a des limites.	
VO_NAX15_01_PHASE2_10	Imbécile ! Tu as éparpillé tes forces !	
VO_NAX15_01_PHASE2_ALT_11	Non ! C’est terminé pour toi. À MON tour de jouer, maintenant !	
VO_NAX15_01_RESPOND_ANDUIN_24	Elle ne l’a pas apportée à Uther, en tout cas !	
VO_NAX15_01_RESPOND_GARROSH_15	Vraiment ? Alors, ce sera la mort.	
VO_NAX15_01_RESPOND_GARROSH_ALT_16	C’est une question-piège ? La mort… pour toi !	
VO_NAX15_01_RESPOND_GULDAN_22	Je dirais plutôt qu’elle sera à MOI.	
VO_NAX15_01_RESPOND_JAINA_23	Certainement pas ! C’est TOI qui déboules dans ma nécropole !	
VO_NAX15_01_RESPOND_MALFURION_ALT_21	La nature ! Alors que fais-tu dans Naxxramas ?	
VO_NAX15_01_RESPOND_REXXAR_19	Après toi.	
VO_NAX15_01_RESPOND_THRALL_17	Tout ça pour un marteau ? Mouais…	
VO_NAX15_01_RESPOND_UTHER_14	Et moi, avec des serviteurs puissants et des sorts dévastateurs. Bonne chance !	
VO_NAX15_01_RESPOND_VALEERA_18	Je n’y manquerai pas.	
VO_NAX15_01_START_13	Nous nous affrontons enfin.	
VO_NAX15_01_SUMMON_ADDS_12	Libérez-vous, mes serviteurs !	
VO_NAX2_01_CARD_02	Tuez-les au nom du maître !	
VO_NAX2_01_CUSTOM_03	Tu as échoué !	
VO_NAX2_01_DEATH_LINE_05	Le maître me vengera !	
VO_NAX2_01_EMOTE_06	Ha ha ha ha !	
VO_NAX2_01_HP_04	À genoux, vermisseau !	
VO_NAX2_01_START_01	Mes acolytes me servent sans poser de questions !	
VO_NAX3_01_CARD_01	*grghhghgh*	
VO_NAX3_01_DEATH_01	*Siffle*	
VO_NAX3_01_EMOTE_01	*Siffle*	
VO_NAX3_01_EMOTE_02	*Siffle*	
VO_NAX3_01_EMOTE_03	*Siffle*	
VO_NAX3_01_EMOTE_04	*Siffle*	
VO_NAX3_01_EMOTE_05	*Siffle*	
VO_NAX3_01_HP_01	*Siffle*	
VO_NAX3_01_START_01	*Glisse*	
VO_NAX4_01_CARD_03	Expire…	
VO_NAX4_01_DEATH_LINE_04	Je servirai le maître… dans la mort.	
VO_NAX4_01_EMOTE_06	Mourez, intrus !	
VO_NAX4_01_HP_02	Levez-vous, soldats ! Levez-vous et combattez une fois encore !	
VO_NAX4_01_START_01	Encore une âme pour ma collection.	
VO_NAX5_01_CARD_03	Je vais vous retourner le cerveau !	
VO_NAX5_01_DEATH_LINE_04	C’était ma dernière danse…	
VO_NAX5_01_EMOTE_05	J’ai pas le temps pour ces bêtises.	
VO_NAX5_01_HP_02	Dansez, maintenant !	
VO_NAX5_01_START_01	Vous pensez être en sécurité ?	
VO_NAX6_01_CARD_03	La fin est proche.	
VO_NAX6_01_DEATH_LINE_04	*rruuuhhhh*	
VO_NAX6_01_EMOTE_05	Économisez votre souffle.	
VO_NAX6_01_HP_02	Vous êtes à moi, maintenant.	
VO_NAX6_01_START_01	Je vous vois.	
VO_NAX7_01_CARD_03	Vous auriez dû rester chez vous !	
VO_NAX7_01_DEATH_LINE_04	Une mort honorable…	
VO_NAX7_01_EMOTE_05	Ha ha ha ! Je suis juste en train de m’échauffer !	
VO_NAX7_01_HP_02	Yieea !	
VO_NAX7_01_START_01	Non, non ! Mes disciples ! Rendez-les-moi !	
VO_NAX8_01_CARD_02	Tuez mes serviteurs si vous voulez… Leurs âmes reviendront vous hanter.	
VO_NAX8_01_CUSTOM_03	Ha ha ha ! Imbécile ! Je suis le Moissonneur d’âmes !	
VO_NAX8_01_CUSTOM2_04	Les morts reviennent !	
VO_NAX8_01_DEATH_LINE_05	Je suis… vaincu…	
VO_NAX8_01_EMOTE1_06	Dans votre folie, vous avez provoqué votre propre mort.	
VO_NAX8_01_EMOTE2_07	Dans votre arrogance, vous avez négligé des pouvoirs dépassant votre compréhension.	
VO_NAX8_01_EMOTE3_08	Vous avez durement combattu pour envahir le royaume du Moissonneur.	
VO_NAX8_01_EMOTE4_09	Il ne vous reste qu’une issue…	
VO_NAX8_01_EMOTE5_10	…vous rendre dans les options et CAPITULER.	
VO_NAX8_01_START_01	Mes serviteurs ne meurent jamais vraiment.	
VO_NAX9_01_CUSTOM_02	Assez jacassé. Qu’ils viennent !	
VO_NAX9_01_DEATH_LINE_03	Non ! J’ai besoin de plus de temps !	
VO_NAX9_01_EMOTE_04	Vous avez demandé la mort ?	
VO_NAX9_01_START_01	Nous réduirons vos os en poussière.	
VO_NAX9_02_CUSTOM_01	Rebroussez chemin tant que c’est encore possible !	
VO_NAX9_03_CUSTOM_01	Enfin, Zeliek, amusons-nous un peu.	
VO_NAX9_04_CUSTOM_01	Allez, viens te battre, mauviette !	
VO_Nazra_Female_Orc_FinalNazraChogall_02	Le clan du Marteau du crépuscule_? Ici_?	
VO_Nazra_Female_Orc_FinalNazraDeath_01	Pour la Horde…	
VO_Nazra_Female_Orc_FinalNazraEmoteResponse_01	Nazra va vous écraser_!	
VO_Nazra_Female_Orc_FinalNazraGrom_01	Grommash_?! Ça faisait tellement longtemps_!	
VO_Nazra_Female_Orc_FinalNazraHeroPower_01	Nazra régnera sur ce monde insignifiant_!	
VO_Nazra_Female_Orc_FinalStartSequence_01	Tremblez devant la Horde_!	
VO_NEFARIAN_ATRAMEDES_DEATH_76	Vous avez tué un dragon aveugle. Vous devriez avoir honte.	
VO_NEFARIAN_BARON_GEDDON_DEAD_40	Nous y sommes presque. Oui. Oui !	
VO_NEFARIAN_CHROMAGGUS_DEAD_63	En fait, Chromaggus était mon serviteur le plus faible. Alors, toujours aussi fier de vous ?	
VO_NEFARIAN_CHROMAGGUS1_59	Je lui ai mis deux têtes parce que deux têtes valent mieux qu’une !	
VO_NEFARIAN_CHROMAGGUS2_60	Je l’ai imprégné des pouvoirs de tous les vols draconiques ! Il est parfait !	
VO_NEFARIAN_CHROMAGGUS3_61	Beau travail, Chromaggus. Brave bête.	
VO_NEFARIAN_CHROMAGGUS4_62	Vous en avez plein la main ? Mouahaha ! Gentil chienchien.	
VO_NEFARIAN_COREN_DEAD_28	Le Sinistre écluseur, comme c’est drôle.	
VO_NEFARIAN_DRAKKISATH_DEAD_50	Ça commence à m’énerver.	
VO_NEFARIAN_DRAKKISATH_RESPOND_48	Oui, Drakkisath. Aventurier, VOUS ÊTES ENCORE DU MAUVAIS CÔTÉ DE LA MONTAGNE.	
VO_NEFARIAN_DRAKKISATH1_49	Écoutez, allez plutôt jouer en partie classée. Cette aventure n’est pas faite pour vous.	
VO_NEFARIAN_GARR_DEAD1_38	Vous devriez prendre un bout de Garr avec vous et le jeter dans le bassin de lave de Ragnaros. Il va adorer.	
VO_NEFARIAN_GARR2_35	Faites attention à ces choses rocheuses, vous voulez bien ?	
VO_NEFARIAN_GARR3_36	N’allez pas vous faire exploser. Vous avez encore un seigneur élémentaire à bannir.	
VO_NEFARIAN_GARR4_37	Vous savez, j’adore vous regarder à l’œuvre.	
VO_NEFARIAN_GRIMSTONE_DEAD1_30	Continuez comme ça et cette montagne sera bientôt débarrassée de Ragnaros !	
VO_NEFARIAN_HEROIC_BLOCK_77	Pas en mode héroïque !	
VO_NEFARIAN_MALORIAK_DEATH_PT1_72	Félicitations ! Quel tour de force !	
VO_NEFARIAN_MALORIAK_DEATH_PT2_73	Je pense que je vais vous trouver un nouveau nom, juste pour commémorer cet instant.	
VO_NEFARIAN_MALORIAK_DEATH_PT3_74	Tueur de serviteurs stupides, incompétents et décevants. Oui, c’est pas mal.	
VO_NEFARIAN_MALORIAK_TURN2_71	Maloriak, essaie de ne pas perdre face à ce mortel.	
VO_NEFARIAN_NEF_MISSION_66	C’EST DE LA TRICHE ! JE NE LE TOLÉRERAI PAS !	
VO_NEFARIAN_NEF2_65	Non ! NON ! JE VAIS VOUS DÉTRUIRE !!!	
VO_NEFARIAN_OMNOTRON_DEAD_69	Vous m’avez épargné de coûteuses réparations. Merci.	
VO_NEFARIAN_OMOKK_DEAD_46	ÇA N’A AUCUN SENS.	
VO_NEFARIAN_OMOKK1_44	Pourquoi êtes-vous venu ? Ragnaros est mort. Vous devriez fêter ça avec vos amis.	
VO_NEFARIAN_OMOKK2_45	Je ne comprends pas. Ragnaros n’est plus là-haut. Votre quête est terminée. RENTREZ CHEZ VOUS.	
VO_NEFARIAN_RAZORGORE_DEAD_55	Ces œufs devaient servir pour de glorieuses expériences !	
VO_NEFARIAN_REND_DEAD_53	OK, mortel. Vous cherchez le mauvais dragon.	
VO_NEFARIAN_REND1_52	Même cet orc sait que vous vous y prenez mal !	
VO_NEFARIAN_THAURISSAN_DEAD_32	Vous auriez aussi dû tuer l’autre nain ! Ne laissez aucun survivant !	
VO_NEFARIAN_THAURISSAN_DEAD2_33	Vous avez tué les deux nains ! Impressionnant, aventurier.	
VO_NEFARIAN_VAEL_DEAD_57	Ha ! Vous avez tué un des gentils ! Vous n’êtes pas triste ???	
VO_Netherspite_Male_Dragon_NetherspiteAngryChicken_01	Encore vous_! Pourquoi vous vous fourrez toujours dans mes portails_?!	
VO_Netherspite_Male_Dragon_NetherspiteDeath_01	Mes travaux…	
VO_Netherspite_Male_Dragon_NetherspiteEmoteResponse_01	Vous osez défier un dragon dans son propre laboratoire_?	
VO_Netherspite_Male_Dragon_NetherspiteEmpowerment_01	Tant de mondes_! Tant de choses à apprendre_!	
VO_Netherspite_Male_Dragon_NetherspiteOpen_01	Qui ose perturber mes recherches_?	
VO_Netherspite_Male_Dragon_NetherspiteShadowBreath_01	Allez-vous-en_!	
VO_Netherspite_Male_Dragon_NetherspiteTurn12_01	Si 12 murlocs quittent le portail rouge à 4 heures, et que C’Thun arrive à 5 heures…	
VO_Netherspite_Male_Dragon_NetherspiteTurn3_02	Mes expériences_! Laissez-les tranquilles_!	
VO_Netherspite_Male_Dragon_NetherspiteTurn5_01	Arrêtez de toucher aux portails_! Les modulations de flux sont calibrées de façon précise_!	
VO_Netherspite_Male_Dragon_NetherspiteTurn7_01	Cette fête a l’air sympa. Allez vous amuser et laissez mes portails tranquilles_!	
VO_Netherspite_Male_Dragon_NetherspiteUnstablePortal_01	Intéressant. Des fluctuations significatives indiquent des instabilités fondamentales.	
VO_Netherspite_Male_Dragon_NetherspiteUnstablePortal_02	Intéressant. Des instabilités fondamentales.	
VO_Nightbane_Roar	*GROAR*	
VO_PrinceKeleseth_Male_Vampire_ResponseLanaThel_01	Ma reine_!	
VO_PrinceTaldaram_Male_Vampire_ResponseLanaThel_01	Ma reine… Je suis assoiffé.	
VO_PrinceValanar_Male_Vampire_ResponseLanaThel_01	Reine Lana’thel_!	
VO_RAGNAROS_GRIMSTONE_DEAD2_66	C’EST TOI QUI VAS ÊTRE ÉLIMINÉ, SALE PETIT DRAGONNET !	
VO_RAGNAROS_NEF1_71	AVENTURIER. ON DIRAIT QUE VOUS AVEZ BESOIN D’AIDE.	
VO_RAGNAROS_NEF3_72	JE ME VENGERAI ! PAR LE FEU, SOYEZ PURIFIÉS !	
VO_RAGNAROS_NEF4_73	J’ENVOIE MES SERVITEURS POUR TE DÉTRUIRE, AILE NOIRE.	
VO_RAGNAROS_NEF5_74	RÉDUISEZ CE POMPEUX DRAGON EN CENDRES !	
VO_RAGNAROS_NEF6_75	CADEAU DES TERRES DE FEU !	
VO_RAGNAROS_NEF7_76	NUL NE PEUT ÉTEINDRE LES FLAMMES DU SEIGNEUR DU FEU !	
VO_RAGNAROS_NEF8_77	J’AURAI MA REVANCHE, DRAGON !	
VO_Rakanishu_Male_Elemental_CastSpell1_01	Pas prendre… MOI_!	
VO_Rakanishu_Male_Elemental_CastSpell2_01	Soyez purifiés par le feu_!	
VO_Rakanishu_Male_Elemental_CastSpell3_01	[x]Mourez !	
VO_Rakanishu_Male_Elemental_CastSpell4_01	Pour Rafaam_!	
VO_Rakanishu_Male_Elemental_CastSpell5_01	Vous brûlerez tous_!	
VO_Rakanishu_Male_Elemental_EventRagnaros_02	Mon héros_!	
VO_Rakanishu_Male_Elemental_Intro_01	À mort_! Prenez le trésor_!	
VO_SilverwareGolem_Male_SilverwareGolem_SilverwareDeath_02	La vaisselle est terminée…	
VO_SilverwareGolem_Male_SilverwareGolem_SilverwareEmoteResponse_01	C’est l’heure de sortir l’argenterie_!	
VO_SilverwareGolem_Male_SilverwareGolem_SilverwareForkedLightning_01	Vous voulez des fourchettes_? J’ai des fourchettes_!	
VO_SilverwareGolem_Male_SilverwareGolem_SilverwareHeroPower_01	Mettez la table_! Préparez le sol_!	
VO_SilverwareGolem_Male_SilverwareGolem_SilverwareKnifeJuggler_01	Oooh, joli lancer de couteau_!	
VO_SilverwareGolem_Male_SilverwareGolem_SilverwareOpen_01	Danser, c’est marrant_!	
VO_SilverwareGolem_Male_SilverwareGolem_SilverwarePlateTossing_01	Une assiette pour vous_! Une assiette pour vous_! Une assiette pour tout le monde_!	
VO_TB_MEDIVA1_001	Brûlez...	
VO_TB_MEDIVA1_002	Attention.	
VO_TB_MEDIVA1_003	Oh, Tito_!	
VO_TB_MEDIVA1_004	À tes souhaits.	
VO_TB_MEDIVA1_005	Bestial_!	
VO_TB_MEDIVA1_006	Trop mignons.	
VO_TB_MEDIVA1_007	Non_! Pas du poison_!	
VO_TB_MEDIVA1_008	[x]Brillant !	
VO_TB_MEDIVA1_009	Vous avez sonné_?	
VO_TB_MEDIVA2_001	[x]Chaud !	
VO_TB_MEDIVA2_002	Effrayantes.	
VO_TB_MEDIVA2_003	Ooh, c’est froid.	
VO_TB_MEDIVA2_004	Oh non_! Un piège_!	
VO_TB_MEDIVA2_005	Oh non, je ne peux pas regarder_!	
VO_TB_MEDIVA2_006	Plutôt mignon.	
VO_TB_MEDIVA2_007	J’adooore les diablotins.	
VO_TB_MEDIVA2_008	[x]Brillant !	
VO_TB_MEDIVA2_009	Atchoum. Hi_!	
VO_TB_MEDIVA2_010	Vous avez appelé_?	
VO_TB_MEDIVA3_001	[x]Chaud !	
VO_TB_MEDIVA3_002	Givré, le bonhomme_!	
VO_TB_MEDIVA3_003	Les effrayantes ténèbres_!	
VO_TB_MEDIVA3_004	Un piège_!	
VO_TB_MEDIVA3_005	Quelles belles bêtes_!	
VO_TB_MEDIVA3_006	Il a des chéris_!	
VO_TB_MEDIVA3_007	Oh non, sale temps.	
VO_TB_MEDIVA3_008	Ça, c’est ce que j’appelle du poison.	
VO_TB_MEDIVA3_009	Et maintenant, les Medivas_!	
VO_TB_MEDIVA3_010	[x]Oui !	
VO_Terenas_Male_Human_ICCDruidVictory_01	Autrefois protecteur de la faune et de la flore en Azeroth, Malfurion le Putride préserve désormais l’équilibre naturel en cultivant un jardin mortifère.	
VO_Terenas_Male_Human_ICCHunterVictory_01	Rexxar libéra les âmes piégées autrefois par le roi-liche et encocha une flèche noire tirée de son carquois. «_Viens, Misha_!_» dit-il. «_La traque commence…_»	
VO_Terenas_Male_Human_ICCMageVictory_01	La nouvelle liche de givre inspecta son domaine. Des légions de morts-vivants allaient lui permettre d’augmenter encore sa puissance. Elle ne sentit même pas son sang se transformer en glace dans ses veines.	
VO_Terenas_Male_Human_ICCPaladinVictory_01	Le noble paladin de jadis embrassa pleinement sa nouvelle existence. Menez une vie digne et vous n’aurez rien à craindre de lui. Mais gare à ceux qui cèdent au mal, car ils devront affronter son jugement dans la mort_!	
VO_Terenas_Male_Human_ICCPriestVictory_01	Le corps du jeune prince s’évapora dans les ombres. «_Je comprends tout désormais_», dit-il, une flamme bleue luisant dans ses yeux. «_J’ai été tellement naïf…_».	
VO_Terenas_Male_Human_ICCRogueVictory_01	Valeera l’Exsangue disparut dans la nuit. Ses spectres et ses ombres voient tout, et nul n’est à l’abri de ses lames glacées…	
VO_Terenas_Male_Human_ICCShamanVictory_01	La cacophonie des voix des morts submergea l’esprit du chaman. Le mort-voyant ferma les yeux et prononça cet unique mot_: «_Dormez…_»	
VO_Terenas_Male_Human_ICCWarlockVictory_01	Gul’dan prit enfin place sur le Trône de glace. La Porte des ténèbres s’ouvrit une fois de plus et une infinité de mondes tremblèrent face à lui.	
VO_Terenas_Male_Human_ICCWarriorVictory_01	L’ancien chef de guerre de la Horde embrassa son nouveau pouvoir. Les victimes gelées de son armée allaient se relever pour le servir, jusqu’à ce qu’il se rende maître de toutes les terres qu’il avait parcourues.	
VO_TIRION_INTRO_03	Qui parmi nos vaillants chevaliers sera sacré champion aujourd’hui ?	
VO_WhiteKing_Male_ChessPiece_ChessDeath_01	Échec et mat.	
VO_WhiteKing_Male_ChessPiece_ChessEmoteGreetings_01	Une petite partie_?	
VO_WhiteKing_Male_ChessPiece_ChessEmoteOops_01	Oh, une erreur.	
VO_WhiteKing_Male_ChessPiece_ChessEmoteSorry_01	Une conséquence malheureuse.	
VO_WhiteKing_Male_ChessPiece_ChessEmoteThanks_01	Vous êtes bien aimable.	
VO_WhiteKing_Male_ChessPiece_ChessEmoteThinking_01	Tour en A3…	
VO_WhiteKing_Male_ChessPiece_ChessEmoteThinking_02	Cavalier en F6…	
VO_WhiteKing_Male_ChessPiece_ChessEmoteThinking_03	Reine en E5… Euh, non, non, non…	
VO_WhiteKing_Male_ChessPiece_ChessEmoteThreaten_01	Je prédis un échec en 4 coups.	
VO_WhiteKing_Male_ChessPiece_ChessEmoteWellPlayed_01	Échec et mat.	
VO_WhiteKing_Male_ChessPiece_ChessEmoteWow_01	Ah, exceptionnel_!	
VO_WhiteKing_Male_ChessPiece_ChessOpen_02	En garde_!	
VOX_Nightbane_Start_01	[x]Groar !	
