TAG	TEXT	COMMENT
GAMEPLAY_EMOTE_EX1_323h_CONCEDE	你赢了…但这个世界已经在劫难逃！！	
GAMEPLAY_EMOTE_EX1_323h_ERROR_FULL_MINIONS	随从太多了！	
GAMEPLAY_EMOTE_EX1_323h_ERROR_GENERIC	我不能\n这么做！	
GAMEPLAY_EMOTE_EX1_323h_ERROR_HAND_FULL	手牌太多了！	
GAMEPLAY_EMOTE_EX1_323h_ERROR_I_ATTACKED	我已经进行过攻击了。	
GAMEPLAY_EMOTE_EX1_323h_ERROR_JUST_PLAYED	它才刚刚\n被召唤出来！	
GAMEPLAY_EMOTE_EX1_323h_ERROR_MINION_ATTACKED	那个东西已经攻击过了。	
GAMEPLAY_EMOTE_EX1_323h_ERROR_NEED_MANA	法力值不足！	
GAMEPLAY_EMOTE_EX1_323h_ERROR_NEED_WEAPON	我的武器\n在哪儿？	
GAMEPLAY_EMOTE_EX1_323h_ERROR_PLAY	我不能\n使用那个。	
GAMEPLAY_EMOTE_EX1_323h_ERROR_STEALTH	它会潜行。	
GAMEPLAY_EMOTE_EX1_323h_ERROR_TARGET	不能这么做。	
GAMEPLAY_EMOTE_EX1_323h_ERROR_TAUNT	有个会嘲讽的随从挡着我了！	
GAMEPLAY_EMOTE_EX1_323h_FIRE_FESTIVAL	让火焰熊熊燃烧吧！	
GAMEPLAY_EMOTE_EX1_323h_GOOD_GAME	精彩的比赛！	
GAMEPLAY_EMOTE_EX1_323h_GREETINGS	面对加拉克苏斯吧，燃烧军团的艾瑞达之王！	
GAMEPLAY_EMOTE_EX1_323h_HALLOWS_END	万圣节，\n见鬼吧！	
GAMEPLAY_EMOTE_EX1_323h_LOW_CARDS	我的套牌里\n剩下的卡牌\n不多了！	
GAMEPLAY_EMOTE_EX1_323h_LUNAR_NEW_YEAR	新年快乐！	
GAMEPLAY_EMOTE_EX1_323h_NO_CARDS	不！我已经\n没有卡牌了！	
GAMEPLAY_EMOTE_EX1_323h_NOBLEGARDEN	复活节快乐！	
GAMEPLAY_EMOTE_EX1_323h_OOPS	失误！	
GAMEPLAY_EMOTE_EX1_323h_PIRATE_DAY	我是加拉克\n苏斯！	
GAMEPLAY_EMOTE_EX1_323h_SORRY	加拉克苏斯…\n很抱歉。	
GAMEPLAY_EMOTE_EX1_323h_THANKS	谢谢。	
GAMEPLAY_EMOTE_EX1_323h_THINK1	嗯...	
GAMEPLAY_EMOTE_EX1_323h_THINK2	我想….	
GAMEPLAY_EMOTE_EX1_323h_THINK3	我应该怎样\n把你摧毁呢…	
GAMEPLAY_EMOTE_EX1_323h_THREATEN	湮灭！！	
GAMEPLAY_EMOTE_EX1_323h_TIMER	快没有\n时间了！	
GAMEPLAY_EMOTE_EX1_323h_WELL_PLAYED	打得不错！	
GAMEPLAY_EMOTE_EX1_323h_WINTERVEIL_GREETINGS	我会在这个\n冬幕节夺去\n你们的灵魂！	
GAMEPLAY_EMOTE_EX1_323h_WOW_04	难以置信！	
GAMEPLAY_EMOTE_HERO_01_CONCEDE	我选择死亡！	
GAMEPLAY_EMOTE_HERO_01_ERROR_FULL_MINIONS	我无法再拥有更多随从了。	
GAMEPLAY_EMOTE_HERO_01_ERROR_GENERIC	我不能\n那么做。	
GAMEPLAY_EMOTE_HERO_01_ERROR_HAND_FULL	我的手牌\n满了！	
GAMEPLAY_EMOTE_HERO_01_ERROR_I_ATTACKED	我已经进行过攻击了。	
GAMEPLAY_EMOTE_HERO_01_ERROR_JUST_PLAYED	那个随从需要一个回合进行\n准备。	
GAMEPLAY_EMOTE_HERO_01_ERROR_MINION_ATTACKED	那个随从已经进行过攻击了。	
GAMEPLAY_EMOTE_HERO_01_ERROR_NEED_MANA	我没有足够的法力值。	
GAMEPLAY_EMOTE_HERO_01_ERROR_NEED_WEAPON	我需要\n一把武器。	
GAMEPLAY_EMOTE_HERO_01_ERROR_PLAY	我无法\n使用它。	
GAMEPLAY_EMOTE_HERO_01_ERROR_STEALTH	我无法将具有潜行技能的\n随从作为目标。	
GAMEPLAY_EMOTE_HERO_01_ERROR_TARGET	这不是一个\n有效的目标。	
GAMEPLAY_EMOTE_HERO_01_ERROR_TAUNT	我必须攻击\n那个具有嘲讽技能的随从。	
GAMEPLAY_EMOTE_HERO_01_EVENT_FIRE_FESTIVAL	点燃篝火！	
GAMEPLAY_EMOTE_HERO_01_EVENT_LUNAR_NEW_YEAR	给你拜年了。	
GAMEPLAY_EMOTE_HERO_01_GOOD_GAME	精彩的比赛。	
GAMEPLAY_EMOTE_HERO_01_GREETINGS	嗬，你好。	
GAMEPLAY_EMOTE_HERO_01_HALLOWS_END	万圣节快乐。	
GAMEPLAY_EMOTE_HERO_01_LOW_CARDS	我的卡牌就快要用光了！	
GAMEPLAY_EMOTE_HERO_01_MIRROR_START	哈哈！有种\n来啊！	
GAMEPLAY_EMOTE_HERO_01_NO_CARDS	我已经没有卡牌了！	
GAMEPLAY_EMOTE_HERO_01_NOBLEGARDEN	复活节快乐！	
GAMEPLAY_EMOTE_HERO_01_OOPS	那真是个\n失误。	
GAMEPLAY_EMOTE_HERO_01_PIRATE_DAY	耶呀！闹\n翻天！	
GAMEPLAY_EMOTE_HERO_01_SORRY	发生这种事，我很抱歉。	
GAMEPLAY_EMOTE_HERO_01_START	不胜利，\n毋宁死！	
GAMEPLAY_EMOTE_HERO_01_THANKS	哼，谢谢。	
GAMEPLAY_EMOTE_HERO_01_THINK1	嗯...	
GAMEPLAY_EMOTE_HERO_01_THINK2	哼，我想….	
GAMEPLAY_EMOTE_HERO_01_THINK3	那么现在…	
GAMEPLAY_EMOTE_HERO_01_THREATEN	我要粉碎你！	
GAMEPLAY_EMOTE_HERO_01_TIMER	我要立刻\n作出决定！	
GAMEPLAY_EMOTE_HERO_01_WELL_PLAYED	打得不错。	
GAMEPLAY_EMOTE_HERO_01_WINTERVEIL_GREETINGS	冬幕节快乐！	
GAMEPLAY_EMOTE_HERO_01_WOW	真不错！	
GAMEPLAY_EMOTE_HERO_01A_CELEBRATE	嗨，嗨，嘿嘿！	
GAMEPLAY_EMOTE_HERO_01A_CONCEDE	啊，\n你战胜了我。	
GAMEPLAY_EMOTE_HERO_01A_ERROR_FULL_MINIONS	我的随从\n太多了。	
GAMEPLAY_EMOTE_HERO_01A_ERROR_GENERIC	我不能\n那么做。	
GAMEPLAY_EMOTE_HERO_01A_ERROR_HAND_FULL	我的手牌\n已经满了！	
GAMEPLAY_EMOTE_HERO_01A_ERROR_I_ATTACKED	我已经\n攻击过了。	
GAMEPLAY_EMOTE_HERO_01A_ERROR_JUST_PLAYED	那个随从需要一个回合进行\n准备。	
GAMEPLAY_EMOTE_HERO_01A_ERROR_MINION_ATTACKED	那个随从已经攻击过了。	
GAMEPLAY_EMOTE_HERO_01A_ERROR_NEED_MANA	我没有足够的法力值。	
GAMEPLAY_EMOTE_HERO_01A_ERROR_NEED_WEAPON	我需要\n一把武器。	
GAMEPLAY_EMOTE_HERO_01A_ERROR_PLAY	我不能使用\n这张牌。	
GAMEPLAY_EMOTE_HERO_01A_ERROR_STEALTH	我不能以潜行的随从\n作为目标。	
GAMEPLAY_EMOTE_HERO_01A_ERROR_TARGET	那不是一个\n有效的目标。	
GAMEPLAY_EMOTE_HERO_01A_ERROR_TAUNT	我必须攻击\n那个具有嘲讽的随从。	
GAMEPLAY_EMOTE_HERO_01A_EVENT_LUNAR_NEW_YEAR	新年快乐。	
GAMEPLAY_EMOTE_HERO_01A_FIRE_FESTIVAL	仲夏火焰节\n快乐！	
GAMEPLAY_EMOTE_HERO_01A_GOOD_GAME	精彩的比赛。	
GAMEPLAY_EMOTE_HERO_01A_GREETINGS	嘿，你好。	
GAMEPLAY_EMOTE_HERO_01A_HALLOWS_END	万圣节快乐，朋友。	
GAMEPLAY_EMOTE_HERO_01A_LOW_CARDS	我快要\n没有牌了！	
GAMEPLAY_EMOTE_HERO_01A_MIRROR_START	是的，为了\n卡兹莫丹！	
GAMEPLAY_EMOTE_HERO_01A_NO_CARDS	我没有牌\n可以用了！	
GAMEPLAY_EMOTE_HERO_01A_NOBLEGARDEN	复活节快乐！	
GAMEPLAY_EMOTE_HERO_01A_OOPS	这好像……\n不太对。	
GAMEPLAY_EMOTE_HERO_01A_PIRATE_DAY	呀啊啊！我是大海之王！	
GAMEPLAY_EMOTE_HERO_01A_SORRY	我很抱歉，\n朋友。	
GAMEPLAY_EMOTE_HERO_01A_START	为了\n卡兹莫丹！	
GAMEPLAY_EMOTE_HERO_01A_THANKS	啊，谢谢你！	
GAMEPLAY_EMOTE_HERO_01A_THINK1	嗯……	
GAMEPLAY_EMOTE_HERO_01A_THINK2	用这张？\n不，不行……	
GAMEPLAY_EMOTE_HERO_01A_THINK3	这么多选择……	
GAMEPLAY_EMOTE_HERO_01A_THREATEN	感受山丘之王的愤怒！	
GAMEPLAY_EMOTE_HERO_01A_TIMER	啊，我得作出决定！	
GAMEPLAY_EMOTE_HERO_01A_WELL_PLAYED	打得很好。	
GAMEPLAY_EMOTE_HERO_01A_WINTERVEIL_GREETINGS	享受这冬幕节吧！	
GAMEPLAY_EMOTE_HERO_01A_WOW	以我胡子的名义，真的吗！	
GAMEPLAY_EMOTE_HERO_02_CONCEDE	这局你赢了，朋友。	
GAMEPLAY_EMOTE_HERO_02_ERROR_FULL_MINIONS	我无法再拥有更多随从了。	
GAMEPLAY_EMOTE_HERO_02_ERROR_GENERIC	我无法\n这么做。	
GAMEPLAY_EMOTE_HERO_02_ERROR_HAND_FULL	我的手牌\n已经满了！	
GAMEPLAY_EMOTE_HERO_02_ERROR_I_ATTACKED	我已经进行过攻击了！	
GAMEPLAY_EMOTE_HERO_02_ERROR_JUST_PLAYED	那个随从需要一个回合进行\n准备。	
GAMEPLAY_EMOTE_HERO_02_ERROR_MINION_ATTACKED	那个随从已经进行过攻击了。	
GAMEPLAY_EMOTE_HERO_02_ERROR_NEED_MANA	我没有足够的法力值。	
GAMEPLAY_EMOTE_HERO_02_ERROR_NEED_WEAPON	我需要\n一把武器。	
GAMEPLAY_EMOTE_HERO_02_ERROR_PLAY	我无法\n使用它。	
GAMEPLAY_EMOTE_HERO_02_ERROR_STEALTH	我无法将具有潜行技能的\n随从作为目标。	
GAMEPLAY_EMOTE_HERO_02_ERROR_TARGET	这不是一个\n有效的目标。	
GAMEPLAY_EMOTE_HERO_02_ERROR_TAUNT	我必须攻击\n那个具有嘲讽技能的随从。	
GAMEPLAY_EMOTE_HERO_02_EVENT_FIRE_FESTIVAL	这是属于元素的节日！	
GAMEPLAY_EMOTE_HERO_02_EVENT_LUNAR_NEW_YEAR	给你拜年了。	
GAMEPLAY_EMOTE_HERO_02_GOOD_GAME	精彩的比赛。	
GAMEPLAY_EMOTE_HERO_02_GREETINGS	你好，朋友。	
GAMEPLAY_EMOTE_HERO_02_HALLOWS_END	万圣节快乐。	
GAMEPLAY_EMOTE_HERO_02_LOW_CARDS	我的卡牌就快要用光了！	
GAMEPLAY_EMOTE_HERO_02_MIRROR_START	为了霜狼氏族！	
GAMEPLAY_EMOTE_HERO_02_NO_CARDS	我已经没有\n卡牌了！	
GAMEPLAY_EMOTE_HERO_02_NOBLEGARDEN	复活节快乐，朋友。	
GAMEPLAY_EMOTE_HERO_02_OOPS	我犯了个\n错误。	
GAMEPLAY_EMOTE_HERO_02_PIRATE_DAY	嗨，伙计，看见我的鹦鹉了吗？	
GAMEPLAY_EMOTE_HERO_02_SORRY	真是抱歉。	
GAMEPLAY_EMOTE_HERO_02_START	为了\n毁灭之锤！	
GAMEPLAY_EMOTE_HERO_02_THANKS	我对你\n非常感谢。	
GAMEPLAY_EMOTE_HERO_02_THINK1	嗯...	
GAMEPLAY_EMOTE_HERO_02_THINK2	我想….	
GAMEPLAY_EMOTE_HERO_02_THINK3	怎么办呢…	
GAMEPLAY_EMOTE_HERO_02_THREATEN	元素之力\n会毁灭你！	
GAMEPLAY_EMOTE_HERO_02_TIMER	时间不多了！	
GAMEPLAY_EMOTE_HERO_02_WELL_PLAYED	打得不错。	
GAMEPLAY_EMOTE_HERO_02_WINTERVEIL_GREETINGS	冬幕节快乐！	
GAMEPLAY_EMOTE_HERO_02_WOW	难以置信！	
GAMEPLAY_EMOTE_HERO_02A_CELEBRATE	<欢庆节日！>	
GAMEPLAY_EMOTE_HERO_02A_CONCEDE	<你击败了我。>	
GAMEPLAY_EMOTE_HERO_02A_ERROR_FULL_MINIONS	<我的随从\n太多了。>	
GAMEPLAY_EMOTE_HERO_02A_ERROR_GENERIC	<我无法\n这么做。>	
GAMEPLAY_EMOTE_HERO_02A_ERROR_HAND_FULL	<我的手牌\n已经满了。>	
GAMEPLAY_EMOTE_HERO_02A_ERROR_I_ATTACKED	<我已经\n攻击过了。>	VO_HERO_15_ERROR04_43.wav
GAMEPLAY_EMOTE_HERO_02A_ERROR_JUST_PLAYED	<那个随从需要一个回合\n进行准备。>	
GAMEPLAY_EMOTE_HERO_02A_ERROR_MINION_ATTACKED	<那个随从已经进行过\n攻击了。>	
GAMEPLAY_EMOTE_HERO_02A_ERROR_NEED_MANA	<我需要更多的\n法力值。>	
GAMEPLAY_EMOTE_HERO_02A_ERROR_NEED_WEAPON	<我需要\n一把武器。>	
GAMEPLAY_EMOTE_HERO_02A_ERROR_PLAY	<我无法\n使用它。>	
GAMEPLAY_EMOTE_HERO_02A_ERROR_STEALTH	<我无法攻击\n具有潜行的随从！>	
GAMEPLAY_EMOTE_HERO_02A_ERROR_TARGET	<那不是一个\n有效的目标。>	
GAMEPLAY_EMOTE_HERO_02A_ERROR_TAUNT	<我必须攻击那个\n具有嘲讽的随从。>	
GAMEPLAY_EMOTE_HERO_02A_EVENT_LUNAR_NEW_YEAR	<新年快乐！>	
GAMEPLAY_EMOTE_HERO_02A_FIRE_FESTIVAL	<我的家乡可没有\n什么火焰节。>	
GAMEPLAY_EMOTE_HERO_02A_GREETINGS	<你好，\n年轻人。>	
GAMEPLAY_EMOTE_HERO_02A_HALLOWS_END	<过一个惊悚的万圣节吧，\n小蝌蚪们。>	
GAMEPLAY_EMOTE_HERO_02A_LOW_CARDS	<我的卡牌就\n快要用光了！>	
GAMEPLAY_EMOTE_HERO_02A_MIRROR_START	<年轻人？！我懂的\n可比你多。>	
GAMEPLAY_EMOTE_HERO_02A_NO_CARDS	<我已经没有\n卡牌了！>	
GAMEPLAY_EMOTE_HERO_02A_NOBLEGARDEN	<复活节快乐！>	
GAMEPLAY_EMOTE_HERO_02A_OOPS	<可恶！>	
GAMEPLAY_EMOTE_HERO_02A_PIRATE_DAY	<哪儿来的海盗？\n这地方是我们的！>	
GAMEPLAY_EMOTE_HERO_02A_SORRY	<原谅我，\n年轻人。>	
GAMEPLAY_EMOTE_HERO_02A_START	<年轻人，让我\n来给你上一课！>	
GAMEPLAY_EMOTE_HERO_02A_THANKS	<真的很\n感谢你。>	
GAMEPLAY_EMOTE_HERO_02A_THINK1	<该怎么办呢…>	VO_HERO_15_Thinking1_13.wav
GAMEPLAY_EMOTE_HERO_02A_THINK2	<很有趣的想法…>	
GAMEPLAY_EMOTE_HERO_02A_THINK3	<有可能吗…>	
GAMEPLAY_EMOTE_HERO_02A_THREATEN	<海洋的智慧\n会将你淹没！>	
GAMEPLAY_EMOTE_HERO_02A_TIMER	<年轻人，\n麻利点！>	
GAMEPLAY_EMOTE_HERO_02A_WELL_PLAYED	<打得不错。>	
GAMEPLAY_EMOTE_HERO_02A_WINTERVEIL_GREETINGS	<冬幕节快乐！>	
GAMEPLAY_EMOTE_HERO_02A_WOW	<不可思议！>	
GAMEPLAY_EMOTE_HERO_03_CONCEDE	我输了。	
GAMEPLAY_EMOTE_HERO_03_ERROR_FULL_MINIONS	我无法再拥有更多随从了。	
GAMEPLAY_EMOTE_HERO_03_ERROR_GENERIC	我无法\n这么做。	
GAMEPLAY_EMOTE_HERO_03_ERROR_HAND_FULL	我的手牌\n已经满了！	
GAMEPLAY_EMOTE_HERO_03_ERROR_I_ATTACKED	我已经进行过攻击了。	
GAMEPLAY_EMOTE_HERO_03_ERROR_JUST_PLAYED	那个随从需要一个回合进行\n准备。	
GAMEPLAY_EMOTE_HERO_03_ERROR_MINION_ATTACKED	那个随从已经进行过攻击了。	
GAMEPLAY_EMOTE_HERO_03_ERROR_NEED_MANA	我没有足够的法力值。	
GAMEPLAY_EMOTE_HERO_03_ERROR_NEED_WEAPON	我需要\n一把武器。	
GAMEPLAY_EMOTE_HERO_03_ERROR_PLAY	我无法\n使用它。	
GAMEPLAY_EMOTE_HERO_03_ERROR_STEALTH	我无法将具有潜行技能的\n随从作为目标。	
GAMEPLAY_EMOTE_HERO_03_ERROR_TARGET	这不是一个\n有效的目标。	
GAMEPLAY_EMOTE_HERO_03_ERROR_TAUNT	我必须攻击\n那个具有嘲讽技能的随从。	
GAMEPLAY_EMOTE_HERO_03_EVENT_LUNAR_NEW_YEAR	新年好。	
GAMEPLAY_EMOTE_HERO_03_FIRE_FESTIVAL	仲夏节快乐。	
GAMEPLAY_EMOTE_HERO_03_GOOD_GAME	精彩的比赛。	
GAMEPLAY_EMOTE_HERO_03_GREETINGS	很荣幸\n见到你。	
GAMEPLAY_EMOTE_HERO_03_HALLOWS_END	万圣节快乐。	
GAMEPLAY_EMOTE_HERO_03_LOW_CARDS	我的卡牌就快要用光了。	
GAMEPLAY_EMOTE_HERO_03_MIRROR_START	不用你提醒我。	
GAMEPLAY_EMOTE_HERO_03_NO_CARDS	我已经没有\n卡牌了！	
GAMEPLAY_EMOTE_HERO_03_NOBLEGARDEN	复活节快乐。	
GAMEPLAY_EMOTE_HERO_03_OOPS	我犯了个\n错误。	
GAMEPLAY_EMOTE_HERO_03_PIRATE_DAY	我的眼罩呢？	
GAMEPLAY_EMOTE_HERO_03_SORRY	对此我很\n抱歉。	
GAMEPLAY_EMOTE_HERO_03_START	当心你的\n背后。	
GAMEPLAY_EMOTE_HERO_03_THANKS	谢谢你。	
GAMEPLAY_EMOTE_HERO_03_THINK1	嗯...	
GAMEPLAY_EMOTE_HERO_03_THINK2	我想...	
GAMEPLAY_EMOTE_HERO_03_THINK3	选择很多...	
GAMEPLAY_EMOTE_HERO_03_THREATEN	你\n死到临头了！	
GAMEPLAY_EMOTE_HERO_03_TIMER	我得快点\n做出决定！	
GAMEPLAY_EMOTE_HERO_03_WELL_PLAYED	打得不错。	
GAMEPLAY_EMOTE_HERO_03_WINTERVEIL_GREETINGS	冬幕节快乐。	
GAMEPLAY_EMOTE_HERO_03_WOW	天呐。	
GAMEPLAY_EMOTE_HERO_04_CONCEDE	胜利属于你。	
GAMEPLAY_EMOTE_HERO_04_ERROR_FULL_MINIONS	我无法再拥有更多随从了。	
GAMEPLAY_EMOTE_HERO_04_ERROR_GENERIC	我无法\n这么做。	
GAMEPLAY_EMOTE_HERO_04_ERROR_HAND_FULL	我的手牌\n已经满了！	
GAMEPLAY_EMOTE_HERO_04_ERROR_I_ATTACKED	我已经进行过攻击了。	
GAMEPLAY_EMOTE_HERO_04_ERROR_JUST_PLAYED	那个随从需要一个回合进行\n准备。	
GAMEPLAY_EMOTE_HERO_04_ERROR_MINION_ATTACKED	那个随从已经进行过攻击了。	
GAMEPLAY_EMOTE_HERO_04_ERROR_NEED_MANA	我没有足够的法力值。	
GAMEPLAY_EMOTE_HERO_04_ERROR_NEED_WEAPON	我需要\n一把武器。	
GAMEPLAY_EMOTE_HERO_04_ERROR_PLAY	我无法\n使用它。	
GAMEPLAY_EMOTE_HERO_04_ERROR_STEALTH	我无法将具有潜行技能的\n随从作为目标。	
GAMEPLAY_EMOTE_HERO_04_ERROR_TARGET	这不是一个\n有效的目标。	
GAMEPLAY_EMOTE_HERO_04_ERROR_TAUNT	我必须攻击\n那个具有嘲讽技能的随从。	
GAMEPLAY_EMOTE_HERO_04_EVENT_LUNAR_NEW_YEAR	新年快乐！	
GAMEPLAY_EMOTE_HERO_04_FIRE_FESTIVAL	仲夏节快乐。	
GAMEPLAY_EMOTE_HERO_04_GOOD_GAME	精彩的比赛。	
GAMEPLAY_EMOTE_HERO_04_GREETINGS	很高兴\n见到你！	
GAMEPLAY_EMOTE_HERO_04_HALLOWS_END	万圣节快乐，勇士。	VO_HERO_04_HAPPY_HALLOWEEN_13.wav
GAMEPLAY_EMOTE_HERO_04_LOW_CARDS	我的卡牌就快要用光了！	
GAMEPLAY_EMOTE_HERO_04_MIRROR_START	圣光就是我的利刃！	
GAMEPLAY_EMOTE_HERO_04_NO_CARDS	我已经没有\n卡牌了！	
GAMEPLAY_EMOTE_HERO_04_NOBLEGARDEN	复活节快乐，勇士！	VO_HERO_04_HAPPY_NOBLEGARDEN_17.wav
GAMEPLAY_EMOTE_HERO_04_OOPS	真是失误。	
GAMEPLAY_EMOTE_HERO_04_PIRATE_DAY	嗨，给我把甲板擦干净！	VO_HERO_04_PIRATE_DAY_33.wav
GAMEPLAY_EMOTE_HERO_04_SORRY	我很抱歉。	
GAMEPLAY_EMOTE_HERO_04_START	荣耀赐予我\n力量！	
GAMEPLAY_EMOTE_HERO_04_THANKS	谢谢你。	
GAMEPLAY_EMOTE_HERO_04_THINK1	嗯...	
GAMEPLAY_EMOTE_HERO_04_THINK2	我想….	
GAMEPLAY_EMOTE_HERO_04_THINK3	让我想想…	
GAMEPLAY_EMOTE_HERO_04_THREATEN	接受正义的\n制裁吧！	
GAMEPLAY_EMOTE_HERO_04_TIMER	我必须\n立即行动！	
GAMEPLAY_EMOTE_HERO_04_WELL_PLAYED	打得不错。	
GAMEPLAY_EMOTE_HERO_04_WINTERVEIL_GREETINGS	冬幕节快乐，勇士！	
GAMEPLAY_EMOTE_HERO_04_WOW	我的圣光啊！	
GAMEPLAY_EMOTE_HERO_04A_CELEBRATE	今天是受圣光祝福的日子！	
GAMEPLAY_EMOTE_HERO_04A_CONCEDE	朋友，你赢了。我认输。	
GAMEPLAY_EMOTE_HERO_04A_ERROR_FULL_MINIONS	我已经拥有太多的随从。	
GAMEPLAY_EMOTE_HERO_04A_ERROR_GENERIC	我不能这么做。	
GAMEPLAY_EMOTE_HERO_04A_ERROR_HAND_FULL	我的手牌满了！	
GAMEPLAY_EMOTE_HERO_04A_ERROR_I_ATTACKED	我已经攻击过了。	
GAMEPLAY_EMOTE_HERO_04A_ERROR_JUST_PLAYED	给那个随从一个回合的准备时间。	
GAMEPLAY_EMOTE_HERO_04A_ERROR_MINION_ATTACKED	那个随从已经攻击过了。	
GAMEPLAY_EMOTE_HERO_04A_ERROR_NEED_MANA	我没有足够的法力值。	
GAMEPLAY_EMOTE_HERO_04A_ERROR_NEED_WEAPON	我需要一把武器。	
GAMEPLAY_EMOTE_HERO_04A_ERROR_PLAY	我不能使用这张牌。	
GAMEPLAY_EMOTE_HERO_04A_ERROR_STEALTH	我不能以潜行的随从作为目标。	
GAMEPLAY_EMOTE_HERO_04A_ERROR_TARGET	这不是一个合理的目标。	
GAMEPLAY_EMOTE_HERO_04A_ERROR_TAUNT	我必须攻击那个具有嘲讽的随从。	
GAMEPLAY_EMOTE_HERO_04A_FIRE_FESTIVAL	火焰节快乐。	
GAMEPLAY_EMOTE_HERO_04A_GOOD_GAME	精彩的比赛。	
GAMEPLAY_EMOTE_HERO_04A_GREETINGS	啊，你好，挑战者。	
GAMEPLAY_EMOTE_HERO_04A_HALLOWS_END	万圣节快乐。	
GAMEPLAY_EMOTE_HERO_04A_LOW_CARDS	我就快没牌了！	
GAMEPLAY_EMOTE_HERO_04A_LUNAR_NEW_YEAR	新年快乐！	
GAMEPLAY_EMOTE_HERO_04A_MIRROR_START	神圣之火，正是我的名号。	
GAMEPLAY_EMOTE_HERO_04A_NO_CARDS	我没有牌了！	
GAMEPLAY_EMOTE_HERO_04A_NOBLEGARDEN	复活节快乐。	
GAMEPLAY_EMOTE_HERO_04A_OOPS	这确实是个\n错误。	
GAMEPLAY_EMOTE_HERO_04A_PIRATE_DAY	呀啊，我要夺走你的财宝！	
GAMEPLAY_EMOTE_HERO_04A_SORRY	啊，向你致歉。	
GAMEPLAY_EMOTE_HERO_04A_START	神圣之火燃烧着我的战刃！	
GAMEPLAY_EMOTE_HERO_04A_THANKS	我由衷地\n感谢你。	
GAMEPLAY_EMOTE_HERO_04A_THINK1	嗯……	
GAMEPLAY_EMOTE_HERO_04A_THINK2	这样，或者这样……	
GAMEPLAY_EMOTE_HERO_04A_THINK3	我是不是应该……	
GAMEPLAY_EMOTE_HERO_04A_THREATEN	你将付出代价，败类！	
GAMEPLAY_EMOTE_HERO_04A_TIMER	行动起来！	
GAMEPLAY_EMOTE_HERO_04A_WELL_PLAYED	打得不错。	
GAMEPLAY_EMOTE_HERO_04A_WINTERVEIL_GREETINGS	享受这冬幕节吧！	
GAMEPLAY_EMOTE_HERO_04A_WOW	这简直难以\n置信！	
GAMEPLAY_EMOTE_HERO_05_CONCEDE	打得好，\n我认输。	
GAMEPLAY_EMOTE_HERO_05_ERROR_FULL_MINIONS	我无法再拥有更多随从了。	
GAMEPLAY_EMOTE_HERO_05_ERROR_GENERIC	我无法\n这么做。	
GAMEPLAY_EMOTE_HERO_05_ERROR_HAND_FULL	我的手牌\n已经满了！	
GAMEPLAY_EMOTE_HERO_05_ERROR_I_ATTACKED	我已经进行过攻击了。	
GAMEPLAY_EMOTE_HERO_05_ERROR_JUST_PLAYED	那个随从需要一个回合进行\n准备。	
GAMEPLAY_EMOTE_HERO_05_ERROR_MINION_ATTACKED	那个随从已经进行过攻击了。	
GAMEPLAY_EMOTE_HERO_05_ERROR_NEED_MANA	我没有足够的法力值。	
GAMEPLAY_EMOTE_HERO_05_ERROR_NEED_WEAPON	我需要\n一把武器。	
GAMEPLAY_EMOTE_HERO_05_ERROR_PLAY	我无法\n使用它。	
GAMEPLAY_EMOTE_HERO_05_ERROR_STEALTH	我无法将具有潜行技能的\n随从作为目标。	
GAMEPLAY_EMOTE_HERO_05_ERROR_TARGET	这不是一个\n有效的目标。	
GAMEPLAY_EMOTE_HERO_05_ERROR_TAUNT	我必须攻击\n那个具有嘲讽技能的随从。	
GAMEPLAY_EMOTE_HERO_05_EVENT_LUNAR_NEW_YEAR	新年\n狩猎愉快。	
GAMEPLAY_EMOTE_HERO_05_FIRE_FESTIVAL	仲夏节快乐。	
GAMEPLAY_EMOTE_HERO_05_GOOD_GAME	精彩的比赛。	
GAMEPLAY_EMOTE_HERO_05_GREETINGS	你好，\n旅行者。	
GAMEPLAY_EMOTE_HERO_05_HALLOWS_END	万圣节快乐。	
GAMEPLAY_EMOTE_HERO_05_LOW_CARDS	我的卡牌就快要用光了！	
GAMEPLAY_EMOTE_HERO_05_MIRROR_START	看谁笑到最后！	
GAMEPLAY_EMOTE_HERO_05_NO_CARDS	我已经没有\n卡牌了！	
GAMEPLAY_EMOTE_HERO_05_NOBLEGARDEN	复活节快乐！	
GAMEPLAY_EMOTE_HERO_05_OOPS	这不是我想要的结果。	
GAMEPLAY_EMOTE_HERO_05_PIRATE_DAY	关舷门！\n放海狗！	
GAMEPLAY_EMOTE_HERO_05_SORRY	抱歉。	
GAMEPLAY_EMOTE_HERO_05_START	狩猎开始了！	
GAMEPLAY_EMOTE_HERO_05_THANKS	谢谢。	
GAMEPLAY_EMOTE_HERO_05_THINK1	嗯...	
GAMEPLAY_EMOTE_HERO_05_THINK2	我想….	
GAMEPLAY_EMOTE_HERO_05_THINK3	嗯...	
GAMEPLAY_EMOTE_HERO_05_THREATEN	你将成为\n我的猎物！	
GAMEPLAY_EMOTE_HERO_05_TIMER	时间过得\n很快！	
GAMEPLAY_EMOTE_HERO_05_WELL_PLAYED	打得不错。	
GAMEPLAY_EMOTE_HERO_05_WINTERVEIL_GREETINGS	冬幕节快乐！	
GAMEPLAY_EMOTE_HERO_05_WOW	真厉害！	
GAMEPLAY_EMOTE_HERO_05A_CELEBRATE	哈哈，没错！	
GAMEPLAY_EMOTE_HERO_05A_CONCEDE	你技高一筹，\n我认输！	
GAMEPLAY_EMOTE_HERO_05A_ERROR_FULL_MINIONS	我已经拥有了太多的随从。	
GAMEPLAY_EMOTE_HERO_05A_ERROR_GENERIC	我不能\n这么做。	
GAMEPLAY_EMOTE_HERO_05A_ERROR_HAND_FULL	我的手牌\n满了！	
GAMEPLAY_EMOTE_HERO_05A_ERROR_I_ATTACKED	我已经\n攻击过了。	
GAMEPLAY_EMOTE_HERO_05A_ERROR_JUST_PLAYED	给那个随从\n一个回合的\n准备时间。	
GAMEPLAY_EMOTE_HERO_05A_ERROR_MINION_ATTACKED	那个随从已经攻击过了。	
GAMEPLAY_EMOTE_HERO_05A_ERROR_NEED_MANA	我没有足够的法力值。	
GAMEPLAY_EMOTE_HERO_05A_ERROR_NEED_WEAPON	我需要\n一把武器。	
GAMEPLAY_EMOTE_HERO_05A_ERROR_PLAY	我不能使用\n这张牌。	
GAMEPLAY_EMOTE_HERO_05A_ERROR_STEALTH	我不能以\n潜行的随从\n作为目标。	
GAMEPLAY_EMOTE_HERO_05A_ERROR_TARGET	这不是一个\n合理的目标。	
GAMEPLAY_EMOTE_HERO_05A_ERROR_TAUNT	我必须攻击\n那个具有嘲讽的随从。	
GAMEPLAY_EMOTE_HERO_05A_EVENT_FIRE_FESTIVAL	火焰节来了。	
GAMEPLAY_EMOTE_HERO_05A_EVENT_HALLOWS_END	万圣节快乐。	
GAMEPLAY_EMOTE_HERO_05A_EVENT_LUNAR_NEW_YEAR	新年快乐。	
GAMEPLAY_EMOTE_HERO_05A_EVENT_NOBLEGARDEN	复活节快乐。	
GAMEPLAY_EMOTE_HERO_05A_EVENT_PIRATE_DAY	呀！我要弄\n沉你！	
GAMEPLAY_EMOTE_HERO_05A_GOOD_GAME	精彩的比赛。	
GAMEPLAY_EMOTE_HERO_05A_GREETINGS	你好，\n旅行者。	
GAMEPLAY_EMOTE_HERO_05A_LOW_CARDS	我就快\n没牌了！	
GAMEPLAY_EMOTE_HERO_05A_MIRROR_START	我从不颤抖。	
GAMEPLAY_EMOTE_HERO_05A_NO_CARDS	我没有牌了！	
GAMEPLAY_EMOTE_HERO_05A_OOPS	嗯，犯了个\n错误。	
GAMEPLAY_EMOTE_HERO_05A_SORRY	我很抱歉。	
GAMEPLAY_EMOTE_HERO_05A_START	在精灵的力量面前颤抖吧！	
GAMEPLAY_EMOTE_HERO_05A_THANKS	谢谢。	
GAMEPLAY_EMOTE_HERO_05A_THINK1	嗯……	
GAMEPLAY_EMOTE_HERO_05A_THINK2	射死\n哪一个呢？	
GAMEPLAY_EMOTE_HERO_05A_THINK3	该怎么做呢？	
GAMEPLAY_EMOTE_HERO_05A_THREATEN	我很快就会\n报仇的！	
GAMEPLAY_EMOTE_HERO_05A_TIMER	快做出决定！	
GAMEPLAY_EMOTE_HERO_05A_WELL_PLAYED	打得不错。	
GAMEPLAY_EMOTE_HERO_05A_WINTERVEIL_GREETING	冬幕节愉快。	
GAMEPLAY_EMOTE_HERO_05A_WOW	难以置信！	
GAMEPLAY_EMOTE_HERO_06_CONCEDE	我承认，\n你赢了。	
GAMEPLAY_EMOTE_HERO_06_ERROR_FULL_MINIONS	我无法再拥有更多随从了。	
GAMEPLAY_EMOTE_HERO_06_ERROR_GENERIC	我无法\n这么做。	
GAMEPLAY_EMOTE_HERO_06_ERROR_HAND_FULL	我的手牌\n已经满了。	
GAMEPLAY_EMOTE_HERO_06_ERROR_I_ATTACKED	我已经进行过攻击了。	
GAMEPLAY_EMOTE_HERO_06_ERROR_JUST_PLAYED	那个随从需要一个回合进行\n准备。	
GAMEPLAY_EMOTE_HERO_06_ERROR_MINION_ATTACKED	那个随从已经进行过攻击了。	
GAMEPLAY_EMOTE_HERO_06_ERROR_NEED_MANA	我没有足够的法力值。	
GAMEPLAY_EMOTE_HERO_06_ERROR_NEED_WEAPON	我需要\n一把武器。	
GAMEPLAY_EMOTE_HERO_06_ERROR_PLAY	我无法\n使用它。	
GAMEPLAY_EMOTE_HERO_06_ERROR_STEALTH	我无法将具有潜行技能的\n随从作为目标。	
GAMEPLAY_EMOTE_HERO_06_ERROR_TARGET	这不是一个\n有效的目标。	
GAMEPLAY_EMOTE_HERO_06_ERROR_TAUNT	我必须攻击\n那个具有嘲讽技能的随从。	
GAMEPLAY_EMOTE_HERO_06_EVENT_LUNAR_NEW_YEAR	新年好。	
GAMEPLAY_EMOTE_HERO_06_FIRE_FESTIVAL	仲夏节快乐！小心林火。	
GAMEPLAY_EMOTE_HERO_06_GOOD_GAME	精彩的比赛。	
GAMEPLAY_EMOTE_HERO_06_GREETINGS	欢迎。	
GAMEPLAY_EMOTE_HERO_06_HALLOWS_END	万圣节快乐！	
GAMEPLAY_EMOTE_HERO_06_LOW_CARDS	我的卡牌就快要用完了。	
GAMEPLAY_EMOTE_HERO_06_MIRROR_START	谨遵大自然的教诲！	
GAMEPLAY_EMOTE_HERO_06_NO_CARDS	我已经没有\n卡牌了。	
GAMEPLAY_EMOTE_HERO_06_NOBLEGARDEN	复活节快乐！	
GAMEPLAY_EMOTE_HERO_06_OOPS	很自然的\n错误…	
GAMEPLAY_EMOTE_HERO_06_PIRATE_DAY	我的木腿呢？	
GAMEPLAY_EMOTE_HERO_06_SORRY	对此我很\n抱歉。	
GAMEPLAY_EMOTE_HERO_06_START	我是大自然的守护者。	
GAMEPLAY_EMOTE_HERO_06_START_TYRANDE	泰兰德，我的挚爱。	
GAMEPLAY_EMOTE_HERO_06_THANKS	谢谢你。	
GAMEPLAY_EMOTE_HERO_06_THINK1	嗯...	
GAMEPLAY_EMOTE_HERO_06_THINK2	嗯...我想….	
GAMEPLAY_EMOTE_HERO_06_THINK3	应该如何\n应对...	
GAMEPLAY_EMOTE_HERO_06_THREATEN	你无法抵挡\n大自然的\n力量！	
GAMEPLAY_EMOTE_HERO_06_TIMER	时间不等人…	
GAMEPLAY_EMOTE_HERO_06_WELL_PLAYED	嗯，\n打得不错。	
GAMEPLAY_EMOTE_HERO_06_WINTERVEIL_GREETINGS	冬幕节快乐。	
GAMEPLAY_EMOTE_HERO_06_WOW	真是壮观！	
GAMEPLAY_EMOTE_HERO_07_CONCEDE	这次是你\n赢了…	
GAMEPLAY_EMOTE_HERO_07_ERROR_FULL_MINIONS	我无法再拥有更多随从了。	
GAMEPLAY_EMOTE_HERO_07_ERROR_GENERIC	我无法\n这么做。	
GAMEPLAY_EMOTE_HERO_07_ERROR_HAND_FULL	我的手牌\n已经满了。	
GAMEPLAY_EMOTE_HERO_07_ERROR_I_ATTACKED	我已经进行过攻击了。	
GAMEPLAY_EMOTE_HERO_07_ERROR_JUST_PLAYED	那个随从需要一个回合进行\n准备。	
GAMEPLAY_EMOTE_HERO_07_ERROR_MINION_ATTACKED	那个随从已经进行过攻击了。	
GAMEPLAY_EMOTE_HERO_07_ERROR_NEED_MANA	我没有足够的法力值。	
GAMEPLAY_EMOTE_HERO_07_ERROR_NEED_WEAPON	我需要\n一把武器。	
GAMEPLAY_EMOTE_HERO_07_ERROR_PLAY	我无法\n使用它。	
GAMEPLAY_EMOTE_HERO_07_ERROR_STEALTH	我无法将具有潜行技能的随从作为目标。	
GAMEPLAY_EMOTE_HERO_07_ERROR_TARGET	这不是一个\n有效的目标。	
GAMEPLAY_EMOTE_HERO_07_ERROR_TAUNT	我必须攻击\n那个具有嘲讽技能的随从。	
GAMEPLAY_EMOTE_HERO_07_EVENT_LUNAR_NEW_YEAR	给你拜年了。	
GAMEPLAY_EMOTE_HERO_07_FIRE_FESTIVAL	把火点起来。	
GAMEPLAY_EMOTE_HERO_07_GOOD_GAME	精彩的比赛。	
GAMEPLAY_EMOTE_HERO_07_GREETINGS	你好。	
GAMEPLAY_EMOTE_HERO_07_HALLOWS_END	万圣节快乐。	
GAMEPLAY_EMOTE_HERO_07_LOW_CARDS	我的卡牌就快要用光了。	
GAMEPLAY_EMOTE_HERO_07_MIRROR_START	我将成为你的梦魇！	
GAMEPLAY_EMOTE_HERO_07_NO_CARDS	我已经没有\n卡牌了。	
GAMEPLAY_EMOTE_HERO_07_NOBLEGARDEN	复活节快乐。	
GAMEPLAY_EMOTE_HERO_07_OOPS	那是个错误。	
GAMEPLAY_EMOTE_HERO_07_PIRATE_DAY	海盗节？是什么东西？	
GAMEPLAY_EMOTE_HERO_07_SORRY	抱歉。	
GAMEPLAY_EMOTE_HERO_07_START	我会夺取\n你的灵魂！	
GAMEPLAY_EMOTE_HERO_07_THANKS	谢谢你。	
GAMEPLAY_EMOTE_HERO_07_THINK1	嗯...	
GAMEPLAY_EMOTE_HERO_07_THINK2	我想….	
GAMEPLAY_EMOTE_HERO_07_THINK3	如此多的\n可能性… 	
GAMEPLAY_EMOTE_HERO_07_THREATEN	你的灵魂\n将受到折磨！	
GAMEPLAY_EMOTE_HERO_07_TIMER	我快没有\n时间了！	
GAMEPLAY_EMOTE_HERO_07_WELL_PLAYED	打得不错。	
GAMEPLAY_EMOTE_HERO_07_WINTERVEIL_GREETINGS	冬幕节快乐…	
GAMEPLAY_EMOTE_HERO_07_WOW	很不错。	
GAMEPLAY_EMOTE_HERO_08_CONCEDE	你赢了。	
GAMEPLAY_EMOTE_HERO_08_ERROR_FULL_MINIONS	我无法再拥有更多随从了。	
GAMEPLAY_EMOTE_HERO_08_ERROR_GENERIC	我无法\n这么做。	
GAMEPLAY_EMOTE_HERO_08_ERROR_HAND_FULL	我的手牌\n已经满了。	
GAMEPLAY_EMOTE_HERO_08_ERROR_I_ATTACKED	我已经进行过攻击了。	
GAMEPLAY_EMOTE_HERO_08_ERROR_JUST_PLAYED	那个随从需要一个回合进行\n准备。	
GAMEPLAY_EMOTE_HERO_08_ERROR_MINION_ATTACKED	那个随从已经进行过攻击了。	
GAMEPLAY_EMOTE_HERO_08_ERROR_NEED_MANA	我没有足够的法力值。	
GAMEPLAY_EMOTE_HERO_08_ERROR_NEED_WEAPON	我需要\n一把武器。	
GAMEPLAY_EMOTE_HERO_08_ERROR_PLAY	我无法\n使用它。	
GAMEPLAY_EMOTE_HERO_08_ERROR_STEALTH	我无法将具有潜行技能的\n随从作为目标。	
GAMEPLAY_EMOTE_HERO_08_ERROR_TARGET	这不是一个\n有效的目标。	
GAMEPLAY_EMOTE_HERO_08_ERROR_TAUNT	我必须攻击\n那个具有嘲讽技能的随从。	
GAMEPLAY_EMOTE_HERO_08_EVENT_LUNAR_NEW_YEAR	新年快乐。	
GAMEPLAY_EMOTE_HERO_08_FIRE_FESTIVAL	仲夏节快乐！	
GAMEPLAY_EMOTE_HERO_08_GOOD_GAME	精彩的比赛。	
GAMEPLAY_EMOTE_HERO_08_GREETINGS	你好。	
GAMEPLAY_EMOTE_HERO_08_HALLOWS_END	万圣节快乐。	
GAMEPLAY_EMOTE_HERO_08_LOW_CARDS	我的卡牌就快要用光了！	
GAMEPLAY_EMOTE_HERO_08_MIRROR_START	那就来吧。	
GAMEPLAY_EMOTE_HERO_08_NO_CARDS	我已经没有\n卡牌了！	
GAMEPLAY_EMOTE_HERO_08_NOBLEGARDEN	复活节快乐。	
GAMEPLAY_EMOTE_HERO_08_OOPS	哦，糟了。	
GAMEPLAY_EMOTE_HERO_08_PIRATE_DAY	哦，我可是个淑女！	
GAMEPLAY_EMOTE_HERO_08_SORRY	抱歉。	
GAMEPLAY_EMOTE_HERO_08_START	这可是你\n自找的！	
GAMEPLAY_EMOTE_HERO_08_THANKS	谢谢你。	
GAMEPLAY_EMOTE_HERO_08_THINK1	嗯...	
GAMEPLAY_EMOTE_HERO_08_THINK2	我想….	
GAMEPLAY_EMOTE_HERO_08_THINK3	该怎么办呢，怎么办呢…	
GAMEPLAY_EMOTE_HERO_08_THREATEN	我的魔法会把你撕成碎片！	
GAMEPLAY_EMOTE_HERO_08_TIMER	我没有\n时间了…	
GAMEPLAY_EMOTE_HERO_08_WELL_PLAYED	打得不错。	
GAMEPLAY_EMOTE_HERO_08_WINTERVEIL_GREETINGS	冬幕节快乐！	
GAMEPLAY_EMOTE_HERO_08_WOW	太棒了。	
GAMEPLAY_EMOTE_HERO_08A_CELEBRATE	对，对，哈哈！	
GAMEPLAY_EMOTE_HERO_08A_CONCEDE	这是步好棋！我认输。	
GAMEPLAY_EMOTE_HERO_08A_ERROR_FULL_MINIONS	我召唤了太多的随从！	
GAMEPLAY_EMOTE_HERO_08A_ERROR_GENERIC	我不能\n这么做。	
GAMEPLAY_EMOTE_HERO_08A_ERROR_HAND_FULL	我的手牌\n满了！	
GAMEPLAY_EMOTE_HERO_08A_ERROR_I_ATTACKED	我已经\n攻击过了。	
GAMEPLAY_EMOTE_HERO_08A_ERROR_JUST_PLAYED	给那个随从\n一个回合的\n准备时间。	
GAMEPLAY_EMOTE_HERO_08A_ERROR_MINION_ATTACKED	那个随从已经攻击过了。	
GAMEPLAY_EMOTE_HERO_08A_ERROR_NEED_MANA	我没有足够的法力值。	
GAMEPLAY_EMOTE_HERO_08A_ERROR_NEED_WEAPON	我需要\n一把武器。	
GAMEPLAY_EMOTE_HERO_08A_ERROR_PLAY	我不能使用\n这张牌。	
GAMEPLAY_EMOTE_HERO_08A_ERROR_STEALTH	我不能\n以潜行的随从作为目标。	
GAMEPLAY_EMOTE_HERO_08A_ERROR_TARGET	这不是一个\n合理的目标。	
GAMEPLAY_EMOTE_HERO_08A_ERROR_TAUNT	我必须攻击\n那个具有嘲讽的随从。	
GAMEPLAY_EMOTE_HERO_08A_FIRE_FESTIVAL	仲夏火焰节\n来了。	
GAMEPLAY_EMOTE_HERO_08A_GOOD_GAME	精彩的比赛。	
GAMEPLAY_EMOTE_HERO_08A_GREETINGS	啊，你好。	
GAMEPLAY_EMOTE_HERO_08A_HALLOWS_END	万圣节快乐。	
GAMEPLAY_EMOTE_HERO_08A_LOW_CARDS	我快要\n无牌可用了！	
GAMEPLAY_EMOTE_HERO_08A_LUNAR_NEW_YEAR	新年快乐。	
GAMEPLAY_EMOTE_HERO_08A_MIRROR_START	哦，比赛已经开始了。	
GAMEPLAY_EMOTE_HERO_08A_NO_CARDS	我没有牌了！	
GAMEPLAY_EMOTE_HERO_08A_NOBLEGARDEN	复活节快乐！	
GAMEPLAY_EMOTE_HERO_08A_OOPS	那可真蠢。	
GAMEPLAY_EMOTE_HERO_08A_PIRATE_DAY	我是麦迪文，大海的守护者！	
GAMEPLAY_EMOTE_HERO_08A_SORRY	我表示由衷的歉意。	
GAMEPLAY_EMOTE_HERO_08A_START	就让比赛\n开始吧。	
GAMEPLAY_EMOTE_HERO_08A_THANKS	我很感激。	
GAMEPLAY_EMOTE_HERO_08A_THINK1	嗯……	
GAMEPLAY_EMOTE_HERO_08A_THINK2	有意思……	
GAMEPLAY_EMOTE_HERO_08A_THINK3	也许……	
GAMEPLAY_EMOTE_HERO_08A_THREATEN	没有什么能够阻止我！\n没有！	
GAMEPLAY_EMOTE_HERO_08A_TIMER	不能再\n碌碌无为了！	
GAMEPLAY_EMOTE_HERO_08A_WELL_PLAYED	打得不错。	
GAMEPLAY_EMOTE_HERO_08A_WINTERVEIL_GREETINGS	节日快乐，挑战者。	
GAMEPLAY_EMOTE_HERO_08A_WOW	喔，难以置信。	
GAMEPLAY_EMOTE_HERO_08B_CONCEDE	很出色，你赢了。	
GAMEPLAY_EMOTE_HERO_08B_ERROR_FULL_MINIONS	我已经拥有了太多的随从。	
GAMEPLAY_EMOTE_HERO_08B_ERROR_GENERIC	我不能\n这么做。	
GAMEPLAY_EMOTE_HERO_08B_ERROR_HAND_FULL	我的手牌\n已经满了！	
GAMEPLAY_EMOTE_HERO_08B_ERROR_I_ATTACKED	我已经\n攻击过了。	
GAMEPLAY_EMOTE_HERO_08B_ERROR_JUST_PLAYED	那个随从需要一个回合进行\n准备。	
GAMEPLAY_EMOTE_HERO_08B_ERROR_MINION_ATTACKED	那个随从已经攻击过了。	
GAMEPLAY_EMOTE_HERO_08B_ERROR_NEED_MANA	我没有足够的法力值。	
GAMEPLAY_EMOTE_HERO_08B_ERROR_NEED_WEAPON	我需要\n一把武器。	
GAMEPLAY_EMOTE_HERO_08B_ERROR_PLAY	我不能使用\n这张牌。	
GAMEPLAY_EMOTE_HERO_08B_ERROR_STEALTH	我不能以潜行的随从作为目标。	
GAMEPLAY_EMOTE_HERO_08B_ERROR_TARGET	那不是一个\n有效的目标。	
GAMEPLAY_EMOTE_HERO_08B_ERROR_TAUNT	必须先攻击\n具有嘲讽的\n随从。	
GAMEPLAY_EMOTE_HERO_08B_FIRE_FESTIVAL	仲夏之夜，欢乐开怀。	
GAMEPLAY_EMOTE_HERO_08B_GOOD_GAME	很好，真是棋逢对手！	
GAMEPLAY_EMOTE_HERO_08B_GREETINGS	你好，求知者。	
GAMEPLAY_EMOTE_HERO_08B_HALLOWS_END	万圣节快乐。	
GAMEPLAY_EMOTE_HERO_08B_LOW_CARDS	我快要\n没有牌了。	
GAMEPLAY_EMOTE_HERO_08B_LUNAR_NEW_YEAR	新年快乐！	
GAMEPLAY_EMOTE_HERO_08B_MIRROR_START	愿我们共同\n成长。	
GAMEPLAY_EMOTE_HERO_08B_NO_CARDS	我已经没有\n卡牌了！	
GAMEPLAY_EMOTE_HERO_08B_NOBLEGARDEN	复活节快乐！	
GAMEPLAY_EMOTE_HERO_08B_OOPS	呃……一个小失误。	
GAMEPLAY_EMOTE_HERO_08B_PIRATE_DAY	海盗……不是违法的吗？	
GAMEPLAY_EMOTE_HERO_08B_SORRY	真是抱歉。	
GAMEPLAY_EMOTE_HERO_08B_START	知识就是\n力量。	
GAMEPLAY_EMOTE_HERO_08B_THANKS	谢谢你，朋友。	
GAMEPLAY_EMOTE_HERO_08B_THINK1	嗯……	
GAMEPLAY_EMOTE_HERO_08B_THINK2	观察，并思考……	
GAMEPLAY_EMOTE_HERO_08B_THINK3	一定有什么办法……	
GAMEPLAY_EMOTE_HERO_08B_THREATEN	如此傲慢无礼，是该给你点教训了！	
GAMEPLAY_EMOTE_HERO_08B_TIMER	注意时间！	
GAMEPLAY_EMOTE_HERO_08B_WELL_PLAYED	打得不错。	
GAMEPLAY_EMOTE_HERO_08B_WINTERVEIL_GREETINGS	冬幕节快乐！	
GAMEPLAY_EMOTE_HERO_08B_WOW	精彩绝伦。	
GAMEPLAY_EMOTE_HERO_09_CONCEDE	你击败了我。	
GAMEPLAY_EMOTE_HERO_09_ERROR_FULL_MINIONS	我无法再拥有更多随从了。	
GAMEPLAY_EMOTE_HERO_09_ERROR_GENERIC	我无法\n这么做。	
GAMEPLAY_EMOTE_HERO_09_ERROR_HAND_FULL	我的手牌\n已经满了！	
GAMEPLAY_EMOTE_HERO_09_ERROR_I_ATTACKED	我已经进行过攻击了！	
GAMEPLAY_EMOTE_HERO_09_ERROR_JUST_PLAYED	那个随从需要一个回合进行\n准备。	
GAMEPLAY_EMOTE_HERO_09_ERROR_MINION_ATTACKED	那个随从已经进行过攻击了。	
GAMEPLAY_EMOTE_HERO_09_ERROR_NEED_MANA	我没有足够的法力值。	
GAMEPLAY_EMOTE_HERO_09_ERROR_NEED_WEAPON	我需要\n一把武器。	
GAMEPLAY_EMOTE_HERO_09_ERROR_PLAY	我无法\n使用它。	
GAMEPLAY_EMOTE_HERO_09_ERROR_STEALTH	我无法将具有潜行技能的随从作为目标。	
GAMEPLAY_EMOTE_HERO_09_ERROR_TARGET	这不是一个\n有效的目标。	
GAMEPLAY_EMOTE_HERO_09_ERROR_TAUNT	我必须攻击\n那个具有嘲讽技能的随从。	
GAMEPLAY_EMOTE_HERO_09_EVENT_LUNAR_NEW_YEAR	新年好。	
GAMEPLAY_EMOTE_HERO_09_FIRE_FESTIVAL	小心火烛！	
GAMEPLAY_EMOTE_HERO_09_GOOD_GAME	精彩的比赛。	
GAMEPLAY_EMOTE_HERO_09_GREETINGS	你好。	
GAMEPLAY_EMOTE_HERO_09_GREETINGS_DISABLED	唔唔！	
GAMEPLAY_EMOTE_HERO_09_HALLOWS_END	万圣节快乐！	
GAMEPLAY_EMOTE_HERO_09_LOW_CARDS	我的卡牌就快要用光了！	
GAMEPLAY_EMOTE_HERO_09_MIRROR_START	圣光也向我露出了微笑！	
GAMEPLAY_EMOTE_HERO_09_NO_CARDS	我已经没有\n卡牌了！	
GAMEPLAY_EMOTE_HERO_09_NOBLEGARDEN	复活节快乐！	
GAMEPLAY_EMOTE_HERO_09_OOPS	和我的计划\n有些出入。	
GAMEPLAY_EMOTE_HERO_09_OOPS_DISABLED	唔唔？	
GAMEPLAY_EMOTE_HERO_09_PIRATE_DAY	耶哈哈哈，海盗节，真酷。	
GAMEPLAY_EMOTE_HERO_09_SORRY	抱歉。	
GAMEPLAY_EMOTE_HERO_09_START	圣光将赐予我胜利！	
GAMEPLAY_EMOTE_HERO_09_THANKS	谢谢你。	
GAMEPLAY_EMOTE_HERO_09_THANKS_DISABLED	唔唔。	
GAMEPLAY_EMOTE_HERO_09_THINK1	嗯...	
GAMEPLAY_EMOTE_HERO_09_THINK2	我想….	
GAMEPLAY_EMOTE_HERO_09_THINK3	我要想一想…
GAMEPLAY_EMOTE_HERO_09_THREATEN	圣光会\n制裁你！	
GAMEPLAY_EMOTE_HERO_09_THREATEN_DISABLED	唔唔！！	
GAMEPLAY_EMOTE_HERO_09_TIMER	我要尽快\n做出选择…	
GAMEPLAY_EMOTE_HERO_09_WELL_PLAYED	打得不错。	
GAMEPLAY_EMOTE_HERO_09_WELL_PLAYED_DISABLED	唔唔……	
GAMEPLAY_EMOTE_HERO_09_WINTERVEIL_GREETINGS	冬幕节快乐！	
GAMEPLAY_EMOTE_HERO_09_WOW	哇喔....	
GAMEPLAY_EMOTE_HERO_09_WOW_DISABLED	唔唔唔……！！	
GAMEPLAY_EMOTE_HERO_TBKTRAF_KT_CONCEDE	我……会……回来的……	
GAMEPLAY_EMOTE_HERO_TBKTRAF_KT_GREETINGS	我们终于见面了！	
GAMEPLAY_EMOTE_HERO_TBKTRAF_KT_LOW_CARDS	我就快没牌了！	
GAMEPLAY_EMOTE_HERO_TBKTRAF_KT_NO_CARDS	不！！！诅咒你，入侵者，诅咒你！	
GAMEPLAY_EMOTE_HERO_TBKTRAF_KT_OOPS	哎，还得重新设计。	
GAMEPLAY_EMOTE_HERO_TBKTRAF_KT_SORRY	不！诅咒你入侵者！诅咒你！	
GAMEPLAY_EMOTE_HERO_TBKTRAF_KT_START	我会亲自找你们算账的，入侵者！	
GAMEPLAY_EMOTE_HERO_TBKTRAF_KT_THANKS	我只是……尽地主之谊。	
GAMEPLAY_EMOTE_HERO_TBKTRAF_KT_THINK1	也许吧。	
GAMEPLAY_EMOTE_HERO_TBKTRAF_KT_THINK2	对……就是这样！	
GAMEPLAY_EMOTE_HERO_TBKTRAF_KT_THINK3	比格沃斯，你怎么看？	
GAMEPLAY_EMOTE_HERO_TBKTRAF_KT_THREATEN	我会冻结你的血液！	
GAMEPLAY_EMOTE_HERO_TBKTRAF_KT_WELL_PLAYED	哼，我当然打得不错，我可是克尔苏加德！	
GAMEPLAY_EMOTE_HERO_TBKTRAF_RAF_CONCEDE	不！我是不可战胜的……	
GAMEPLAY_EMOTE_HERO_TBKTRAF_RAF_GREETINGS	你好，探险者。	
GAMEPLAY_EMOTE_HERO_TBKTRAF_RAF_LOW_CARDS	我就快没牌了！	
GAMEPLAY_EMOTE_HERO_TBKTRAF_RAF_NO_CARDS	真怀念我的宝藏！	
GAMEPLAY_EMOTE_HERO_TBKTRAF_RAF_OOPS	我手滑了！	
GAMEPLAY_EMOTE_HERO_TBKTRAF_RAF_SORRY	我很同情你。	
GAMEPLAY_EMOTE_HERO_TBKTRAF_RAF_START	拉法姆才是最最伟大的考古学家！	
GAMEPLAY_EMOTE_HERO_TBKTRAF_RAF_THANKS	呃，谢谢你。	
GAMEPLAY_EMOTE_HERO_TBKTRAF_RAF_THINK1	嗯...	
GAMEPLAY_EMOTE_HERO_TBKTRAF_RAF_THINK2	拿哪张好呢……	
GAMEPLAY_EMOTE_HERO_TBKTRAF_RAF_THINK3	每张都想要……	
GAMEPLAY_EMOTE_HERO_TBKTRAF_RAF_THREATEN	如此强大的力量！	
GAMEPLAY_EMOTE_HERO_TBKTRAF_RAF_WELL_PLAYED	干得好……	
GAMEPLAY_EMOTE_HERO_TBMECHWAR01_CONCEDE	<战败>	The text is in brackets because the VO files is just Annoy-o-Tron's greeting
GAMEPLAY_EMOTE_HERO_TBMECHWAR01_ERROR_FULL_MINIONS	<错误！>	The text is in brackets because the VO files is just Annoy-o-Tron's greeting
GAMEPLAY_EMOTE_HERO_TBMECHWAR01_ERROR_HAND_FULL	<错误！>	The text is in brackets because the VO files is just Annoy-o-Tron's greeting
GAMEPLAY_EMOTE_HERO_TBMECHWAR01_ERROR_I_ATTACKED	<错误！>	The text is in brackets because the VO files is just Annoy-o-Tron's greeting
GAMEPLAY_EMOTE_HERO_TBMECHWAR01_ERROR_JUST_PLAYED	<错误！>	The text is in brackets because the VO files is just Annoy-o-Tron's greeting
GAMEPLAY_EMOTE_HERO_TBMECHWAR01_ERROR_MINION_ATTACKED	<错误！>	The text is in brackets because the VO files is just Annoy-o-Tron's greeting
GAMEPLAY_EMOTE_HERO_TBMECHWAR01_ERROR_NEED_MANA	<错误！>	The text is in brackets because the VO files is just Annoy-o-Tron's greeting
GAMEPLAY_EMOTE_HERO_TBMECHWAR01_ERROR_NEED_WEAPON	<错误！>	The text is in brackets because the VO files is just Annoy-o-Tron's greeting
GAMEPLAY_EMOTE_HERO_TBMECHWAR01_ERROR_PLAY	<错误！>	The text is in brackets because the VO files is just Annoy-o-Tron's greeting
GAMEPLAY_EMOTE_HERO_TBMECHWAR01_ERROR_STEALTH	<错误！>	The text is in brackets because the VO files is just Annoy-o-Tron's greeting
GAMEPLAY_EMOTE_HERO_TBMECHWAR01_ERROR_TARGET	<错误！>	The text is in brackets because the VO files is just Annoy-o-Tron's greeting
GAMEPLAY_EMOTE_HERO_TBMECHWAR01_ERROR_TAUNT	<错误！>	The text is in brackets because the VO files is just Annoy-o-Tron's greeting
GAMEPLAY_EMOTE_HERO_TBMECHWAR01_GREETINGS	<你好>	The text is in brackets because the VO files is just Annoy-o-Tron's greeting
GAMEPLAY_EMOTE_HERO_TBMECHWAR01_LOW_CARDS	<卡牌不足>	The text is in brackets because the VO files is just Annoy-o-Tron's greeting
GAMEPLAY_EMOTE_HERO_TBMECHWAR01_NO_CARDS	<没有卡牌>	The text is in brackets because the VO files is just Annoy-o-Tron's greeting
GAMEPLAY_EMOTE_HERO_TBMECHWAR01_OOPS	<错误>	The text is in brackets because the VO files is just Annoy-o-Tron's greeting
GAMEPLAY_EMOTE_HERO_TBMECHWAR01_SORRY	<抱歉>	The text is in brackets because the VO files is just Annoy-o-Tron's greeting
GAMEPLAY_EMOTE_HERO_TBMECHWAR01_START	<开始>	The text is in brackets because the VO files is just Annoy-o-Tron's greeting
GAMEPLAY_EMOTE_HERO_TBMECHWAR01_THANKS	<谢谢>	The text is in brackets because the VO files is just Annoy-o-Tron's greeting
GAMEPLAY_EMOTE_HERO_TBMECHWAR01_THINK1	<处理中…>	The text is in brackets because the VO files is just Annoy-o-Tron's greeting
GAMEPLAY_EMOTE_HERO_TBMECHWAR01_THINK2	<获取目标…>	The text is in brackets because the VO files is just Annoy-o-Tron's greeting
GAMEPLAY_EMOTE_HERO_TBMECHWAR01_THINK3	<耗费周期…>	The text is in brackets because the VO files is just Annoy-o-Tron's greeting
GAMEPLAY_EMOTE_HERO_TBMECHWAR01_THREATEN	<威胁>	The text is in brackets because the VO files is just Annoy-o-Tron's attack
GAMEPLAY_EMOTE_HERO_TBMECHWAR01_TIMER	<时日无多>	The text is in brackets because the VO files is just Annoy-o-Tron's greeting
GAMEPLAY_EMOTE_HERO_TBMECHWAR01_WELL_PLAYED	<打得不错>	The text is in brackets because the VO files is just Annoy-o-Tron's greeting
GAMEPLAY_EMOTE_HERO_TBMECHWAR01_WOW	<真厉害！>	The text is in brackets because the VO files is just Annoy-o-Tron's greeting
GAMEPLAY_EMOTE_HERO_TBMECHWAR02_CONCEDE	<阵列结束>	The text is in brackets because the VO files is just Boom Bot's greeting
GAMEPLAY_EMOTE_HERO_TBMECHWAR02_ERROR_FULL_MINIONS	<错误！>	The text is in brackets because the VO files is just Boom Bot's greeting
GAMEPLAY_EMOTE_HERO_TBMECHWAR02_ERROR_HAND_FULL	<错误！>	The text is in brackets because the VO files is just Boom Bot's greeting
GAMEPLAY_EMOTE_HERO_TBMECHWAR02_ERROR_I_ATTACKED	<错误！>	The text is in brackets because the VO files is just Boom Bot's greeting
GAMEPLAY_EMOTE_HERO_TBMECHWAR02_ERROR_JUST_PLAYED	<错误！>	The text is in brackets because the VO files is just Boom Bot's greeting
GAMEPLAY_EMOTE_HERO_TBMECHWAR02_ERROR_MINION_ATTACKED	<错误！>	The text is in brackets because the VO files is just Boom Bot's greeting
GAMEPLAY_EMOTE_HERO_TBMECHWAR02_ERROR_NEED_MANA	<错误！>	The text is in brackets because the VO files is just Boom Bot's greeting
GAMEPLAY_EMOTE_HERO_TBMECHWAR02_ERROR_NEED_WEAPON	<错误！>	The text is in brackets because the VO files is just Boom Bot's greeting
GAMEPLAY_EMOTE_HERO_TBMECHWAR02_ERROR_PLAY	<错误！>	The text is in brackets because the VO files is just Boom Bot's greeting
GAMEPLAY_EMOTE_HERO_TBMECHWAR02_ERROR_STEALTH	<错误！>	The text is in brackets because the VO files is just Boom Bot's greeting
GAMEPLAY_EMOTE_HERO_TBMECHWAR02_ERROR_TARGET	<错误！>	The text is in brackets because the VO files is just Boom Bot's greeting
GAMEPLAY_EMOTE_HERO_TBMECHWAR02_ERROR_TAUNT	<错误！>	The text is in brackets because the VO files is just Boom Bot's greeting
GAMEPLAY_EMOTE_HERO_TBMECHWAR02_GREETINGS	<你好>	The text is in brackets because the VO files is just Annoy-o-Tron's greeting
GAMEPLAY_EMOTE_HERO_TBMECHWAR02_LOW_CARDS	<卡牌不足>	The text is in brackets because the VO files is just Boom Bot's greeting
GAMEPLAY_EMOTE_HERO_TBMECHWAR02_NO_CARDS	<没有卡牌>	The text is in brackets because the VO files is just Boom Bot's greeting
GAMEPLAY_EMOTE_HERO_TBMECHWAR02_OOPS	<错误！>	The text is in brackets because the VO files is just Boom Bot's greeting
GAMEPLAY_EMOTE_HERO_TBMECHWAR02_SORRY	<抱歉>	The text is in brackets because the VO files is just Boom Bot's greeting
GAMEPLAY_EMOTE_HERO_TBMECHWAR02_START	<初始化>	The text is in brackets because the VO files is just Boom Bot's greeting
GAMEPLAY_EMOTE_HERO_TBMECHWAR02_THANKS	<谢谢>	The text is in brackets because the VO files is just Boom Bot's greeting
GAMEPLAY_EMOTE_HERO_TBMECHWAR02_THINK1	<处理中…>	The text is in brackets because the VO files is just Boom Bot's greeting
GAMEPLAY_EMOTE_HERO_TBMECHWAR02_THINK2	<获取目标…>	The text is in brackets because the VO files is just Boom Bot's greeting
GAMEPLAY_EMOTE_HERO_TBMECHWAR02_THINK3	<耗费周期…>	The text is in brackets because the VO files is just Boom Bot's greeting
GAMEPLAY_EMOTE_HERO_TBMECHWAR02_THREATEN	<威胁>	The text is in brackets because the VO files is just Boom Bot's Attack sound
GAMEPLAY_EMOTE_HERO_TBMECHWAR02_TIMER	<时日无多>	The text is in brackets because the VO files is just Boom Bot's greeting
GAMEPLAY_EMOTE_HERO_TBMECHWAR02_WELL_PLAYED	<打得不错>	The text is in brackets because the VO files is just Boom Bot's greeting
GAMEPLAY_EMOTE_HERO_TBMECHWAR02_WOW	<你好棒！>	The text is in brackets because the VO files is just Annoy-o-Tron's greeting
GAMEPLAY_EMOTE_ICC_481_CONCEDE	享受冰冷的胜利吧。	
GAMEPLAY_EMOTE_ICC_481_GREETINGS	迎接死亡冰冷的拥抱吧。	
GAMEPLAY_EMOTE_ICC_481_LOW_CARDS	我的卡牌就快要用光了！	
GAMEPLAY_EMOTE_ICC_481_NO_CARDS	我已经没有卡牌了！	
GAMEPLAY_EMOTE_ICC_481_OOPS	严重失误。	
GAMEPLAY_EMOTE_ICC_481_START	为了\n毁灭之锤！	
GAMEPLAY_EMOTE_ICC_481_THANKS	谢谢。	
GAMEPLAY_EMOTE_ICC_481_THINK1	嗯...	
GAMEPLAY_EMOTE_ICC_481_THINK2	元素沉默了……	
GAMEPLAY_EMOTE_ICC_481_THINK3	我只能自己做决定了。	
GAMEPLAY_EMOTE_ICC_481_THREATEN	我要粉碎你！	
GAMEPLAY_EMOTE_ICC_481_TIMER	必须选择一条道路！	
GAMEPLAY_EMOTE_ICC_481_WELL_PLAYED	打得不错。	
GAMEPLAY_EMOTE_ICC_481_WOW	难以置信！	
GAMEPLAY_EMOTE_ICC_827_CONCEDE	今天属于你。	
GAMEPLAY_EMOTE_ICC_827_GREETINGS	你之前躲哪\n去了？	
GAMEPLAY_EMOTE_ICC_827_LOW_CARDS	我的卡牌快要用光了！	
GAMEPLAY_EMOTE_ICC_827_NO_CARDS	我已经没有卡牌了！	
GAMEPLAY_EMOTE_ICC_827_OOPS	真是悲剧……	
GAMEPLAY_EMOTE_ICC_827_START	当心你的\n背后。	
GAMEPLAY_EMOTE_ICC_827_THANKS	谢谢。	
GAMEPLAY_EMOTE_ICC_827_THINK1	嗯...	
GAMEPLAY_EMOTE_ICC_827_THINK2	死亡的阴影在扩大……	
GAMEPLAY_EMOTE_ICC_827_THINK3	时间飞逝……	
GAMEPLAY_EMOTE_ICC_827_THREATEN	你将学会畏惧你的影子。	
GAMEPLAY_EMOTE_ICC_827_TIMER	我得快点\n做决定！	
GAMEPLAY_EMOTE_ICC_827_WELL_PLAYED	很好。	
GAMEPLAY_EMOTE_ICC_827_WOW	超越想象！	
GAMEPLAY_EMOTE_ICC_828_CONCEDE	这场狩猎你\n赢了。	
GAMEPLAY_EMOTE_ICC_828_GREETINGS	开始跑吧，\n猎物！	
GAMEPLAY_EMOTE_ICC_828_LOW_CARDS	我的卡牌就快要用光了！	
GAMEPLAY_EMOTE_ICC_828_NO_CARDS	我已经没有卡牌了！	
GAMEPLAY_EMOTE_ICC_828_OOPS	失误了。	
GAMEPLAY_EMOTE_ICC_828_START	狩猎开始了！	
GAMEPLAY_EMOTE_ICC_828_THANKS	谢谢。	
GAMEPLAY_EMOTE_ICC_828_THINK1	嗯...	
GAMEPLAY_EMOTE_ICC_828_THINK2	应该追踪哪个痕迹……	
GAMEPLAY_EMOTE_ICC_828_THINK3	我想...	
GAMEPLAY_EMOTE_ICC_828_THREATEN	我会追杀你……到天涯海角！	
GAMEPLAY_EMOTE_ICC_828_TIMER	气味变淡了。	
GAMEPLAY_EMOTE_ICC_828_WELL_PLAYED	打得不错。	
GAMEPLAY_EMOTE_ICC_828_WOW	真厉害！	
GAMEPLAY_EMOTE_ICC_829_CONCEDE	你胜利了。但仅限这一次。	
GAMEPLAY_EMOTE_ICC_829_GREETINGS	只有我才是\n正义。	
GAMEPLAY_EMOTE_ICC_829_LOW_CARDS	我的卡牌就快要用光了！	
GAMEPLAY_EMOTE_ICC_829_NO_CARDS	我已经没有\n卡牌了！	
GAMEPLAY_EMOTE_ICC_829_OOPS	令人失望。	
GAMEPLAY_EMOTE_ICC_829_START	荣耀赐予我\n力量！	
GAMEPLAY_EMOTE_ICC_829_THANKS	谢谢你。	
GAMEPLAY_EMOTE_ICC_829_THINK1	嗯...	
GAMEPLAY_EMOTE_ICC_829_THINK2	霜之哀伤在\n呼唤。	
GAMEPLAY_EMOTE_ICC_829_THINK3	冰封王座在呼唤……	
GAMEPLAY_EMOTE_ICC_829_THREATEN	求饶吧，但我会拒绝！	
GAMEPLAY_EMOTE_ICC_829_TIMER	结局即将\n到来！	
GAMEPLAY_EMOTE_ICC_829_WELL_PLAYED	打得不错。	
GAMEPLAY_EMOTE_ICC_829_WOW	难以置信！	
GAMEPLAY_EMOTE_ICC_830_CONCEDE	不！你的胜利没有任何意义！	
GAMEPLAY_EMOTE_ICC_830_GREETINGS	我要复仇，我要让黑暗吞噬\n一切！	
GAMEPLAY_EMOTE_ICC_830_LOW_CARDS	我的卡牌就快要用光了！	
GAMEPLAY_EMOTE_ICC_830_NO_CARDS	我已经没有卡牌了！	
GAMEPLAY_EMOTE_ICC_830_OOPS	犯错是人之\n常情。	
GAMEPLAY_EMOTE_ICC_830_START	黑暗将赐予我胜利！	
GAMEPLAY_EMOTE_ICC_830_THANKS	谢谢。	
GAMEPLAY_EMOTE_ICC_830_THINK1	嗯...	
GAMEPLAY_EMOTE_ICC_830_THINK2	黑暗在向我\n低语……	
GAMEPLAY_EMOTE_ICC_830_THINK3	阴暗的\n想法……	
GAMEPLAY_EMOTE_ICC_830_THREATEN	黑暗会\n吞噬你！	
GAMEPLAY_EMOTE_ICC_830_TIMER	暗影正在\n流逝！	
GAMEPLAY_EMOTE_ICC_830_WELL_PLAYED	打得不错。	
GAMEPLAY_EMOTE_ICC_830_WOW	不可思议！	
GAMEPLAY_EMOTE_ICC_831_CONCEDE	这次……是你赢了。	
GAMEPLAY_EMOTE_ICC_831_GREETINGS	惧怕我吧。	
GAMEPLAY_EMOTE_ICC_831_LOW_CARDS	我的卡牌就快要用光了！	
GAMEPLAY_EMOTE_ICC_831_NO_CARDS	我已经没有卡牌了！	
GAMEPLAY_EMOTE_ICC_831_OOPS	那毫无意义。	
GAMEPLAY_EMOTE_ICC_831_START	我会夺取\n你的灵魂！	
GAMEPLAY_EMOTE_ICC_831_THANKS	啊……\n谢谢你。	
GAMEPLAY_EMOTE_ICC_831_THINK1	嗯...	
GAMEPLAY_EMOTE_ICC_831_THINK2	我越来\n越饿……	
GAMEPLAY_EMOTE_ICC_831_THINK3	如此血腥的可能性……	
GAMEPLAY_EMOTE_ICC_831_THREATEN	你会感受到传说级别的……\n痛苦！	
GAMEPLAY_EMOTE_ICC_831_TIMER	我必须进食，立刻！	
GAMEPLAY_EMOTE_ICC_831_WELL_PLAYED	干得漂亮。	
GAMEPLAY_EMOTE_ICC_831_WOW	地狱烈焰\n在上。	
GAMEPLAY_EMOTE_ICC_832_CONCEDE	你赢了。我现在可以安息了。	
GAMEPLAY_EMOTE_ICC_832_GREETINGS	衰败的轮回开始了。	
GAMEPLAY_EMOTE_ICC_832_LOW_CARDS	我的卡牌就快要用光了！	
GAMEPLAY_EMOTE_ICC_832_NO_CARDS	我已经没有卡牌了！	
GAMEPLAY_EMOTE_ICC_832_OOPS	谜团解开了。	
GAMEPLAY_EMOTE_ICC_832_START	生命的轮回结束了！	
GAMEPLAY_EMOTE_ICC_832_THANKS	谢谢你。	
GAMEPLAY_EMOTE_ICC_832_THINK1	嗯...	
GAMEPLAY_EMOTE_ICC_832_THINK2	纠结的谜团……	
GAMEPLAY_EMOTE_ICC_832_THINK3	我的思维受到了感染……	
GAMEPLAY_EMOTE_ICC_832_THREATEN	你将枯萎\n腐烂。	
GAMEPLAY_EMOTE_ICC_832_TIMER	死亡是永恒的，但我的回合\n不是！	
GAMEPLAY_EMOTE_ICC_832_WELL_PLAYED	很熟练。	
GAMEPLAY_EMOTE_ICC_832_WOW	令人震惊！	
GAMEPLAY_EMOTE_ICC_833_CONCEDE	我认可你的\n力量。	
GAMEPLAY_EMOTE_ICC_833_GREETINGS	你在颤抖。你害怕了吗？	
GAMEPLAY_EMOTE_ICC_833_LOW_CARDS	我的卡牌就快要用光了！	
GAMEPLAY_EMOTE_ICC_833_NO_CARDS	我已经没有卡牌了！	
GAMEPLAY_EMOTE_ICC_833_OOPS	一个致命的\n失误。	
GAMEPLAY_EMOTE_ICC_833_START	这可是你\n自找的！	
GAMEPLAY_EMOTE_ICC_833_THANKS	谢谢你。	
GAMEPLAY_EMOTE_ICC_833_THINK1	嗯...	
GAMEPLAY_EMOTE_ICC_833_THINK2	时间飞逝……	
GAMEPLAY_EMOTE_ICC_833_THINK3	嗯，我必须作出决定……	
GAMEPLAY_EMOTE_ICC_833_THREATEN	向你的女王\n低头！	
GAMEPLAY_EMOTE_ICC_833_TIMER	就是现在！	
GAMEPLAY_EMOTE_ICC_833_WELL_PLAYED	打得不错。	
GAMEPLAY_EMOTE_ICC_833_WOW	以我的冰封之心为名！	
GAMEPLAY_EMOTE_ICC_834_CONCEDE	我选择死亡。	
GAMEPLAY_EMOTE_ICC_834_GREETINGS	你将无法逃脱地狱咆哮的愤怒！	
GAMEPLAY_EMOTE_ICC_834_LOW_CARDS	我的卡牌就快要用光了！	
GAMEPLAY_EMOTE_ICC_834_NO_CARDS	我已经没有卡牌了。	
GAMEPLAY_EMOTE_ICC_834_OOPS	我手滑了！	
GAMEPLAY_EMOTE_ICC_834_START	不胜利，\n毋宁死！	
GAMEPLAY_EMOTE_ICC_834_THANKS	哼，谢谢。	
GAMEPLAY_EMOTE_ICC_834_THINK1	嗯...	
GAMEPLAY_EMOTE_ICC_834_THINK2	时间正在\n流逝……	
GAMEPLAY_EMOTE_ICC_834_THINK3	那么现在…	
GAMEPLAY_EMOTE_ICC_834_THREATEN	你将成为第一个跪服之人。	
GAMEPLAY_EMOTE_ICC_834_TIMER	我要立刻\n作出决定！	
GAMEPLAY_EMOTE_ICC_834_WELL_PLAYED	一个劲敌。	
GAMEPLAY_EMOTE_ICC_834_WOW	真不错！	
VO_Arthas_Male_Human_Attack_01	邪恶都将被净化！	
VO_Arthas_Male_Human_CONCEDE_01	战斗结束了，你赢了。	
VO_Arthas_Male_Human_ERROR_FULL_MINIONS_01	我召唤了太多的随从！	
VO_Arthas_Male_Human_ERROR_GENERIC_01	我不能\n那么做。	
VO_Arthas_Male_Human_ERROR_HAND_FULL_01	我的手牌\n满了！	
VO_Arthas_Male_Human_ERROR_I_ATTACKED_01	我已经进行过攻击了。	
VO_Arthas_Male_Human_ERROR_JUST_PLAYED_01	那个随从需要一个回合进行\n准备。	
VO_Arthas_Male_Human_ERROR_MINION_ATTACKED_01	那个随从已经攻击过了。	
VO_Arthas_Male_Human_ERROR_NEED_MANA_01	我没有足够的法力值。	
VO_Arthas_Male_Human_ERROR_NEED_WEAPON_01	我需要\n一把武器。	
VO_Arthas_Male_Human_ERROR_PLAY_01	我无法\n使用它。	
VO_Arthas_Male_Human_ERROR_STEALTH_01	我无法将具有潜行技能的随从作为目标。	
VO_Arthas_Male_Human_ERROR_TARGET_01	这不是一个\n有效的目标。	
VO_Arthas_Male_Human_ERROR_TAUNT_01	我必须攻击\n那个具有嘲讽技能的随从。	
VO_Arthas_Male_Human_FIRE_FESTIVAL_01	点燃篝火！	
VO_Arthas_Male_Human_GREETINGS_01	你好，幸会。	
VO_Arthas_Male_Human_HAPPY_HALLOWEEN_01	万圣节快乐……	
VO_Arthas_Male_Human_HAPPY_HOLIDAYS_01	冬幕节快乐！	
VO_Arthas_Male_Human_HAPPY_NEW_YEAR_01	新年快乐！	
VO_Arthas_Male_Human_HAPPY_NEW_YEAR_LUNAR_01	春节快乐！	
VO_Arthas_Male_Human_HAPPY_NOBLEGARDEN	复活节快乐。	
VO_Arthas_Male_Human_LOW_CARDS_01	我快要没有卡牌了！	
VO_Arthas_Male_Human_MIRROR_GREETINGS_01	真是幸会！	
VO_Arthas_Male_Human_MIRROR_START_01	为了父王！	
VO_Arthas_Male_Human_NO_CARDS_01	我已经没有卡牌了！	
VO_Arthas_Male_Human_OOPS_01	一次失误。	
VO_Arthas_Male_Human_PIRATE_DAY_01	我就是阿尔萨斯船长！	
VO_Arthas_Male_Human_SORRY_01	向你致以皇家的歉意，朋友。	
VO_Arthas_Male_Human_START_01	为了洛丹伦！	
VO_Arthas_Male_Human_THANKS_01	非常感谢。	
VO_Arthas_Male_Human_THINK1_01	嗯…	
VO_Arthas_Male_Human_THINK2_01	该选哪条路呢……	
VO_Arthas_Male_Human_THINK3_01	乌瑟尔会怎么做……	
VO_Arthas_Male_Human_THREATEN_01	你已无药\n可救！	
VO_Arthas_Male_Human_TIMER_01	我必须立刻\n行动！	
VO_Arthas_Male_Human_WELL_PLAYED_01	打得不错。	
VO_Arthas_Male_Human_WOW_01	圣光啊！	
VO_BRM_027h__LUNAR_NEW_YEAR	在火焰中迎来新的一年！	
VO_BRM_027h_Attack_15	尝尝萨弗隆的火焰吧！	
VO_BRM_027h_Concede_11	你赢了，很精彩！	
VO_BRM_027h_Emote_Start	我会复仇的，黑龙！	
VO_BRM_027h_ERROR01_51	我需要一把武器。	
VO_BRM_027h_ERROR02_52	法力值不足。	
VO_BRM_027h_ERROR03_53	他已经攻击过了。	
VO_BRM_027h_ERROR04_54	我已经进行过攻击了。	
VO_BRM_027h_ERROR05_55	凡人们需要一个回合进行准备。	
VO_BRM_027h_ERROR06_56	手牌太多了。	
VO_BRM_027h_ERROR07_57	随从太多了。	
VO_BRM_027h_ERROR08_58	它正在潜行，我无法攻击。	
VO_BRM_027h_ERROR09_59	不能使用。	
VO_BRM_027h_ERROR10_60	不行。	
VO_BRM_027h_ERROR11_61	那个嘲讽的随从挡住我了。	
VO_BRM_027h_ERROR12_62	不能这么做。	
VO_BRM_027h_FIRE_FESTIVAL	这是属于我的节日！	
VO_BRM_027h_GG_16	精彩的对决！	
VO_BRM_027h_Greetings_04	让火焰净化一切！	
VO_BRM_027h_HALLOWS_END	万圣节愉快！	
VO_BRM_027h_HAPPY_NEW_YEAR_38	在火焰中迎来新的一年！	
VO_BRM_027h_LowCards_49	我快把我的牌都烧光了！	
VO_BRM_027h_NOBLEGARDEN	在烈焰中迎接复活节吧！	
VO_BRM_027h_NoCards_50	我的牌都被烧光了！	
VO_BRM_027h_Oops_07	啊！犯了个错误！	
VO_BRM_027h_PIRATE_DAY	见识一下火焰之王的力量！	
VO_BRM_027h_Sorry_10	抱歉。	
VO_BRM_027h_Thanks_09	热忱的感谢。	
VO_BRM_027h_Thinking1_12	嗯…	
VO_BRM_027h_Thinking2_13	我想…	
VO_BRM_027h_Thinking3_14	先把什么烧焦呢…	
VO_BRM_027h_Threaten_08	你将在烈焰中灰飞烟灭！	
VO_BRM_027h_Time_48	时间都被烧光了！	
VO_BRM_027h_Well_Played_06	打得不错。	
VO_BRM_027h_Winterveil_Greetings	冬幕节应该\n再暖和一些！	
VO_BRM_027h_WOW_20	棒极了。	
VO_EX1_323h_HAPPY_NEW_YEAR_13	春节快乐！	
VO_GIL_504_Female_Orc_Concede_01	这次你赢了。	
VO_GIL_504_Female_Orc_Greetings_02	欢迎来到我的领地。	
VO_GIL_504_Female_Orc_LowCards_01	我的卡牌就快用光了！	
VO_GIL_504_Female_Orc_NoCards_01	我没有\n卡牌了！	
VO_GIL_504_Female_Orc_Oops_01	真不明智。	
VO_GIL_504_Female_Orc_Start_01	夜晚的森林很危险。	
VO_GIL_504_Female_Orc_Thanks_01	谢谢你。	
VO_GIL_504_Female_Orc_Thinking_01	嗯……	
VO_GIL_504_Female_Orc_Thinking_02	令人困惑……	
VO_GIL_504_Female_Orc_Thinking_03	一条阴暗的\n道路……	
VO_GIL_504_Female_Orc_Threaten_02	诅咒会吞\n噬你！	
VO_GIL_504_Female_Orc_Time_01	我必须作出\n决定！	
VO_GIL_504_Female_Orc_Well_Played_01	打得不错。	
VO_GIL_504_Female_Orc_Wow_01	黑夜！	
VO_GILA_400h_Male_Human_Concede_01	我打不过你！	
VO_GILA_400h_Male_Human_Death_02	<Death>	
VO_GILA_400h_Male_Human_ERROR_FULL_MINIONS_01	没地方再召唤随从了。	
VO_GILA_400h_Male_Human_ERROR_GENERIC_01	我不能那\n么做。	
VO_GILA_400h_Male_Human_ERROR_GENERIC_04	我做不到。	
VO_GILA_400h_Male_Human_ERROR_HAND_FULL_01	我的手牌太\n多了！	
VO_GILA_400h_Male_Human_ERROR_I_ATTACKED_01	我已经攻击过了。	
VO_GILA_400h_Male_Human_ERROR_MINION_ATTACKED_01	那个随从已经攻击过了。	
VO_GILA_400h_Male_Human_ERROR_NEED_MANA_02	我没有足够的法力值了！	
VO_GILA_400h_Male_Human_ERROR_NEED_WEAPON_02	我需要武器！	
VO_GILA_400h_Male_Human_ERROR_STEALTH_01	它潜行了！	
VO_GILA_400h_Male_Human_ERROR_SUMMON_SICKNESS_01	那个随从还没有准备好。	
VO_GILA_400h_Male_Human_ERROR_TARGET_01	我不能瞄准那个目标。	
VO_GILA_400h_Male_Human_ERROR_TAUNT_01	有个嘲讽随从在挡着我们。	
VO_GILA_400h_Male_Human_Greetings_01	我不喜欢你。我的狗也不喜\n欢你。	
VO_GILA_400h_Male_Human_LowCards_01	我的卡牌快要用光了……	
VO_GILA_400h_Male_Human_NoCards_01	没有卡牌了！	
VO_GILA_400h_Male_Human_Oops_01	糟透了。	
VO_GILA_400h_Male_Human_Sorry_01	非常抱歉。	
VO_GILA_400h_Male_Human_Start_01	看我的狗发现什么了。	
VO_GILA_400h_Male_Human_Thanks_01	谢了。	
VO_GILA_400h_Male_Human_Thinking_01	嗯……	
VO_GILA_400h_Male_Human_Thinking_03	我得仔细想想……	
VO_GILA_400h_Male_Human_Thinking_04	快点，快点……	
VO_GILA_400h_Male_Human_Threaten_04	你最好赶快\n装死。	
VO_GILA_400h_Male_Human_Time_01	没多少时\n间了。	
VO_GILA_400h_Male_Human_Well_Played_01	这招不错！	
VO_GILA_400h_Male_Human_WOW_01	好！	
VO_GILA_500h3_Female_Human_Concede_01	我战胜不\n了你！	
VO_GILA_500h3_Female_Human_ERROR_FULL_MINIONS_01	没有位置了。	
VO_GILA_500h3_Female_Human_ERROR_GENERIC_04	我不可以那\n么做！	
VO_GILA_500h3_Female_Human_ERROR_HAND_FULL_02	我的手牌\n满了！	
VO_GILA_500h3_Female_Human_ERROR_I_ATTACKED_02	我不能攻击\n两次！	
VO_GILA_500h3_Female_Human_ERROR_MINION_ATTACKED_01	它已经攻击\n过了。	
VO_GILA_500h3_Female_Human_ERROR_NEED_MANA_02	我的法力值\n不足。	
VO_GILA_500h3_Female_Human_ERROR_NEED_WEAPON_02	我得有武器\n才行。	
VO_GILA_500h3_Female_Human_ERROR_PLAY_01	我不能违反\n规则。	
VO_GILA_500h3_Female_Human_ERROR_STEALTH_01	我找不到\n它们！	
VO_GILA_500h3_Female_Human_ERROR_SUMMON_SICKNESS_01	那个随从还没准备好。	
VO_GILA_500h3_Female_Human_ERROR_TARGET_01	我不能选择那个目标。	
VO_GILA_500h3_Female_Human_ERROR_TAUNT_01	有个嘲讽随从挡着我！	
VO_GILA_500h3_Female_Human_Greetings_01	无冕者向你\n致意。	
VO_GILA_500h3_Female_Human_LowCards_01	我的卡牌不多了……	
VO_GILA_500h3_Female_Human_NoCards_01	我没有卡\n牌了！	
VO_GILA_500h3_Female_Human_Oops_02	那……不是我想要的。	
VO_GILA_500h3_Female_Human_Sorry_01	抱歉了。	
VO_GILA_500h3_Female_Human_Start_01	踪迹一直延续到这里。	
VO_GILA_500h3_Female_Human_Thanks_01	谢谢你。	
VO_GILA_500h3_Female_Human_Thinking_02	肯定有办法……	
VO_GILA_500h3_Female_Human_Thinking_03	快想啊，苔丝。快想。	
VO_GILA_500h3_Female_Human_Thinking_05	啊……嗯。	
VO_GILA_500h3_Female_Human_Threaten_03	我会毁灭你！	
VO_GILA_500h3_Female_Human_Time_01	我必须快点\n行动。	
VO_GILA_500h3_Female_Human_Well_Played_01	很好的策略。	
VO_GILA_500h3_Female_Human_WOW_01	绝对难以\n置信。	
VO_GILA_600h_Male_Worgen_Concede_01	你战胜我了！	
VO_GILA_600h_Male_Worgen_ERROR_FULL_MINIONS_02	我场上的随从太多了。	
VO_GILA_600h_Male_Worgen_ERROR_GENERIC_01	不行！	
VO_GILA_600h_Male_Worgen_ERROR_GENERIC_02	我不能那么做。	
VO_GILA_600h_Male_Worgen_ERROR_HAND_FULL_01	卡牌太多了！	
VO_GILA_600h_Male_Worgen_ERROR_I_ATTACKED_01	我已经攻击过了。	
VO_GILA_600h_Male_Worgen_ERROR_MINION_ATTACKED_01	那个随从已经攻击过了。	
VO_GILA_600h_Male_Worgen_ERROR_NEED_MANA_01	我的法力值\n不足。	
VO_GILA_600h_Male_Worgen_ERROR_NEED_WEAPON_02	我需要武器。	
VO_GILA_600h_Male_Worgen_ERROR_STEALTH_01	那个随从藏起来了！	
VO_GILA_600h_Male_Worgen_ERROR_SUMMON_SICKNESS_01	它还没准备好行动。	
VO_GILA_600h_Male_Worgen_ERROR_TARGET_01	我不能瞄准那个目标。	
VO_GILA_600h_Male_Worgen_ERROR_TAUNT_01	有个嘲讽随从挡路！	
VO_GILA_600h_Male_Worgen_Greetings_01	跟我的大朋友打个招呼。	
VO_GILA_600h_Male_Worgen_LowCards_01	我的卡牌就要用光了！	
VO_GILA_600h_Male_Worgen_NoCards_01	我已经没有卡牌了！	
VO_GILA_600h_Male_Worgen_Oops_01	那样做不对！	
VO_GILA_600h_Male_Worgen_Sorry_01	我……很抱歉。	
VO_GILA_600h_Male_Worgen_Start_01	我已经就\n位了。	
VO_GILA_600h_Male_Worgen_Thanks_01	谢谢你。	
VO_GILA_600h_Male_Worgen_Thinking_01	嗯……	
VO_GILA_600h_Male_Worgen_Thinking_02	下一步该怎么走……	
VO_GILA_600h_Male_Worgen_Thinking_04	我会想到办法的……	
VO_GILA_600h_Male_Worgen_Threaten_01	我会炸飞你！	
VO_GILA_600h_Male_Worgen_Time_01	别催我！	
VO_GILA_600h_Male_Worgen_Well_Played_01	很好的行动。	
VO_GILA_600h_Male_Worgen_WOW_01	难以置信！	
VO_GILA_900h_Female_Gnome_Concede_01	我尽力了。你赢了！	
VO_GILA_900h_Female_Gnome_ERROR_FULL_MINIONS_02	我不能召唤更多随从了。	
VO_GILA_900h_Female_Gnome_ERROR_GENERIC_01	我不能\n那么做。	
VO_GILA_900h_Female_Gnome_ERROR_HAND_FULL_01	我的手牌\n太多了！	
VO_GILA_900h_Female_Gnome_ERROR_I_ATTACKED_02	我还不能再次攻击！	
VO_GILA_900h_Female_Gnome_ERROR_MINION_ATTACKED_01	那个随从已经攻击过了。	
VO_GILA_900h_Female_Gnome_ERROR_NEED_MANA_01	法力值不足。	
VO_GILA_900h_Female_Gnome_ERROR_NEED_WEAPON_01	我没有武器。	
VO_GILA_900h_Female_Gnome_ERROR_PLAY_01	就算是我也不能那么做！	
VO_GILA_900h_Female_Gnome_ERROR_STEALTH_01	那个目标\n潜行了。	
VO_GILA_900h_Female_Gnome_ERROR_SUMMON_SICKNESS_01	那个随从需要点准备时间。	
VO_GILA_900h_Female_Gnome_ERROR_TARGET_01	那不是个\n好目标。	
VO_GILA_900h_Female_Gnome_ERROR_TAUNT_01	有个嘲讽随从挡路！	
VO_GILA_900h_Female_Gnome_GG_01	打得真棒！	
VO_GILA_900h_Female_Gnome_Greetings_01	啊，你好。又是你。	
VO_GILA_900h_Female_Gnome_LowCards_01	剩下的牌\n不多了……	
VO_GILA_900h_Female_Gnome_NoCards_01	我没有牌了！	
VO_GILA_900h_Female_Gnome_Oops_02	我认为那是个错误。	
VO_GILA_900h_Female_Gnome_Sorry_01	呃，抱歉？	
VO_GILA_900h_Female_Gnome_Start_01	你的时间用\n光了！	
VO_GILA_900h_Female_Gnome_Thanks_01	谢谢。	
VO_GILA_900h_Female_Gnome_Thinking_02	嗯……	
VO_GILA_900h_Female_Gnome_Thinking_03	……必须从第四维度上思考……	
VO_GILA_900h_Female_Gnome_Thinking_05	……齿轮在\n转动……	
VO_GILA_900h_Female_Gnome_Threaten_01	我会把你从时间线上抹除！	
VO_GILA_900h_Female_Gnome_Time_01	我的时间也会用光吗？	
VO_GILA_900h_Female_Gnome_Well_Played_01	我正想这么\n做呢。	
VO_GILA_900h_Female_Gnome_WOW_02	不可思议！	
VO_HERO_01_HAPPY_NEW_YEAR_06	新年快乐！	
VO_HERO_02_HAPPY_NEW_YEAR_07	新年快乐，\n朋友！	
VO_HERO_03_HAPPY_NEW_YEAR_06	新年快乐！	
VO_HERO_03a_Attack_15	我代表正义消灭你！	
VO_HERO_03a_CONCEDE_06	打得好，\n我认输。	
VO_HERO_03a_ERROR_FULL_MINIONS_25	我已经拥有了太多的随从。	
VO_HERO_03a_ERROR_GENERIC_30	我不能这么做。	
VO_HERO_03a_ERROR_HAND_FULL_24	我的手牌已经满了！	
VO_HERO_03a_ERROR_I_ATTACKED_22	我已经攻击\n过了。	
VO_HERO_03a_ERROR_JUST_PLAYED_23	那个随从需要一个回合进行\n准备。	
VO_HERO_03a_ERROR_MINION_ATTACKED_21	那个随从已经攻击过了。	
VO_HERO_03a_ERROR_NEED_MANA_20	我没有足够的法力值。	
VO_HERO_03a_ERROR_NEED_WEAPON_19	我需要一把武器。	
VO_HERO_03a_ERROR_PLAY_27	我不能使用这张牌。	
VO_HERO_03a_ERROR_STEALTH_26	我不能以潜行的随从作为目标。	
VO_HERO_03a_ERROR_TARGET_28	那不是一个有效的目标。	
VO_HERO_03a_ERROR_TAUNT_29	必须先攻击具有嘲讽的随从。	
VO_HERO_03a_FIRE_FESTIVAL	仲夏节快乐！	
VO_HERO_03a_GREETINGS_03	你好啊，\n朋友。	
VO_HERO_03a_HALLOWS_END	万圣节快乐。	
VO_HERO_03a_HAPPY_HOLIDAYS_52	冬幕节快乐！	
VO_HERO_03a_HAPPY_NEW_YEAR_53	新年快乐！	
VO_HERO_03a_LOW_CARDS_17	我快要没有\n牌了。	
VO_HERO_03a_MIRROR_GREETINGS_04	见到你很高兴！	
VO_HERO_03a_MIRROR_START_02	我就是正义\n之手！	
VO_HERO_03a_NO_CARDS_18	我已经没有\n牌了！	
VO_HERO_03a_NOBLEGARDEN	复活节快乐！彩蛋放哪儿了？	
VO_HERO_03a_OOPS_08	真是失误。	
VO_HERO_03a_PICKED_11	时候到了！	
VO_HERO_03a_PIRATE_DAY	呀，伙计！	
VO_HERO_03a_SORRY_10	抱歉。	
VO_HERO_03a_START_01	没人能逃出我的掌心！	
VO_HERO_03a_THANKS_09	谢谢。	
VO_HERO_03a_THINK1_12	嗯……	
VO_HERO_03a_THINK2_13	嗯，我想……	
VO_HERO_03a_THINK3_14	我想……	
VO_HERO_03a_THREATEN_05	见证我的\n怒火！	
VO_HERO_03a_TIMER_16	别磨蹭！	
VO_HERO_03a_WELL_PLAYED_07	打得不错。	
VO_HERO_03a_WOW_35	漂亮！	
VO_HERO_04_HAPPY_NEW_YEAR_15	新年快乐，\n勇士！	
VO_HERO_05_HAPPY_NEW_YEAR_15	新年快乐！	
VO_HERO_06_HAPPY_NEW_YEAR_15	新年快乐！	
VO_HERO_07_HAPPY_NEW_YEAR_15	新年快乐！	
VO_HERO_08_HAPPY_NEW_YEAR_15	新年快乐！	
VO_HERO_08b_HAPPY_NEW_YEAR_53	新年快乐！	
VO_HERO_09_HAPPY_NEW_YEAR_15	新年快乐！	
VO_HERO_09a_Attack_15	为了艾露恩！	
VO_HERO_09a_CONCEDE_06	结束吧，你\n赢了。	
VO_HERO_09a_ERROR_FULL_MINIONS_25	我已经拥有了太多的随从！	
VO_HERO_09a_ERROR_GENERIC_30	我不能\n这么做。	
VO_HERO_09a_ERROR_HAND_FULL_24	我的手牌\n已经满了！	
VO_HERO_09a_ERROR_I_ATTACKED_22	我已经进行过攻击了！	
VO_HERO_09a_ERROR_JUST_PLAYED_23	那个随从需要一个回合进行\n准备。	
VO_HERO_09a_ERROR_MINION_ATTACKED_21	那个随从已经攻击过了。	
VO_HERO_09a_ERROR_NEED_MANA_20	我没有足够的法力值。	
VO_HERO_09a_ERROR_NEED_WEAPON_19	我需要\n一把武器。	
VO_HERO_09a_ERROR_PLAY_27	我不能使用\n这张牌。	
VO_HERO_09a_ERROR_STEALTH_26	我不能以潜行的随从作为目标。	
VO_HERO_09a_ERROR_TARGET_28	那不是一个\n有效的目标。	
VO_HERO_09a_ERROR_TAUNT_29	必须先攻击\n具有嘲讽的\n随从。	
VO_HERO_09a_FIRE_FESTIVAL	仲夏节快乐！	
VO_HERO_09a_GREETINGS_03	祝福你。	
VO_HERO_09a_HALLOWS_END	万圣节快乐。	
VO_HERO_09a_HAPPY_HOLIDAYS_52	冬幕节快乐！	
VO_HERO_09a_HAPPY_NEW_YEAR_01	新年快乐！	
VO_HERO_09a_HAPPY_NEW_YEAR_LUNAR_53	祝福你。	
VO_HERO_09a_LOW_CARDS_17	我快要\n没有牌了！	
VO_HERO_09a_MIRROR_GREETINGS_04	也祝福你。	
VO_HERO_09a_MIRROR_START_02	月神护佑\n着我。	
VO_HERO_09a_NO_CARDS_18	我已经没有\n卡牌了！	
VO_HERO_09a_NOBLEGARDEN	复活节快乐。	
VO_HERO_09a_OOPS_08	真是个错误。	
VO_HERO_09a_PICKED_11	月神在召唤！	
VO_HERO_09a_PIRATE_DAY	真言术：\n海盗！	
VO_HERO_09a_SORRY_10	原谅我。	
VO_HERO_09a_START_01	艾露恩赐予我力量。	
VO_HERO_09a_START_MALFURION	我亲爱的玛法里奥。	
VO_HERO_09a_THANKS_09	谢谢你。	
VO_HERO_09a_THINK1_12	嗯…	
VO_HERO_09a_THINK2_13	我想…	
VO_HERO_09a_THINK3_14	艾露恩会怎么做…	
VO_HERO_09a_THREATEN_05	你会后悔的！	
VO_HERO_09a_TIMER_16	抓紧时间！	
VO_HERO_09a_WELL_PLAYED_07	打得不错。	
VO_HERO_09a_WOW_10	真棒！	
VO_HERO_11_HAPPY_NEW_YEAR_20	新年快乐！	
VO_HERO_12_HAPPY_NEW_YEAR_20	新年快乐！	
VO_HERO_13_HAPPY_NEW_YEAR_20	新年快乐！	
VO_HERO_14_HAPPY_NEW_YEAR_20	新年快乐！	
VO_HERO_15_HAPPY_NEW_YEAR_24	<新年快乐！>	
VO_HERO_16_Female_Dryad_Concede_01	我输了。	
VO_HERO_16_Female_Dryad_ERROR_01	我没有可以使用的武器。	
VO_HERO_16_Female_Dryad_ERROR_02	我需要更多的法力值！	
VO_HERO_16_Female_Dryad_ERROR_03	那个随从无法再次进行攻击！	
VO_HERO_16_Female_Dryad_ERROR_04	我已经进行过攻击了。	
VO_HERO_16_Female_Dryad_ERROR_05	那个随从还无法进行攻击。	
VO_HERO_16_Female_Dryad_ERROR_06	我的手牌已经满了！	
VO_HERO_16_Female_Dryad_ERROR_07	我已经拥有了太多的随从！	
VO_HERO_16_Female_Dryad_ERROR_08	那个随从具有潜行	
VO_HERO_16_Female_Dryad_ERROR_09	我无法这\n么做。	
VO_HERO_16_Female_Dryad_ERROR_10	那不可能。	
VO_HERO_16_Female_Dryad_ERROR_11	我必须先攻击那个具有嘲讽的\n随从。	
VO_HERO_16_Female_Dryad_ERROR_12	那是不可\n能的。	
VO_HERO_16_Female_Dryad_FIRE_FESTIVAL_01	我爱火焰节！	
VO_HERO_16_Female_Dryad_Greetings_01	愿大自然保\n佑你。	
VO_HERO_16_Female_Dryad_HAPPY_HALLOWEEN_01	万圣节快乐！	
VO_HERO_16_Female_Dryad_HAPPY_HOLIDAYS_01	冬幕节快乐！	
VO_HERO_16_Female_Dryad_HAPPY_NEW_YEAR_01	又是一年春\n来到！	
VO_HERO_16_Female_Dryad_HAPPY_NOBLEGARDEN_01	复活节快乐！	
VO_HERO_16_Female_Dryad_LowCards_01	我就快没\n牌了！	
VO_HERO_16_Female_Dryad_MALFURION_START_01	Ishnu'alah，大德鲁伊。	
VO_HERO_16_Female_Dryad_MIRROR_GREETINGS_01	也保佑你！	
VO_HERO_16_Female_Dryad_MIRROR_START_01	为了大自然！	
VO_HERO_16_Female_Dryad_NoCards_01	我已经没有卡牌了！	
VO_HERO_16_Female_Dryad_Oops_02	我…计算失误。	
VO_HERO_16_Female_Dryad_PIRATE_DAY_01	嘿呀！我是\n海盗！	
VO_HERO_16_Female_Dryad_Sorry_01	对此我很抱歉。	
VO_HERO_16_Female_Dryad_Start_01	森林也是会反抗的。	
VO_HERO_16_Female_Dryad_Thanks_01	感谢你的\n支持。	
VO_HERO_16_Female_Dryad_Thinking_01	让我想想…	
VO_HERO_16_Female_Dryad_Thinking_02	那么现在…	
VO_HERO_16_Female_Dryad_Thinking_03	假如…	
VO_HERO_16_Female_Dryad_Threaten_01	亲身感受大自然的痛苦吧！	
VO_HERO_16_Female_Dryad_Time_01	没时间了。	
VO_HERO_16_Female_Dryad_Well_Played_01	打得不错。	
VO_HERO_16_Female_Dryad_WOW_01	真是太狂\n野了！	
VO_HERO_18_Female_Gnome_Concede_01	厉害！这次是你赢了。	
VO_HERO_18_Female_Gnome_ERROR_01	我的武器呢？	
VO_HERO_18_Female_Gnome_ERROR_03	法力值不足。	
VO_HERO_18_Female_Gnome_ERROR_04	他们已经进行过攻击了。	
VO_HERO_18_Female_Gnome_ERROR_06	我无法再次进行攻击。	
VO_HERO_18_Female_Gnome_ERROR_07	嘘，他们还在睡觉呢。	
VO_HERO_18_Female_Gnome_ERROR_08	呃！我的手牌太多啦！	
VO_HERO_18_Female_Gnome_ERROR_10	只能上七个随从，伙计！	
VO_HERO_18_Female_Gnome_ERROR_12	呃！他们是潜行的。	
VO_HERO_18_Female_Gnome_ERROR_14	嗯，做不到。	
VO_HERO_18_Female_Gnome_ERROR_15	我没法\n这么做。	
VO_HERO_18_Female_Gnome_ERROR_17	一个具有嘲讽的随从挡在我\n面前。	
VO_HERO_18_Female_Gnome_FIRE_FESTIVAL_01	仲夏节的烟火好美呀！	
VO_HERO_18_Female_Gnome_Greetings_01	你好啊，\n朋友！	
VO_HERO_18_Female_Gnome_HAPPY_HALLOWEEN_01	万圣节！捣蛋时间到！	
VO_HERO_18_Female_Gnome_HAPPY_HOLIDAYS_01	冬幕节快乐	
VO_HERO_18_Female_Gnome_HAPPY_NEW_YEAR_01	新年快乐！	
VO_HERO_18_Female_Gnome_HAPPY_NEW_YEAR_LUNAR_16	春节快乐！	
VO_HERO_18_Female_Gnome_LowCards_01	我的卡牌快要用光啦。	
VO_HERO_18_Female_Gnome_MIRROR_START_01	耶！真是\n棒极了！	
VO_HERO_18_Female_Gnome_NOBLEGARDEN	我超爱复\n活节！	
VO_HERO_18_Female_Gnome_NoCards_01	我已经没有\n卡牌了！	
VO_HERO_18_Female_Gnome_Oops_02	糟糕！	
VO_HERO_18_Female_Gnome_PIRATE_DAY_01	我是酷酷的海盗！嘿呀！	
VO_HERO_18_Female_Gnome_Sorry_01	啊哦，对不起。	
VO_HERO_18_Female_Gnome_Start_01	让我们来找点乐子吧！	
VO_HERO_18_Female_Gnome_Thanks_02	噢，谢谢你！	
VO_HERO_18_Female_Gnome_Thinking_01	嗯……	
VO_HERO_18_Female_Gnome_Thinking_03	啧啧啧……	
VO_HERO_18_Female_Gnome_Thinking_04	假如……	
VO_HERO_18_Female_Gnome_Threaten_01	我要把你做成一个玩偶！	
VO_HERO_18_Female_Gnome_Time_01	手脚麻利点！	
VO_HERO_18_Female_Gnome_Well_Played_01	哇喔，打得\n不错！	
VO_HERO_18_Female_Gnome_WOW_01	真是太棒了！	
VO_ICC08_LichKing_Male_Human_YoungArthas_02	我讨厌镜像\n比赛。	
VO_TBA01_4__Concede	*低吼*	
VO_TBA01_4__Error_Full_Minions	*低吼*	
VO_TBA01_4__Error_Generic	*低吼*	
VO_TBA01_4__Error_Hand_Full	*低吼*	
VO_TBA01_4__Error_I_Attacked	*低吼*	
VO_TBA01_4__Error_Just_Played	*低吼*	
VO_TBA01_4__Error_Minion_Attacked	*低吼*	
VO_TBA01_4__Error_Need_Mana	*低吼*	
VO_TBA01_4__Error_Need_Weapon	*低吼*	
VO_TBA01_4__Error_Play	*低吼*	
VO_TBA01_4__Error_Stealth	*低吼*	
VO_TBA01_4__Good_Game	*低吼*	
VO_TBA01_4__Greetings	游戏开始了！	
VO_TBA01_4__Low_Cards	*低吼*	
VO_TBA01_4__No_Cards	*低吼*	
VO_TBA01_4__Oops	喔，糟了。	
VO_TBA01_4__Sorry	抱歉。	
VO_TBA01_4__Start	我才是这里的主人！	
VO_TBA01_4__Thanks	谢谢。	
VO_TBA01_4__Threaten	哈哈哈！看好了，黑龙王子真正的力量！	
VO_TBA01_4__Timer	*低吼*	
VO_TBA01_4__Well_Played	打得不错。	
